Size,Time,Cycles,Price,Instructions,HeapSize,TotalHeapSize
1,2057612584,79038457,1.0670191695e-11,5543,1025396,1026024
2,2062258166,79144987,1.0684573244999999e-11,6142,-1280,1024744
3,2067531125,79038148,1.0670149979999999e-11,6142,1025408,2050152
4,2067162333,79251552,1.0698959519999999e-11,6681,-1176,2048976
5,2126277250,79038860,1.06702461e-11,6681,1025408,3074384
6,2044126792,79038165,1.0670152274999999e-11,6681,1025408,4099792
7,2065798667,79411377,1.0720535894999999e-11,6681,-514468,3585324
8,2047525959,79038181,1.0670154435e-11,7220,1025408,4610732
9,2039074333,79038181,1.0670154435e-11,7220,1025408,5636140
10,2069211333,79572518,1.074228993e-11,7220,-514468,5121672
11,2039838250,79038179,1.0670154164999998e-11,7157,1025408,6147080
12,2057909167,79038180,1.0670154299999999e-11,7178,1025408,7172488
13,2034329209,79038180,1.0670154299999999e-11,7178,1025408,8197896
14,2069831250,79784313,1.0770882254999999e-11,7199,-1027760,7170136
15,2050546750,79039901,1.0670386635e-11,7199,1025408,8195544
16,2057891291,79038197,1.0670156594999999e-11,7738,1025408,9220952
17,2088174666,79038197,1.0670156594999999e-11,7738,1025408,10246360
18,8080005583,79040089,1.0670412014999999e-11,7738,1025408,11271768
19,12484933833,80052935,1.0807146224999999e-11,7738,-1541052,9730716
20,2049817625,79038197,1.0670156594999999e-11,7738,1025408,10756124
21,2050479875,79038195,1.0670156325e-11,7675,1025408,11781532
22,2050329917,79040429,1.0670457915e-11,7696,1025408,12806940
23,2051677709,79038197,1.0670156594999999e-11,7717,1025408,13832348
24,2065444917,79038197,1.0670156594999999e-11,7717,1025408,14857756
25,2050478875,80370347,1.0849996844999998e-11,7717,-2054344,12803412
26,2049500750,79038197,1.0670156594999999e-11,7717,1025408,13828820
27,2050901125,79041038,1.067054013e-11,7738,1025408,14854228
28,2067925333,79038197,1.0670156594999999e-11,7738,1025408,15879636
29,2053968792,79038197,1.0670156594999999e-11,7738,1025408,16905044
30,2056902542,79038197,1.0670156594999999e-11,7738,1025408,17930452
31,2053011042,79041036,1.067053986e-11,7675,1025408,18955860
32,2053032667,79038790,1.067023665e-11,27002,1026232,19982092
33,2087334625,80796839,1.0907573264999999e-11,8674,-3081236,16900856
34,2084112584,79038226,1.0670160509999999e-11,8674,1025432,17926288
35,2119102292,79038227,1.0670160645e-11,8695,1025432,18951720
36,2063459917,79041903,1.0670656905e-11,8695,1025432,19977152
37,2050393875,79038227,1.0670160645e-11,8695,1025432,21002584
38,2051737583,79038227,1.0670160645e-11,8695,1025432,22028016
39,2054825959,79038227,1.0670160645e-11,8695,1025432,23053448
40,2054038917,79038227,1.0670160645e-11,8695,1025432,24078880
41,2050683041,79041901,1.0670656634999999e-11,8632,1025432,25104312
42,2052745250,79038225,1.0670160374999998e-11,8653,1025432,26129744
43,2106398250,81329583,1.0979493705e-11,8653,-4107728,22022016
44,2061525750,79038226,1.0670160509999999e-11,8674,1025432,23047448
45,2052313166,79038226,1.0670160509999999e-11,8674,1025432,24072880
46,9272113375,79038226,1.0670160509999999e-11,8674,1025432,25098312
47,3672681125,79038226,1.0670160509999999e-11,8674,1025432,26123744
48,2503931875,79038227,1.0670160645e-11,8695,1025432,27149176
49,2222638166,79038714,1.0670226389999999e-11,24545,1025880,28175056
50,6970454292,79042929,1.0670795414999999e-11,8716,1025432,29200488
51,2051779709,79038225,1.0670160374999998e-11,8632,1025432,30225920
52,2049725750,79038225,1.0670160374999998e-11,8653,1025432,31251352
53,2070312083,79042928,1.067079528e-11,8674,1025432,32276784
54,2076959792,79038226,1.0670160509999999e-11,8674,1025432,33302216
55,2095417625,81968981,1.1065812435e-11,8674,-5134620,28167596
56,2064197542,79038227,1.0670160645e-11,8695,1025432,29193028
57,2092292792,79038227,1.0670160645e-11,8695,1025432,30218460
58,2146203042,79044145,1.0670959575e-11,8695,1025432,31243892
59,2067662166,79038227,1.0670160645e-11,8695,1025432,32269324
60,2063563667,79038227,1.0670160645e-11,8695,1025432,33294756
61,2114579291,79038225,1.0670160374999998e-11,8632,1025432,34320188
62,2057080583,79038225,1.0670160374999998e-11,8653,1025432,35345620
63,2085087750,79044143,1.0670959304999998e-11,8653,1025432,36371052
64,2073600834,79038226,1.0670160509999999e-11,8674,1025432,37396484
65,2083889750,79038226,1.0670160509999999e-11,8674,1025432,38421916
66,2064295500,79038709,1.0670225715e-11,24392,1025880,39447796
67,2094977125,79038243,1.0670162804999999e-11,9213,1025432,40473228
68,3284034041,79044161,1.0670961734999999e-11,9213,1025432,41498660
69,2086903458,79038243,1.0670162804999999e-11,9213,1025432,42524092
70,3357937750,82768220,1.1173709699999998e-11,9234,-6674568,35849524
71,2068888875,79038241,1.0670162535e-11,9150,1025432,36874956
72,2060118458,79045691,1.0671168285e-11,9171,1025432,37900388
73,2081442584,79038242,1.067016267e-11,9192,1025432,38925820
74,2062615750,79038242,1.067016267e-11,9192,1025432,39951252
75,2102363083,79038242,1.067016267e-11,9192,1025432,40976684
76,2067421167,79038242,1.067016267e-11,9192,1025432,42002116
77,2066009291,79045693,1.0671168554999998e-11,9213,1025432,43027548
78,2066169917,79038243,1.0670162804999999e-11,9213,1025432,44052980
79,3333147584,79038243,1.0670162804999999e-11,9213,1025432,45078412
80,2125296041,79038243,1.0670162804999999e-11,9213,1025432,46103844
81,2064077208,79045691,1.0671168285e-11,9150,1025432,47129276
82,3269728750,79038241,1.0670162535e-11,9171,1025432,48154708
83,2052420959,79038721,1.0670227335e-11,24757,1025880,49180588
84,2048168250,79038242,1.067016267e-11,9192,1025432,50206020
85,2373014292,79045693,1.0671168554999998e-11,9213,1025432,51231452
86,2352340292,79038243,1.0670162804999999e-11,9213,1025432,52256884
87,3413668000,79038243,1.0670162804999999e-11,9213,1025432,53282316
88,4057367000,79046439,1.0671269264999999e-11,9213,1025432,54307748
89,12375940667,83791835,1.1311897725e-11,9213,-8727832,45579916
90,2050962333,79038243,1.0670162804999999e-11,9213,1025432,46605348
91,2050940291,79038241,1.0670162535e-11,9150,1025432,47630780
92,2049975375,79038241,1.0670162535e-11,9171,1025432,48656212
93,2051087458,79038241,1.0670162535e-11,9171,1025432,49681644
94,2051110708,79047654,1.067143329e-11,9192,1025432,50707076
95,2051244500,79038242,1.067016267e-11,9192,1025432,51732508
96,2050284417,79038242,1.067016267e-11,9192,1025432,52757940
97,2050779583,79038242,1.067016267e-11,9192,1025432,53783372
98,6522913042,79047655,1.0671433424999998e-11,9213,1025432,54808804
99,2053179000,79038243,1.0670162804999999e-11,9213,1025432,55834236
100,2129069250,79038718,1.0670226929999998e-11,24667,1025880,56860116
101,2061639666,79047649,1.0671432614999998e-11,9024,1025432,57885548
102,2057508708,79038238,1.067016213e-11,9066,1025432,58910980
103,2050276958,79038239,1.0670162265e-11,9108,1025432,59936412
104,2050597917,79038239,1.0670162265e-11,9108,1025432,60961844
105,2048751792,79038239,1.0670162265e-11,9108,1025432,61987276
106,2079531500,79047653,1.0671433155e-11,9150,1025432,63012708
107,2047705417,79038241,1.0670162535e-11,9150,1025432,64038140
108,2075636750,79038241,1.0670162535e-11,9150,1025432,65063572
109,2058756666,79038241,1.0670162535e-11,9150,1025432,66089004
110,2082975542,79038241,1.0670162535e-11,9150,1025432,67114436
111,2070077000,79038239,1.0670162265e-11,9087,1025432,68139868
112,2049592875,79047651,1.0671432885e-11,9108,1025432,69165300
113,3249903417,85059229,1.1482995914999999e-11,9108,-11294412,57870888
114,2048912458,79038240,1.0670162399999999e-11,9129,1025432,58896320
115,4799806458,79050121,1.0671766335e-11,9129,1025432,59921752
116,2099854458,79038241,1.0670162535e-11,9150,1025432,60947184
117,3308974834,79038712,1.067022612e-11,24472,1025880,61973064
118,2105069291,79038242,1.067016267e-11,9192,1025432,62998496
119,3276804834,79050124,1.067176674e-11,9213,1025432,64023928
120,2087933792,79038243,1.0670162804999999e-11,9213,1025432,65049360
121,8642293417,79051309,1.0671926714999999e-11,9129,1025432,66074792
122,2046910250,79038241,1.0670162535e-11,9150,1025432,67100224
123,2113076125,79038241,1.0670162535e-11,9171,1025432,68125656
124,2031785958,79038241,1.0670162535e-11,9171,1025432,69151088
125,3296179875,79050122,1.067176647e-11,9171,1025432,70176520
126,2086318208,79038241,1.0670162535e-11,9171,1025432,71201952
127,2080620750,79038242,1.067016267e-11,9192,1025432,72227384
128,2061916625,79038242,1.067016267e-11,9192,1025432,73252816
129,2069256458,79038242,1.067016267e-11,9192,1025432,74278248
130,2084585833,79050123,1.0671766604999999e-11,9192,1025432,75303680
131,2062623417,79038240,1.0670162399999999e-11,9129,1025432,76329112
132,2075692834,79038241,1.0670162535e-11,9150,1025432,77354544
133,3277167709,79038241,1.0670162535e-11,9150,1025432,78379976
134,3309502750,79050589,1.0671829515e-11,24340,1025880,79405856
135,3331054833,79038258,1.067016483e-11,9710,1025432,80431288
136,3266406375,79038258,1.067016483e-11,9710,1025432,81456720
137,4732040458,79050139,1.0671768764999998e-11,9710,1025432,82482152
138,3282938625,79038258,1.067016483e-11,9710,1025432,83507584
139,3266166291,79038258,1.067016483e-11,9710,1025432,84533016
140,3327774042,79038258,1.067016483e-11,9710,1025432,85558448
141,3277931666,79051325,1.0671928875e-11,9647,1025432,86583880
142,3269361584,79038257,1.0670164694999999e-11,9668,1025432,87609312
143,4724544958,86672646,1.1700807209999998e-11,9668,-14374568,73234744
144,2047570583,79038257,1.0670164694999999e-11,9689,1025432,74260176
145,3265262959,79038257,1.0670164694999999e-11,9689,1025432,75285608
146,3266804458,79038257,1.0670164694999999e-11,9689,1025432,76311040
147,3266170583,79054710,1.067238585e-11,9689,1025432,77336472
148,3266042792,79038258,1.067016483e-11,9710,1025432,78361904
149,3266176250,79038258,1.067016483e-11,9710,1025432,79387336
150,3263740625,79053215,1.0672184024999999e-11,9710,1025432,80412768
151,3265966167,79038719,1.0670227065e-11,24684,1025880,81438648
152,3266291042,79038257,1.0670164694999999e-11,9668,1025432,82464080
153,11079762000,79053214,1.067218389e-11,9689,1025432,83489512
154,2841656541,79053214,1.067218389e-11,9689,1025432,84514944
155,2269636208,79038258,1.067016483e-11,9710,1025432,85540376
156,2442210625,79038258,1.067016483e-11,9710,1025432,86565808
157,3814363500,79053215,1.0672184024999999e-11,9710,1025432,87591240
158,2331989833,79038258,1.067016483e-11,9710,1025432,88616672
159,3124190792,79038258,1.067016483e-11,9710,1025432,89642104
160,2229757416,79038258,1.067016483e-11,9710,1025432,90667536
161,2074899583,79053213,1.0672183754999999e-11,9647,1025432,91692968
162,2063223709,79038257,1.0670164694999999e-11,9668,1025432,92718400
163,4733373708,79038257,1.0670164694999999e-11,9668,1025432,93743832
164,2085910417,79053214,1.067218389e-11,9689,1025432,94769264
165,2052358791,79038257,1.0670164694999999e-11,9689,1025432,95794696
166,2080832750,79038257,1.0670164694999999e-11,9689,1025432,96820128
167,2061821958,79038257,1.0670164694999999e-11,9689,1025432,97845560
168,2104796041,79053674,1.067224599e-11,24615,1025880,98871440
169,2071022125,79038258,1.067016483e-11,9731,1025432,99896872
170,2067810792,79038258,1.067016483e-11,9731,1025432,100922304
171,2059093792,79038256,1.067016456e-11,9647,1025432,101947736
172,2078772458,79038257,1.0670164694999999e-11,9668,1025432,102973168
173,2060775750,79053214,1.067218389e-11,9689,1025432,103998600
174,2081781917,79038257,1.0670164694999999e-11,9689,1025432,105024032
175,2060615125,79038257,1.0670164694999999e-11,9689,1025432,106049464
176,2085798250,79038258,1.067016483e-11,9710,1025432,107074896
177,2072347542,79038258,1.067016483e-11,9710,1025432,108100328
178,2132788125,79038258,1.067016483e-11,9710,1025432,109125760
179,2059706875,79053215,1.0672184024999999e-11,9710,1025432,110151192
180,4730061917,88629053,1.1964922154999998e-11,9710,-17967780,92183412
181,2050667084,79038256,1.067016456e-11,9647,1025432,93208844
182,2053170625,79056989,1.0672693514999999e-11,9668,1025432,94234276
183,2050533958,79038257,1.0670164694999999e-11,9668,1025432,95259708
184,2049617584,79038257,1.0670164694999999e-11,9689,1025432,96285140
185,2049910417,79038713,1.0670226254999998e-11,24483,1025880,97311020
186,2073020625,79038258,1.067016483e-11,9731,1025432,98336452
187,2060444625,79056990,1.0672693649999998e-11,9731,1025432,99361884
188,2111185542,79038258,1.067016483e-11,9731,1025432,100387316
189,2061108834,79038258,1.067016483e-11,9731,1025432,101412748
190,2050479167,79038258,1.067016483e-11,9731,1025432,102438180
191,2049485750,79038257,1.0670164694999999e-11,9668,1025432,103463612
192,2058499583,79056989,1.0672693514999999e-11,9689,1025432,104489044
193,2050189000,79038258,1.067016483e-11,9710,1025432,105514476
194,11065521250,79060736,1.067319936e-11,9710,1025432,106539908
195,6526697958,79038258,1.067016483e-11,9710,1025432,107565340
196,2181947083,79056990,1.0672693649999998e-11,9710,1025432,108590772
197,2525511917,79038258,1.067016483e-11,9731,1025432,109616204
198,3806981750,79038258,1.067016483e-11,9731,1025432,110641636
199,3195342292,79056990,1.0672693649999998e-11,9731,1025432,111667068
200,2710695625,79038258,1.067016483e-11,9731,1025432,112692500
201,2954476625,79038252,1.0670164019999999e-11,9521,1025432,113717932
202,2254349959,79057435,1.0672753725e-11,24183,1025880,114743812
203,2067370417,79038255,1.0670164424999999e-11,9605,1025432,115769244
204,2125649750,79038255,1.0670164424999999e-11,9605,1025432,116794676
205,2064780750,79038256,1.067016456e-11,9647,1025432,117820108
206,2052601333,79038256,1.067016456e-11,9647,1025432,118845540
207,2051400792,79056988,1.067269338e-11,9647,1025432,119870972
208,2051783958,79038256,1.067016456e-11,9647,1025432,120896404
209,2048615291,79038256,1.067016456e-11,9647,1025432,121921836
210,2062934958,79038256,1.067016456e-11,9647,1025432,122947268
211,2051922042,79038254,1.0670164289999999e-11,9584,1025432,123972700
212,2107625458,79056987,1.0672693245e-11,9605,1025432,124998132
213,2051958333,79038255,1.0670164424999999e-11,9605,1025432,126023564
214,2119626791,79038256,1.067016456e-11,9647,1025432,127048996
215,2051889916,79038256,1.067016456e-11,9647,1025432,128074428
216,2120890958,79056988,1.067269338e-11,9647,1025432,129099860
217,2051047792,79038256,1.067016456e-11,9647,1025432,130125292
218,2051332625,79038257,1.0670164694999999e-11,9668,1025432,131150724
219,2053179083,79038704,1.0670225039999998e-11,24198,1025880,132176604
220,2050651084,79038258,1.067016483e-11,9710,1025432,133202036
221,2053208750,79056987,1.0672693245e-11,9626,1025432,134227468
222,2053017125,79038256,1.067016456e-11,9647,1025432,135252900
223,2051430875,79038257,1.0670164694999999e-11,9668,1025432,136278332
224,2049863209,79038257,1.0670164694999999e-11,9668,1025432,137303764
225,2051481959,79038257,1.0670164694999999e-11,9668,1025432,138329196
226,3280021125,79056989,1.0672693514999999e-11,9689,1025432,139354628
227,6551463167,91133269,1.2302991314999998e-11,9689,-23101200,116253428
228,6475733125,79061836,1.067334786e-11,9689,1025432,117278860
229,3269310292,79038257,1.0670164694999999e-11,9689,1025432,118304292
230,2051358667,79038257,1.0670164694999999e-11,9689,1025432,119329724
231,3269335458,79061834,1.067334759e-11,9626,1025432,120355156
232,2052014083,79038256,1.067016456e-11,9647,1025432,121380588
233,3268888292,79038256,1.067016456e-11,9647,1025432,122406020
234,3267780042,79061836,1.067334786e-11,9668,1025432,123431452
235,2052419917,79038257,1.0670164694999999e-11,9668,1025432,124456884
236,3269563167,79038700,1.0670224499999999e-11,24066,1025880,125482764
237,2052276958,79038257,1.0670164694999999e-11,9689,1025432,126508196
238,3267073875,79061836,1.067334786e-11,9689,1025432,127533628
239,2052269208,79038257,1.0670164694999999e-11,9689,1025432,128559060
240,3274082708,79038258,1.067016483e-11,9710,1025432,129584492
241,14156023292,79061834,1.067334759e-11,9626,1025432,130609924
242,3253820125,79064193,1.0673666054999998e-11,9647,1025432,131635356
243,2064168666,79038257,1.0670164694999999e-11,9668,1025432,132660788
244,2052053208,79038257,1.0670164694999999e-11,9668,1025432,133686220
245,2052396459,79038257,1.0670164694999999e-11,9668,1025432,134711652
246,2051984750,79061836,1.067334786e-11,9668,1025432,135737084
247,2051847292,79038257,1.0670164694999999e-11,9689,1025432,136762516
248,3267471250,79038257,1.0670164694999999e-11,9689,1025432,137787948
249,3268965000,79038257,1.0670164694999999e-11,9689,1025432,138813380
250,3269254041,79061836,1.067334786e-11,9689,1025432,139838812
251,3269443166,79038255,1.0670164424999999e-11,9626,1025432,140864244
252,3268357583,79038256,1.067016456e-11,9647,1025432,141889676
253,3268099708,79064632,1.067372532e-11,23913,1025880,142915556
254,3269679917,79038257,1.0670164694999999e-11,9689,1025432,143940988
255,3269927500,79038258,1.067016483e-11,9710,1025432,144966420
256,3279956792,79038258,1.067016483e-11,9710,1025432,145991852
257,3268837292,79064195,1.0673666324999998e-11,9710,1025432,147017284
258,3253212333,79038258,1.067016483e-11,9710,1025432,148042716
259,3282434292,79038258,1.067016483e-11,9710,1025432,149068148
260,3274797666,79061837,1.0673347995e-11,9710,1025432,150093580
261,3278006000,79038256,1.067016456e-11,9647,1025432,151119012
262,3275787667,79038257,1.0670164694999999e-11,9668,1025432,152144444
263,3287769208,79061836,1.067334786e-11,9668,1025432,153169876
264,3295646625,79038257,1.0670164694999999e-11,9689,1025432,154195308
265,3266245625,79038257,1.0670164694999999e-11,9689,1025432,155220740
266,3458773916,79061836,1.067334786e-11,9689,1025432,156246172
267,28690081958,79097205,1.0678122674999998e-11,9689,1025432,157271604
268,2122000458,79038258,1.067016483e-11,9710,1025432,158297036
269,2052833208,79061837,1.0673347995e-11,9710,1025432,159322468
270,2104326458,79038693,1.0670223554999998e-11,23844,1025880,160348348
271,2053382708,79038272,1.0670166719999999e-11,10165,1025432,161373780
272,2105050375,79038273,1.0670166855e-11,10186,1025432,162399212
273,2051104500,79038273,1.0670166855e-11,10207,1025432,163424644
274,2106293500,79061852,1.067335002e-11,10207,1025432,164450076
275,2097140083,79038273,1.0670166855e-11,10207,1025432,165475508
276,2074061334,79038274,1.0670166989999999e-11,10228,1025432,166500940
277,2125408417,79038274,1.0670166989999999e-11,10228,1025432,167526372
278,2065149750,79038274,1.0670166989999999e-11,10228,1025432,168551804
279,2052245917,79061853,1.0673350154999999e-11,10228,1025432,169577236
280,2057760667,79038274,1.0670166989999999e-11,10228,1025432,170602668
281,2051496750,79038272,1.0670166719999999e-11,10165,1025432,171628100
282,2106399125,79038273,1.0670166855e-11,10186,1025432,172653532
283,2051437708,79061852,1.067335002e-11,10186,1025432,173678964
284,2107222792,79038273,1.0670166855e-11,10207,1025432,174704396
285,6470932292,94223516,1.272017466e-11,10207,-28747676,145956720
286,2052707459,79067773,1.0674149355e-11,10207,1025432,146982152
287,2052774833,79038704,1.0670225039999998e-11,24209,1025880,148008032
288,2052081583,79038274,1.0670166989999999e-11,10228,1025432,149033464
289,2066261875,79038274,1.0670166989999999e-11,10249,1025432,150058896
290,2326731792,79038274,1.0670166989999999e-11,10249,1025432,151084328
291,3146577750,79067772,1.0674149219999999e-11,10165,1025432,152109760
292,4200219541,79038273,1.0670166855e-11,10186,1025432,153135192
293,2810911834,79067773,1.0674149355e-11,10207,1025432,154160624
294,2723732666,79038273,1.0670166855e-11,10207,1025432,155186056
295,2743484500,79038273,1.0670166855e-11,10207,1025432,156211488
296,2176530334,79038273,1.0670166855e-11,10207,1025432,157236920
297,2052162709,79067774,1.0674149489999999e-11,10228,1025432,158262352
298,2048750209,79038274,1.0670166989999999e-11,10228,1025432,159287784
299,2081358708,79038274,1.0670166989999999e-11,10228,1025432,160313216
300,2056282042,79038274,1.0670166989999999e-11,10228,1025432,161338648
301,2127041542,79038267,1.0670166045e-11,10018,1025432,162364080
302,2135114833,79038269,1.0670166314999999e-11,10060,1025432,163389512
303,14117455167,79070720,1.0674547199999998e-11,10060,1025432,164414944
304,2062220250,79038695,1.0670223825e-11,23930,1025880,165440824
305,2081222333,79038271,1.0670166584999998e-11,10144,1025432,166466256
306,2064270000,79067771,1.0674149085e-11,10144,1025432,167491688
307,2097250959,79038271,1.0670166584999998e-11,10144,1025432,168517120
308,2072511708,79038271,1.0670166584999998e-11,10144,1025432,169542552
309,2069896125,79038271,1.0670166584999998e-11,10144,1025432,170567984
310,2073070625,79038271,1.0670166584999998e-11,10144,1025432,171593416
311,2088602834,79067769,1.0674148814999999e-11,10081,1025432,172618848
312,6467230209,79038271,1.0670166584999998e-11,10123,1025432,173644280
313,2059066708,79067771,1.0674149085e-11,10123,1025432,174669712
314,2055461166,79038271,1.0670166584999998e-11,10144,1025432,175695144
315,2052300875,79038271,1.0670166584999998e-11,10144,1025432,176720576
316,2063331375,79038271,1.0670166584999998e-11,10144,1025432,177746008
317,2052140042,79038271,1.0670166584999998e-11,10144,1025432,178771440
318,2052816000,79038272,1.0670166719999999e-11,10165,1025432,179796872
319,2051614583,79067772,1.0674149219999999e-11,10165,1025432,180822304
320,2053473625,79038272,1.0670166719999999e-11,10165,1025432,181847736
321,2079219875,79038692,1.067022342e-11,23819,1025880,182873616
322,2052120417,79038271,1.0670166584999998e-11,10144,1025432,183899048
323,2051752708,79038272,1.0670166719999999e-11,10165,1025432,184924480
324,2051526291,79067772,1.0674149219999999e-11,10165,1025432,185949912
325,2052951750,79038273,1.0670166855e-11,10186,1025432,186975344
326,2052934750,79038273,1.0670166855e-11,10186,1025432,188000776
327,2054491833,79038273,1.0670166855e-11,10186,1025432,189026208
328,2053290417,79038273,1.0670166855e-11,10186,1025432,190051640
329,2119315375,79067773,1.0674149355e-11,10186,1025432,191077072
330,2223220958,79038273,1.0670166855e-11,10186,1025432,192102504
331,3168950583,79038271,1.0670166584999998e-11,10123,1025432,193127936
332,3219146792,79067771,1.0674149085e-11,10144,1025432,194153368
333,2514991042,79038271,1.0670166584999998e-11,10144,1025432,195178800
334,2235168208,79038272,1.0670166719999999e-11,10165,1025432,196204232
335,2979654167,79067772,1.0674149219999999e-11,10165,1025432,197229664
336,2525392209,79038272,1.0670166719999999e-11,10165,1025432,198255096
337,2075764375,79038272,1.0670166719999999e-11,10165,1025432,199280528
338,2071299458,79038690,1.0670223149999998e-11,23771,1025880,200306408
339,2053418667,79067774,1.0674149489999999e-11,10228,1025432,201331840
340,2050304291,79038274,1.0670166989999999e-11,10228,1025432,202357272
341,2052254333,79038271,1.0670166584999998e-11,10144,1025432,203382704
342,2051700416,79038272,1.0670166719999999e-11,10165,1025432,204408136
343,2122553708,79038273,1.0670166855e-11,10186,1025432,205433568
344,2052564083,79067773,1.0674149355e-11,10186,1025432,206459000
345,2051993125,79038273,1.0670166855e-11,10186,1025432,207484432
346,2052741208,79038273,1.0670166855e-11,10207,1025432,208509864
347,2051867292,79038273,1.0670166855e-11,10207,1025432,209535296
348,2052017167,79038273,1.0670166855e-11,10207,1025432,210560728
349,2051926750,79067773,1.0674149355e-11,10207,1025432,211586160
350,2052305042,79038273,1.0670166855e-11,10207,1025432,212611592
351,2051894292,79038271,1.0670166584999998e-11,10144,1025432,213637024
352,2061383875,79038272,1.0670166719999999e-11,10165,1025432,214662456
353,2077285167,79038272,1.0670166719999999e-11,10165,1025432,215687888
354,2063937291,79067773,1.0674149355e-11,10186,1025432,216713320
355,2129666667,79038687,1.0670222745e-11,23660,1025880,217739200
356,2063438417,79038273,1.0670166855e-11,10207,1025432,218764632
357,2052071375,79038273,1.0670166855e-11,10207,1025432,219790064
358,8562418834,98150078,1.3250260529999999e-11,10207,-36447936,183342128
359,2051587625,79038273,1.0670166855e-11,10207,1025432,184367560
360,2052266750,79038273,1.0670166855e-11,10207,1025432,185392992
361,2051230791,79075272,1.0675161719999999e-11,10144,1025432,186418424
362,2051152625,79038272,1.0670166719999999e-11,10165,1025432,187443856
363,2051098750,79038273,1.0670166855e-11,10186,1025432,188469288
364,2060827500,79038273,1.0670166855e-11,10186,1025432,189494720
365,2052277834,79038273,1.0670166855e-11,10186,1025432,190520152
366,2052319458,79075274,1.067516199e-11,10186,1025432,191545584
367,8560721792,79038273,1.0670166855e-11,10207,1025432,192571016
368,2052280541,79075274,1.067516199e-11,10207,1025432,193596448
369,2051836208,79038273,1.0670166855e-11,10207,1025432,194621880
370,2051603542,79038273,1.0670166855e-11,10207,1025432,195647312
371,2049485875,79038271,1.0670166584999998e-11,10144,1025432,196672744
372,2051950667,79038682,1.0670222069999999e-11,23486,1025880,197698624
373,2051702292,79075274,1.067516199e-11,10186,1025432,198724056
374,2063334334,79038273,1.0670166855e-11,10186,1025432,199749488
375,2119782125,79038273,1.0670166855e-11,10207,1025432,200774920
376,2052045083,79038273,1.0670166855e-11,10207,1025432,201800352
377,2052336708,79038273,1.0670166855e-11,10207,1025432,202825784
378,2051531250,79075274,1.067516199e-11,10207,1025432,203851216
379,2052154875,79038273,1.0670166855e-11,10207,1025432,204876648
380,2052302209,79038273,1.0670166855e-11,10207,1025432,205902080
381,2051783250,79038271,1.0670166584999998e-11,10144,1025432,206927512
382,2053078541,79038272,1.0670166719999999e-11,10165,1025432,207952944
383,21981350917,79119675,1.0681156124999998e-11,10165,1025432,208978376
384,3361530042,79038273,1.0670166855e-11,10186,1025432,210003808
385,3283014417,79075274,1.067516199e-11,10186,1025432,211029240
386,3273763875,79038273,1.0670166855e-11,10186,1025432,212054672
387,3270862000,79038273,1.0670166855e-11,10186,1025432,213080104
388,2052373917,79075274,1.067516199e-11,10207,1025432,214105536
389,2049300792,79038680,1.0670221799999999e-11,23417,1025880,215131416
390,3270598583,79038274,1.0670166989999999e-11,10249,1025432,216156848
391,3276261208,79038272,1.0670166719999999e-11,10165,1025432,217182280
392,3266684541,79075274,1.067516199e-11,10186,1025432,218207712
393,3267019250,79038273,1.0670166855e-11,10207,1025432,219233144
394,3269153792,79038273,1.0670166855e-11,10207,1025432,220258576
395,2051345625,79075274,1.067516199e-11,10207,1025432,221284008
396,2082086541,79038274,1.0670166989999999e-11,10228,1025432,222309440
397,2050583166,79038274,1.0670166989999999e-11,10228,1025432,223334872
398,2104032042,79038274,1.0670166989999999e-11,10228,1025432,224360304
399,3266493125,79075275,1.0675162124999999e-11,10228,1025432,225385736
400,3269516542,79038274,1.0670166989999999e-11,10228,1025432,226411168
401,3267152416,79038267,1.0670166045e-11,10018,1025432,227436600
402,3327806083,79038269,1.0670166314999999e-11,10060,1025432,228462032
403,3279728208,79075270,1.0675161449999999e-11,10060,1025432,229487464
404,2110366500,79038270,1.067016645e-11,10102,1025432,230512896
405,3252219917,79038270,1.067016645e-11,10102,1025432,231538328
406,3265503208,79075673,1.0675215855e-11,23180,1025880,232564208
407,3265529834,79038271,1.0670166584999998e-11,10144,1025432,233589640
408,3264764833,79038271,1.0670166584999998e-11,10144,1025432,234615072
409,3265263833,79075272,1.0675161719999999e-11,10144,1025432,235640504
410,3265415833,79038273,1.0670166855e-11,10186,1025432,236665936
411,5035205334,79075271,1.0675161585e-11,10102,1025432,237691368
412,2664571875,79038271,1.0670166584999998e-11,10123,1025432,238716800
413,1394094334,79038271,1.0670166584999998e-11,10144,1025432,239742232
414,2764732417,79038271,1.0670166584999998e-11,10144,1025432,240767664
415,2741281584,79075272,1.0675161719999999e-11,10144,1025432,241793096
416,2420748583,79038271,1.0670166584999998e-11,10144,1025432,242818528
417,3034706875,79038272,1.0670166719999999e-11,10165,1025432,243843960
418,2612813167,79038272,1.0670166719999999e-11,10165,1025432,244869392
419,2573887292,79038272,1.0670166719999999e-11,10165,1025432,245894824
420,2074173875,79038272,1.0670166719999999e-11,10165,1025432,246920256
421,2051307292,79038270,1.067016645e-11,10102,1025432,247945688
422,2053777667,79038271,1.0670166584999998e-11,10123,1025432,248971120
423,2048372667,79075670,1.067521545e-11,23069,1025880,249997000
424,2145950750,79038272,1.0670166719999999e-11,10165,1025432,251022432
425,2059455125,79038273,1.0670166855e-11,10186,1025432,252047864
426,2089011333,79038273,1.0670166855e-11,10186,1025432,253073296
427,2061043833,79075274,1.067516199e-11,10186,1025432,254098728
428,2075983125,79038273,1.0670166855e-11,10186,1025432,255124160
429,2051188042,79038273,1.0670166855e-11,10186,1025432,256149592
430,2115571000,79038273,1.0670166855e-11,10186,1025432,257175024
431,2052462958,79038271,1.0670166584999998e-11,10123,1025432,258200456
432,2089278459,79038271,1.0670166584999998e-11,10144,1025432,259225888
433,8555014667,79075272,1.0675161719999999e-11,10144,1025432,260251320
434,2124065750,79075273,1.0675161855e-11,10165,1025432,261276752
435,2049067083,79038272,1.0670166719999999e-11,10165,1025432,262302184
436,2048454833,79038272,1.0670166719999999e-11,10165,1025432,263327616
437,2049383084,79038272,1.0670166719999999e-11,10165,1025432,264353048
438,2049286541,79038273,1.0670166855e-11,10186,1025432,265378480
439,2051019750,79075274,1.067516199e-11,10186,1025432,266403912
440,2052429750,79038667,1.0670220045e-11,23000,1025880,267429792
441,2051441542,79038274,1.0670166989999999e-11,10239,1025432,268455224
442,2051404791,79038275,1.0670167124999999e-11,10260,1025432,269480656
443,2049949292,79038275,1.0670167124999999e-11,10281,1025432,270506088
444,2049009458,79075276,1.067516226e-11,10281,1025432,271531520
445,2049266208,79038275,1.0670167124999999e-11,10281,1025432,272556952
446,2050542125,79038276,1.0670167259999998e-11,10302,1025432,273582384
447,2049444333,79038276,1.0670167259999998e-11,10302,1025432,274607816
448,2049650417,79038276,1.0670167259999998e-11,10302,1025432,275633248
449,11232015333,103054221,1.3912319834999997e-11,10302,-45687624,229945624
450,2796861167,79038273,1.0670166855e-11,10186,1025432,230971056
451,4437382125,79038271,1.0670166584999998e-11,10123,1025432,231996488
452,2402112875,79038271,1.0670166584999998e-11,10144,1025432,233021920
453,2889089875,79084592,1.0676419919999998e-11,10144,1025432,234047352
454,2839633583,79038272,1.0670166719999999e-11,10165,1025432,235072784
455,2483544084,79038272,1.0670166719999999e-11,10165,1025432,236098216
456,2744005750,79084593,1.0676420055e-11,10165,1025432,237123648
457,2066993833,79038662,1.067021937e-11,22847,1025880,238149528
458,2056823250,79038273,1.0670166855e-11,10207,1025432,239174960
459,2050941625,79038274,1.0670166989999999e-11,10228,1025432,240200392
460,2108146375,79084595,1.0676420325e-11,10228,1025432,241225824
461,2050339208,79038271,1.0670166584999998e-11,10144,1025432,242251256
462,2113324708,79038272,1.0670166719999999e-11,10165,1025432,243276688
463,2050547917,79038273,1.0670166855e-11,10186,1025432,244302120
464,2107165917,79038273,1.0670166855e-11,10186,1025432,245327552
465,2048889667,79084594,1.0676420189999999e-11,10186,1025432,246352984
466,2105763250,79038273,1.0670166855e-11,10186,1025432,247378416
467,2098985459,79038273,1.0670166855e-11,10207,1025432,248403848
468,2059197250,79038273,1.0670166855e-11,10207,1025432,249429280
469,2134452959,79038273,1.0670166855e-11,10207,1025432,250454712
470,2065869625,79084594,1.0676420189999999e-11,10207,1025432,251480144
471,2049893667,79038271,1.0670166584999998e-11,10144,1025432,252505576
472,2104130917,79038272,1.0670166719999999e-11,10165,1025432,253531008
473,2049719291,79038272,1.0670166719999999e-11,10165,1025432,254556440
474,2111050792,79038658,1.0670218829999998e-11,22715,1025880,255582320
475,2050098833,79084594,1.0676420189999999e-11,10207,1025432,256607752
476,2108477417,79038273,1.0670166855e-11,10207,1025432,257633184
477,2049344708,79038273,1.0670166855e-11,10207,1025432,258658616
478,2105282167,79038273,1.0670166855e-11,10207,1025432,259684048
479,2049170291,79038273,1.0670166855e-11,10207,1025432,260709480
480,2104484042,79084594,1.0676420189999999e-11,10207,1025432,261734912
481,2048607959,79038271,1.0670166584999998e-11,10144,1025432,262760344
482,27154695834,79158707,1.0686425444999999e-11,10165,1025432,263785776
483,2049850708,79038272,1.0670166719999999e-11,10165,1025432,264811208
484,2050046208,79038273,1.0670166855e-11,10186,1025432,265836640
485,2050796125,79038273,1.0670166855e-11,10186,1025432,266862072
486,2049548250,79084594,1.0676420189999999e-11,10186,1025432,267887504
487,2048810916,79038276,1.0670167259999998e-11,10302,1025432,268912936
488,2050228208,79038277,1.0670167395e-11,10323,1025432,269938368
489,2048886000,79038277,1.0670167395e-11,10323,1025432,270963800
490,2053396875,79038277,1.0670167395e-11,10323,1025432,271989232
491,2048518583,79084977,1.0676471895e-11,22657,1025880,273015112
492,2123361875,79038275,1.0670167124999999e-11,10281,1025432,274040544
493,2058296334,79038276,1.0670167259999998e-11,10302,1025432,275065976
494,2049753042,79038276,1.0670167259999998e-11,10302,1025432,276091408
495,2049660000,79038277,1.0670167395e-11,10323,1025432,277116840
496,2049651958,79084598,1.067642073e-11,10323,1025432,278142272
497,2049739958,79038277,1.0670167395e-11,10323,1025432,279167704
498,2050053709,79038277,1.0670167395e-11,10323,1025432,280193136
499,2050446667,79038277,1.0670167395e-11,10323,1025432,281218568
500,2050540167,79084598,1.067642073e-11,10323,1025432,282244000
501,3266128875,79038271,1.0670166584999998e-11,10134,1025432,283269432
502,3267975625,79038272,1.0670166719999999e-11,10176,1025432,284294864
503,2048666625,79038272,1.0670166719999999e-11,10176,1025432,285320296
504,2049646417,79038273,1.0670166855e-11,10218,1025432,286345728
505,3265276167,79084594,1.0676420189999999e-11,10218,1025432,287371160
506,3267364041,79038273,1.0670166855e-11,10218,1025432,288396592
507,11077468875,79084594,1.0676420189999999e-11,10218,1025432,289422024
508,3270013250,79038652,1.067021802e-11,22504,1025880,290447904
509,3268395084,79084597,1.0676420594999999e-11,10302,1025432,291473336
510,3269405166,79038276,1.0670167259999998e-11,10302,1025432,292498768
511,3268890125,79038273,1.0670166855e-11,10218,1025432,293524200
512,3269526709,79084595,1.0676420325e-11,10239,1025432,294549632
513,3275208875,79038275,1.0670167124999999e-11,10260,1025432,295575064
514,3351934208,79038275,1.0670167124999999e-11,10260,1025432,296600496
515,3294296917,79084596,1.0676420459999999e-11,10260,1025432,297625928
516,2336547833,79038275,1.0670167124999999e-11,10281,1025432,298651360
517,2486530083,79038275,1.0670167124999999e-11,10281,1025432,299676792
518,2207341500,79084596,1.0676420459999999e-11,10281,1025432,300702224
519,2666331875,79038275,1.0670167124999999e-11,10281,1025432,301727656
520,3155087875,79038275,1.0670167124999999e-11,10281,1025432,302753088
521,2807060333,79084594,1.0676420189999999e-11,10218,1025432,303778520
522,3819345292,79038274,1.0670166989999999e-11,10239,1025432,304803952
523,2722535084,79038274,1.0670166989999999e-11,10239,1025432,305829384
524,2260002583,79038275,1.0670167124999999e-11,10260,1025432,306854816
525,2127998125,79084970,1.0676470949999999e-11,22414,1025880,307880696
526,2051225500,79038276,1.0670167259999998e-11,10302,1025432,308906128
527,2051568333,79038276,1.0670167259999998e-11,10302,1025432,309931560
528,2052918667,79038276,1.0670167259999998e-11,10302,1025432,310956992
529,2052007833,79084597,1.0676420594999999e-11,10302,1025432,311982424
530,2052134208,79038276,1.0670167259999998e-11,10302,1025432,313007856
531,2052640333,79038274,1.0670166989999999e-11,10239,1025432,314033288
532,2051729417,79038275,1.0670167124999999e-11,10260,1025432,315058720
533,2051418542,79038275,1.0670167124999999e-11,10281,1025432,316084152
534,2075429959,79084596,1.0676420459999999e-11,10281,1025432,317109584
535,2058528958,79038275,1.0670167124999999e-11,10281,1025432,318135016
536,2123789708,79038275,1.0670167124999999e-11,10281,1025432,319160448
537,2062329250,79038276,1.0670167259999998e-11,10302,1025432,320185880
538,2052263834,79038276,1.0670167259999998e-11,10302,1025432,321211312
539,2052532500,79084597,1.0676420594999999e-11,10302,1025432,322236744
540,2052025709,79038276,1.0670167259999998e-11,10302,1025432,323262176
541,2050938083,79038274,1.0670166989999999e-11,10239,1025432,324287608
542,2052872625,79038644,1.0670216939999998e-11,22261,1025880,325313488
543,2051108250,79038290,1.0670169149999998e-11,10765,1025432,326338920
544,2049961167,79084611,1.0676422484999999e-11,10765,1025432,327364352
545,2051825041,79038291,1.0670169285e-11,10786,1025432,328389784
546,2094190750,79038291,1.0670169285e-11,10786,1025432,329415216
547,2052964958,79038291,1.0670169285e-11,10786,1025432,330440648
548,2051187416,79038291,1.0670169285e-11,10786,1025432,331466080
549,2051618125,79084612,1.067642262e-11,10786,1025432,332491512
550,2050576834,79038291,1.0670169285e-11,10786,1025432,333516944
551,2051186958,79038289,1.0670169014999999e-11,10723,1025432,334542376
552,2051101167,79038290,1.0670169149999998e-11,10744,1025432,335567808
553,2050393541,79038290,1.0670169149999998e-11,10744,1025432,336593240
554,2049958750,79084611,1.0676422484999999e-11,10765,1025432,337618672
555,2087984791,79038290,1.0670169149999998e-11,10765,1025432,338644104
556,3275292666,79038290,1.0670169149999998e-11,10765,1025432,339669536
557,3344986791,79038290,1.0670169149999998e-11,10765,1025432,340694968
558,2091133000,79084612,1.067642262e-11,10786,1025432,341720400
559,2052358917,79039651,1.0670352885e-11,54989,1027060,342747460
560,2050832958,79038307,1.0670171445e-11,11297,1025456,343772916
561,2051460375,79038304,1.067017104e-11,11213,1025456,344798372
562,2052360250,79038305,1.0670171175e-11,11234,1025456,345823828
563,14072110458,109140294,1.4733939689999997e-11,11255,-57495008,288328820
564,2051046208,79038305,1.0670171175e-11,11255,1025456,289354276
565,2052220333,79038305,1.0670171175e-11,11255,1025456,290379732
566,2048793333,79038306,1.0670171309999999e-11,11276,1025456,291405188
567,2050720875,79096326,1.067800401e-11,11276,1025456,292430644
568,3268083208,79038306,1.0670171309999999e-11,11276,1025456,293456100
569,2051829833,79038306,1.0670171309999999e-11,11276,1025456,294481556
570,3267985208,79038306,1.0670171309999999e-11,11276,1025456,295507012
571,3268183916,79096324,1.0678003739999999e-11,11213,1025456,296532468
572,3267674042,79038305,1.0670171175e-11,11234,1025456,297557924
573,3269500292,79038305,1.0670171175e-11,11234,1025456,298583380
574,3268890541,79096325,1.0678003875e-11,11255,1025456,299608836
575,3278163333,79038305,1.0670171175e-11,11255,1025456,300634292
576,3275564958,79038736,1.0670229359999998e-11,25257,1025904,301660196
577,3337847000,79096327,1.0678004144999999e-11,11297,1025456,302685652
578,3277763166,79038307,1.0670171445e-11,11297,1025456,303711108
579,3267400708,79038307,1.0670171445e-11,11297,1025456,304736564
580,3267968334,79096327,1.0678004144999999e-11,11318,1025456,305762020
581,3266159958,79038305,1.0670171175e-11,11234,1025456,306787476
582,2051843625,79038305,1.0670171175e-11,11255,1025456,307812932
583,2051376750,79038306,1.0670171309999999e-11,11276,1025456,308838388
584,3271194459,79096326,1.067800401e-11,11276,1025456,309863844
585,3300709542,79038306,1.0670171309999999e-11,11276,1025456,310889300
586,3277626791,79038306,1.0670171309999999e-11,11276,1025456,311914756
587,3343714541,79096327,1.0678004144999999e-11,11297,1025456,312940212
588,2059912458,79038307,1.0670171445e-11,11297,1025456,313965668
589,2053157334,79038307,1.0670171445e-11,11297,1025456,314991124
590,3267338625,79038307,1.0670171445e-11,11297,1025456,316016580
591,3265856000,79096325,1.0678003875e-11,11234,1025456,317042036
592,3296891167,79038305,1.0670171175e-11,11255,1025456,318067492
593,4723697167,79038732,1.067022882e-11,25125,1025904,319093396
594,3315268708,79096326,1.067800401e-11,11276,1025456,320118852
595,14072044166,79096327,1.0678004144999999e-11,11297,1025456,321144308
596,3268316000,79038307,1.0670171445e-11,11297,1025456,322169764
597,4800061333,79102129,1.0678787415e-11,11297,1025456,323195220
598,3282173667,79038307,1.0670171445e-11,11297,1025456,324220676
599,3327981833,79038307,1.0670171445e-11,11297,1025456,325246132
600,4738533000,79096327,1.0678004144999999e-11,11297,1025456,326271588
601,27183810917,79038300,1.0670170499999999e-11,11087,1025456,327297044
602,8638274250,79229767,1.0696018544999998e-11,11129,1025456,328322500
603,3269330541,79038301,1.0670170635e-11,11129,1025456,329347956
604,3278340875,79096323,1.0678003605e-11,11171,1025456,330373412
605,2191270083,79038303,1.0670170904999999e-11,11171,1025456,331398868
606,2386369000,79038303,1.0670170904999999e-11,11171,1025456,332424324
607,2182097083,79096323,1.0678003605e-11,11171,1025456,333449780
608,2473764709,79038304,1.067017104e-11,11213,1025456,334475236
609,2388001500,79038304,1.067017104e-11,11213,1025456,335500692
610,3381707083,79096747,1.0678060845e-11,24951,1025904,336526596
611,2113209416,79038303,1.0670170904999999e-11,11171,1025456,337552052
612,2693510625,79038303,1.0670170904999999e-11,11192,1025456,338577508
613,2474319875,79096324,1.0678003739999999e-11,11213,1025456,339602964
614,2055022708,79038304,1.067017104e-11,11213,1025456,340628420
615,2075885083,79038304,1.067017104e-11,11213,1025456,341653876
616,2051278834,79038305,1.0670171175e-11,11234,1025456,342679332
617,2106530792,79038305,1.0670171175e-11,11234,1025456,343704788
618,2051695125,79096325,1.0678003875e-11,11234,1025456,344730244
619,2120897583,79038305,1.0670171175e-11,11234,1025456,345755700
620,2051352584,79038305,1.0670171175e-11,11234,1025456,346781156
621,2124025875,79038303,1.0670170904999999e-11,11171,1025456,347806612
622,2058182583,79038303,1.0670170904999999e-11,11192,1025456,348832068
623,2126309750,79096323,1.0678003605e-11,11192,1025456,349857524
624,2051784708,79038304,1.067017104e-11,11213,1025456,350882980
625,2111800667,79038304,1.067017104e-11,11213,1025456,351908436
626,2052114416,79038304,1.067017104e-11,11213,1025456,352933892
627,2107536750,79038723,1.0670227604999999e-11,24819,1025904,353959796
628,2050727292,79096325,1.0678003875e-11,11255,1025456,354985252
629,2106204375,79038306,1.0670171309999999e-11,11276,1025456,356010708
630,2051681500,79038306,1.0670171309999999e-11,11276,1025456,357036164
631,2109027833,79038303,1.0670170904999999e-11,11192,1025456,358061620
632,2051705708,79038304,1.067017104e-11,11213,1025456,359087076
633,2121870041,79096325,1.0678003875e-11,11234,1025456,360112532
634,2082940500,79038305,1.0670171175e-11,11234,1025456,361137988
635,2063157125,79038305,1.0670171175e-11,11234,1025456,362163444
636,2138202500,79038305,1.0670171175e-11,11234,1025456,363188900
637,2067577167,79096325,1.0678003875e-11,11255,1025456,364214356
638,2051362791,79038305,1.0670171175e-11,11255,1025456,365239812
639,2106993167,79038305,1.0670171175e-11,11255,1025456,366265268
640,3268672833,79038305,1.0670171175e-11,11255,1025456,367290724
641,3270166875,79038303,1.0670170904999999e-11,11192,1025456,368316180
642,2052971916,79096324,1.0678003739999999e-11,11213,1025456,369341636
643,3272523917,79038304,1.067017104e-11,11213,1025456,370367092
644,2052837250,79038719,1.0670227065e-11,24687,1025904,371392996
645,2052315458,79038306,1.0670171309999999e-11,11276,1025456,372418452
646,2053335709,79096326,1.067800401e-11,11276,1025456,373443908
647,3277639500,79038306,1.0670171309999999e-11,11276,1025456,374469364
648,3251582500,79038306,1.0670171309999999e-11,11276,1025456,375494820
649,2126928625,79038306,1.0670171309999999e-11,11276,1025456,376520276
650,3274572959,79096326,1.067800401e-11,11276,1025456,377545732
651,3268590333,79038304,1.067017104e-11,11213,1025456,378571188
652,3267362250,79038305,1.0670171175e-11,11234,1025456,379596644
653,3267865166,79096325,1.0678003875e-11,11234,1025456,380622100
654,2050125208,79038305,1.0670171175e-11,11255,1025456,381647556
655,3268500916,79038305,1.0670171175e-11,11255,1025456,382673012
656,3269070625,79096325,1.0678003875e-11,11255,1025456,383698468
657,3268680792,79038305,1.0670171175e-11,11255,1025456,384723924
658,3268976417,79038306,1.0670171309999999e-11,11276,1025456,385749380
659,3267906084,79038306,1.0670171309999999e-11,11276,1025456,386774836
660,3266822209,79096326,1.067800401e-11,11276,1025456,387800292
661,3317605416,79038714,1.0670226389999999e-11,24534,1025904,388826196
662,3271700500,79038305,1.0670171175e-11,11234,1025456,389851652
663,3342675833,79096325,1.0678003875e-11,11255,1025456,390877108
664,3276533750,79038305,1.0670171175e-11,11255,1025456,391902564
665,3267658834,79038306,1.0670171309999999e-11,11276,1025456,392928020
666,3268827791,79096326,1.067800401e-11,11276,1025456,393953476
667,4722906500,79038306,1.0670171309999999e-11,11276,1025456,394978932
668,3269246000,79038306,1.0670171309999999e-11,11276,1025456,396004388
669,4727473208,79096326,1.067800401e-11,11276,1025456,397029844
670,4729948791,79038306,1.0670171309999999e-11,11276,1025456,398055300
671,2124240000,79096324,1.0678003739999999e-11,11213,1025456,399080756
672,3270450459,79038305,1.0670171175e-11,11234,1025456,400106212
673,3267533625,79038305,1.0670171175e-11,11234,1025456,401131668
674,3268758333,79038305,1.0670171175e-11,11255,1025456,402157124
675,3267073750,79096325,1.0678003875e-11,11255,1025456,403182580
676,3267681708,79038305,1.0670171175e-11,11255,1025456,404208036
677,3266506708,79038305,1.0670171175e-11,11255,1025456,405233492
678,3268574042,79096732,1.0678058819999999e-11,24465,1025904,406259396
679,3282617041,79038307,1.0670171445e-11,11297,1025456,407284852
680,3268282875,79038307,1.0670171445e-11,11297,1025456,408310308
681,3267285958,79096324,1.0678003739999999e-11,11213,1025456,409335764
682,3268980959,79038305,1.0670171175e-11,11234,1025456,410361220
683,3301355250,79038305,1.0670171175e-11,11255,1025456,411386676
684,3276304500,79096325,1.0678003875e-11,11255,1025456,412412132
685,3267360167,79038305,1.0670171175e-11,11255,1025456,413437588
686,3267943042,79038306,1.0670171309999999e-11,11276,1025456,414463044
687,4725585083,79038306,1.0670171309999999e-11,11276,1025456,415488500
688,3377072125,79102128,1.0678787279999999e-11,11276,1025456,416513956
689,2241330375,79038306,1.0670171309999999e-11,11276,1025456,417539412
690,3158622792,79096326,1.067800401e-11,11276,1025456,418564868
691,4000671666,79038304,1.067017104e-11,11213,1025456,419590324
692,2467880917,79038305,1.0670171175e-11,11234,1025456,420615780
693,3458504792,79096325,1.0678003875e-11,11234,1025456,421641236
694,2298429500,79038305,1.0670171175e-11,11255,1025456,422666692
695,2345434375,79038708,1.067022558e-11,24333,1025904,423692596
696,2621642416,79038306,1.0670171309999999e-11,11276,1025456,424718052
697,14103860417,79165950,1.068740325e-11,11276,1025456,425743508
698,2087751625,79038306,1.0670171309999999e-11,11276,1025456,426768964
699,2087594417,79038306,1.0670171309999999e-11,11276,1025456,427794420
700,2089831708,79038306,1.0670171309999999e-11,11276,1025456,428819876
701,2076661042,79096320,1.0678003199999998e-11,11087,1025456,429845332
702,2114868750,79038301,1.0670170635e-11,11129,1025456,430870788
703,2075441958,79038303,1.0670170904999999e-11,11171,1025456,431896244
704,2110169083,79038303,1.0670170904999999e-11,11171,1025456,432921700
705,14051449417,116746886,1.576082961e-11,11171,-71870904,361050796
706,2098347250,79038303,1.0670170904999999e-11,11171,1025456,362076252
707,2056822375,79038304,1.067017104e-11,11213,1025456,363101708
708,2101136042,79038304,1.067017104e-11,11213,1025456,364127164
709,2046760834,79038304,1.067017104e-11,11213,1025456,365152620
710,2142439750,79038304,1.067017104e-11,11213,1025456,366178076
711,2049114458,79110865,1.0679966774999998e-11,11150,1025456,367203532
712,2067947625,79038701,1.0670224635e-11,24096,1025904,368229436
713,2059765791,79038304,1.067017104e-11,11213,1025456,369254892
714,2086847250,79038304,1.067017104e-11,11213,1025456,370280348
715,2057579042,79110868,1.0679967179999998e-11,11234,1025456,371305804
716,2087240459,79038305,1.0670171175e-11,11234,1025456,372331260
717,2060238458,79038305,1.0670171175e-11,11234,1025456,373356716
718,2087976875,79038305,1.0670171175e-11,11234,1025456,374382172
719,2058428042,79038305,1.0670171175e-11,11234,1025456,375407628
720,2085633375,79110868,1.0679967179999998e-11,11234,1025456,376433084
721,2063103417,79038303,1.0670170904999999e-11,11171,1025456,377458540
722,2090131541,79038303,1.0670170904999999e-11,11192,1025456,378483996
723,2112499084,79038303,1.0670170904999999e-11,11192,1025456,379509452
724,2048234250,79038304,1.067017104e-11,11213,1025456,380534908
725,2131607541,79110867,1.0679967045e-11,11213,1025456,381560364
726,2077892208,79038304,1.067017104e-11,11213,1025456,382585820
727,2059213833,79038304,1.067017104e-11,11213,1025456,383611276
728,2104340250,79038305,1.0670171175e-11,11234,1025456,384636732
729,2048966959,79038699,1.0670224364999999e-11,24048,1025904,385662636
730,2071513750,79110869,1.0679967314999999e-11,11276,1025456,386688092
731,2062085500,79038303,1.0670170904999999e-11,11192,1025456,387713548
732,2187954166,79038304,1.067017104e-11,11213,1025456,388739004
733,3503378334,79038305,1.0670171175e-11,11234,1025456,389764460
734,3787392250,79038305,1.0670171175e-11,11234,1025456,390789916
735,3740919958,79038305,1.0670171175e-11,11234,1025456,391815372
736,2655983167,79110868,1.0679967179999998e-11,11255,1025456,392840828
737,2970308959,79038305,1.0670171175e-11,11255,1025456,393866284
738,2608763708,79038305,1.0670171175e-11,11255,1025456,394891740
739,3790982375,79110868,1.0679967179999998e-11,11255,1025456,395917196
740,2070699458,79038305,1.0670171175e-11,11255,1025456,396942652
741,2128433542,79038303,1.0670170904999999e-11,11192,1025456,397968108
742,2053696500,79038304,1.067017104e-11,11213,1025456,398993564
743,2072426125,79110867,1.0679967045e-11,11213,1025456,400019020
744,2057647625,79038305,1.0670171175e-11,11234,1025456,401044476
745,2050490833,79038305,1.0670171175e-11,11234,1025456,402069932
746,2050991542,79038695,1.0670223825e-11,23916,1025904,403095836
747,2053560042,79038305,1.0670171175e-11,11255,1025456,404121292
748,2052201833,79110868,1.0679967179999998e-11,11255,1025456,405146748
749,40818473917,79285019,1.0703477565e-11,11255,1025456,406172204
750,2082135291,79038306,1.0670171309999999e-11,11276,1025456,407197660
751,2067328500,79110866,1.0679966909999999e-11,11192,1025456,408223116
752,2065624167,79038304,1.067017104e-11,11213,1025456,409248572
753,2052676459,79038305,1.0670171175e-11,11234,1025456,410274028
754,2049641791,79038305,1.0670171175e-11,11234,1025456,411299484
755,2051814250,79038305,1.0670171175e-11,11234,1025456,412324940
756,2051621584,79038305,1.0670171175e-11,11234,1025456,413350396
757,2051536459,79110868,1.0679967179999998e-11,11255,1025456,414375852
758,2051725875,79038305,1.0670171175e-11,11255,1025456,415401308
759,2051801833,79038305,1.0670171175e-11,11255,1025456,416426764
760,2057492000,79038305,1.0670171175e-11,11255,1025456,417452220
761,2069450792,79038303,1.0670170904999999e-11,11192,1025456,418477676
762,2070409958,79110867,1.0679967045e-11,11213,1025456,419503132
763,2133871708,79038690,1.0670223149999998e-11,23763,1025904,420529036
764,2076447917,79038305,1.0670171175e-11,11255,1025456,421554492
765,2215768792,79038306,1.0670171309999999e-11,11276,1025456,422579948
766,2845498167,79110869,1.0679967314999999e-11,11276,1025456,423605404
767,2317658000,79038306,1.0670171309999999e-11,11276,1025456,424630860
768,3478064875,79038306,1.0670171309999999e-11,11276,1025456,425656316
769,3999026250,79110869,1.0679967314999999e-11,11276,1025456,426681772
770,2979016875,79038306,1.0670171309999999e-11,11276,1025456,427707228
771,3512944250,79038304,1.067017104e-11,11213,1025456,428732684
772,2674409625,79110868,1.0679967179999998e-11,11234,1025456,429758140
773,2141032334,79038305,1.0670171175e-11,11234,1025456,430783596
774,2050736125,79038305,1.0670171175e-11,11255,1025456,431809052
775,2050865375,79038305,1.0670171175e-11,11255,1025456,432834508
776,2053402083,79110868,1.0679967179999998e-11,11255,1025456,433859964
777,2057519625,79038305,1.0670171175e-11,11255,1025456,434885420
778,2066265834,79038306,1.0670171309999999e-11,11276,1025456,435910876
779,2051167750,79038306,1.0670171309999999e-11,11276,1025456,436936332
780,2121773000,79038688,1.0670222879999999e-11,23694,1025904,437962236
781,2052088583,79110867,1.0679967045e-11,11213,1025456,438987692
782,2122166500,79038305,1.0670171175e-11,11234,1025456,440013148
783,2052445084,79038305,1.0670171175e-11,11255,1025456,441038604
784,2052070042,79038305,1.0670171175e-11,11255,1025456,442064060
785,2051589917,79038305,1.0670171175e-11,11255,1025456,443089516
786,2051493334,79110869,1.0679967314999999e-11,11276,1025456,444114972
787,2051981292,79038306,1.0670171309999999e-11,11276,1025456,445140428
788,2051709167,79038306,1.0670171309999999e-11,11276,1025456,446165884
789,2050232375,79038306,1.0670171309999999e-11,11276,1025456,447191340
790,2063173000,79038306,1.0670171309999999e-11,11276,1025456,448216796
791,2083175875,79110867,1.0679967045e-11,11213,1025456,449242252
792,2058117875,79038305,1.0670171175e-11,11234,1025456,450267708
793,2121932333,79038305,1.0670171175e-11,11234,1025456,451293164
794,2059132708,79038305,1.0670171175e-11,11255,1025456,452318620
795,2053734833,79038305,1.0670171175e-11,11255,1025456,453344076
796,2052055875,79110868,1.0679967179999998e-11,11255,1025456,454369532
797,2051924084,79038683,1.0670222205e-11,23541,1025904,455395436
798,2050344917,79038306,1.0670171309999999e-11,11276,1025456,456420892
799,2050628208,79038307,1.0670171445e-11,11297,1025456,457446348
800,2051369750,79038307,1.0670171445e-11,11297,1025456,458471804
801,2053104666,79110863,1.0679966504999999e-11,11087,1025456,459497260
802,2061895375,79038301,1.0670170635e-11,11129,1025456,460522716
803,2051546917,79038303,1.0670170904999999e-11,11171,1025456,461548172
804,2051065167,79038303,1.0670170904999999e-11,11171,1025456,462573628
805,3268036875,79110866,1.0679966909999999e-11,11171,1025456,463599084
806,2051647875,79038303,1.0670170904999999e-11,11171,1025456,464624540
807,2050908333,79038304,1.067017104e-11,11213,1025456,465649996
808,2052357209,79038304,1.067017104e-11,11213,1025456,466675452
809,2051501375,79038304,1.067017104e-11,11213,1025456,467700908
810,2051210750,79110867,1.0679967045e-11,11213,1025456,468726364
811,2050315250,79038302,1.067017077e-11,11150,1025456,469751820
812,2051231041,79038303,1.0670170904999999e-11,11171,1025456,470777276
813,3268059708,79038303,1.0670170904999999e-11,11171,1025456,471802732
814,2051343834,79038677,1.0670221394999999e-11,23325,1025904,472828636
815,3269523333,79110868,1.0679967179999998e-11,11234,1025456,473854092
816,17674673666,79118124,1.068094674e-11,11234,1025456,474879548
817,2051093542,79110868,1.0679967179999998e-11,11234,1025456,475905004
818,2051316167,79038305,1.0670171175e-11,11234,1025456,476930460
819,3269374750,79038305,1.0670171175e-11,11234,1025456,477955916
820,2051835292,79038305,1.0670171175e-11,11234,1025456,478981372
821,3266497667,79110866,1.0679966909999999e-11,11171,1025456,480006828
822,2051673667,79038303,1.0670170904999999e-11,11192,1025456,481032284
823,3268866292,79038303,1.0670170904999999e-11,11192,1025456,482057740
824,3266564959,79038304,1.067017104e-11,11213,1025456,483083196
825,3280300708,79110867,1.0679967045e-11,11213,1025456,484108652
826,3275674750,79038304,1.067017104e-11,11213,1025456,485134108
827,3342241166,79038304,1.067017104e-11,11213,1025456,486159564
828,3275045041,79110868,1.0679967179999998e-11,11234,1025456,487185020
829,3270162417,79038305,1.0670171175e-11,11234,1025456,488210476
830,3268070958,79038305,1.0670171175e-11,11234,1025456,489235932
831,3268832583,79111235,1.0680016725e-11,23172,1025904,490261836
832,3269382958,79038318,1.0670172929999999e-11,11676,1025456,491287292
833,3299933875,79038319,1.0670173065e-11,11697,1025456,492312748
834,3275570583,79110882,1.0679969069999998e-11,11697,1025456,493338204
835,3268882125,79038320,1.0670173199999999e-11,11718,1025456,494363660
836,3265176166,79038320,1.0670173199999999e-11,11718,1025456,495389116
837,3318012750,79110883,1.0679969205e-11,11718,1025456,496414572
838,3277289000,79038320,1.0670173199999999e-11,11718,1025456,497440028
839,3289276958,79038320,1.0670173199999999e-11,11718,1025456,498465484
840,3274522125,79110883,1.0679969205e-11,11718,1025456,499490940
841,3315992959,79038318,1.0670172929999999e-11,11655,1025456,500516396
842,3265399291,79038318,1.0670172929999999e-11,11676,1025456,501541852
843,3289492958,79038318,1.0670172929999999e-11,11676,1025456,502567308
844,3276235917,79110882,1.0679969069999998e-11,11697,1025456,503592764
845,2180995833,79038319,1.0670173065e-11,11697,1025456,504618220
846,2189372750,79038319,1.0670173065e-11,11697,1025456,505643676
847,2293722208,79110882,1.0679969069999998e-11,11697,1025456,506669132
848,2267376917,79039572,1.0670342219999999e-11,52423,1026708,507695840
849,3379525333,79038307,1.0670171445e-11,11297,1025456,508721296
850,4231155042,79110870,1.067996745e-11,11297,1025456,509746752
851,5234115542,79038304,1.067017104e-11,11213,1025456,510772208
852,2452060708,79038305,1.0670171175e-11,11234,1025456,511797664
853,3412824208,79110868,1.0679967179999998e-11,11255,1025456,512823120
854,2063773042,79038305,1.0670171175e-11,11255,1025456,513848576
855,2076100291,79038305,1.0670171175e-11,11255,1025456,514874032
856,2084925917,79110869,1.0679967314999999e-11,11276,1025456,515899488
857,2062022041,79038306,1.0670171309999999e-11,11276,1025456,516924944
858,2099277958,79038306,1.0670171309999999e-11,11276,1025456,517950400
859,2112806625,79038306,1.0670171309999999e-11,11276,1025456,518975856
860,2062519292,79038306,1.0670171309999999e-11,11276,1025456,520001312
861,2134060042,79110867,1.0679967045e-11,11213,1025456,521026768
862,2072956458,79038305,1.0670171175e-11,11234,1025456,522052224
863,2058064333,79038305,1.0670171175e-11,11234,1025456,523077680
864,2083767084,79038305,1.0670171175e-11,11255,1025456,524103136
865,2059328500,79038736,1.0670229359999998e-11,25257,1025904,525129040
866,2091788834,79110869,1.0679967314999999e-11,11276,1025456,526154496
867,2057808083,79038306,1.0670171309999999e-11,11276,1025456,527179952
868,2087708292,79038306,1.0670171309999999e-11,11276,1025456,528205408
869,2058747958,79038306,1.0670171309999999e-11,11276,1025456,529230864
870,2088245750,79038306,1.0670171309999999e-11,11276,1025456,530256320
871,2058804792,79110867,1.0679967045e-11,11213,1025456,531281776
872,2085018000,79038305,1.0670171175e-11,11234,1025456,532307232
873,2060703750,79038305,1.0670171175e-11,11255,1025456,533332688
874,2116924209,79038305,1.0670171175e-11,11255,1025456,534358144
875,2055263459,79038305,1.0670171175e-11,11255,1025456,535383600
876,2088889959,79110868,1.0679967179999998e-11,11255,1025456,536409056
877,2059895792,79038306,1.0670171309999999e-11,11276,1025456,537434512
878,2085712709,79038306,1.0670171309999999e-11,11276,1025456,538459968
879,2059608334,79038306,1.0670171309999999e-11,11276,1025456,539485424
880,2089183292,79038306,1.0670171309999999e-11,11276,1025456,540510880
881,2058390917,79110867,1.0679967045e-11,11213,1025456,541536336
882,2082587667,79038731,1.0670228684999999e-11,25083,1025904,542562240
883,17680987209,126176764,1.7033863139999998e-11,11276,-90352400,452209840
884,2082068167,79129138,1.0682433629999999e-11,11276,1025456,453235296
885,2057260750,79038307,1.0670171445e-11,11297,1025456,454260752
886,2052154292,79038307,1.0670171445e-11,11297,1025456,455286208
887,2070191375,79038307,1.0670171445e-11,11297,1025456,456311664
888,2086177875,79038307,1.0670171445e-11,11297,1025456,457337120
889,2061894792,79129139,1.0682433765e-11,11297,1025456,458362576
890,2117921542,79038307,1.0670171445e-11,11297,1025456,459388032
891,2060399541,79038305,1.0670171175e-11,11234,1025456,460413488
892,2052539667,79038305,1.0670171175e-11,11255,1025456,461438944
893,3268807959,79129137,1.0682433494999998e-11,11255,1025456,462464400
894,3268073000,79038306,1.0670171309999999e-11,11276,1025456,463489856
895,3269110458,79038306,1.0670171309999999e-11,11276,1025456,464515312
896,3268462417,79038306,1.0670171309999999e-11,11276,1025456,465540768
897,2051890042,79129138,1.0682433629999999e-11,11276,1025456,466566224
898,3269165667,79038307,1.0670171445e-11,11297,1025456,467591680
899,3267183583,79038729,1.0670228415e-11,25035,1025904,468617584
900,3273633250,79129139,1.0682433765e-11,11318,1025456,469643040
901,3268218625,79038300,1.0670170499999999e-11,11087,1025456,470668496
902,2051461708,79038301,1.0670170635e-11,11129,1025456,471693952
903,3268385000,79038303,1.0670170904999999e-11,11171,1025456,472719408
904,3269054292,79129135,1.0682433224999999e-11,11171,1025456,473744864
905,2050503291,79038303,1.0670170904999999e-11,11171,1025456,474770320
906,3269107833,79038304,1.067017104e-11,11213,1025456,475795776
907,3267420042,79129136,1.068243336e-11,11213,1025456,476821232
908,3280687959,79038304,1.067017104e-11,11213,1025456,477846688
909,3267357584,79038304,1.067017104e-11,11213,1025456,478872144
910,2056479667,79038304,1.067017104e-11,11213,1025456,479897600
911,3251392458,79129134,1.068243309e-11,11150,1025456,480923056
912,3372835042,79038303,1.0670170904999999e-11,11171,1025456,481948512
913,2162644458,79129135,1.0682433224999999e-11,11171,1025456,482973968
914,2286038625,79038303,1.0670170904999999e-11,11192,1025456,483999424
915,2588805875,79038303,1.0670170904999999e-11,11192,1025456,485024880
916,3604493500,79038722,1.067022747e-11,24798,1025904,486050784
917,2700262292,79129137,1.0682433494999998e-11,11255,1025456,487076240
918,3703979125,79038305,1.0670171175e-11,11255,1025456,488101696
919,2267103375,79038305,1.0670171175e-11,11255,1025456,489127152
920,3850512375,79129138,1.0682433629999999e-11,11276,1025456,490152608
921,3533909708,79038303,1.0670170904999999e-11,11192,1025456,491178064
922,2081876416,79038304,1.067017104e-11,11213,1025456,492203520
923,2105203416,79129137,1.0682433494999998e-11,11234,1025456,493228976
924,2048701458,79038305,1.0670171175e-11,11234,1025456,494254432
925,2119674458,79038305,1.0670171175e-11,11234,1025456,495279888
926,2118592000,79038305,1.0670171175e-11,11234,1025456,496305344
927,2058975166,79038305,1.0670171175e-11,11255,1025456,497330800
928,2096841208,79129137,1.0682433494999998e-11,11255,1025456,498356256
929,2058372334,79038305,1.0670171175e-11,11255,1025456,499381712
930,2095729959,79038305,1.0670171175e-11,11255,1025456,500407168
931,60479818083,79628715,1.0749876524999999e-11,11192,1025456,501432624
932,2076136875,79038304,1.067017104e-11,11213,1025456,502458080
933,2058817208,79038719,1.0670227065e-11,24687,1025904,503483984
934,2088890750,79038305,1.0670171175e-11,11255,1025456,504509440
935,2058369500,79038306,1.0670171309999999e-11,11276,1025456,505534896
936,2101773208,79129138,1.0682433629999999e-11,11276,1025456,506560352
937,2061671750,79038306,1.0670171309999999e-11,11276,1025456,507585808
938,2078338916,79038306,1.0670171309999999e-11,11276,1025456,508611264
939,2065876000,79038306,1.0670171309999999e-11,11276,1025456,509636720
940,2126210291,79038306,1.0670171309999999e-11,11276,1025456,510662176
941,2276684458,79129136,1.068243336e-11,11213,1025456,511687632
942,2422415875,79038305,1.0670171175e-11,11234,1025456,512713088
943,2565267792,79038305,1.0670171175e-11,11234,1025456,513738544
944,3055572250,79129137,1.0682433494999998e-11,11255,1025456,514764000
945,4348998833,79038305,1.0670171175e-11,11255,1025456,515789456
946,2721702041,79038305,1.0670171175e-11,11255,1025456,516814912
947,4012923709,79129137,1.0682433494999998e-11,11255,1025456,517840368
948,2287351166,79038306,1.0670171309999999e-11,11276,1025456,518865824
949,2158829208,79038306,1.0670171309999999e-11,11276,1025456,519891280
950,2114932458,79129549,1.0682489114999999e-11,24618,1025904,520917184
951,2061188042,79038304,1.067017104e-11,11213,1025456,521942640
952,2075295792,79038305,1.0670171175e-11,11234,1025456,522968096
953,2054536541,79038305,1.0670171175e-11,11255,1025456,523993552
954,2048527291,79038305,1.0670171175e-11,11255,1025456,525019008
955,17691983625,79247220,1.06983747e-11,11255,1025456,526044464
956,2053724041,79038306,1.0670171309999999e-11,11276,1025456,527069920
957,2057089417,79038306,1.0670171309999999e-11,11276,1025456,528095376
958,2071711375,79038306,1.0670171309999999e-11,11276,1025456,529120832
959,2069502958,79129138,1.0682433629999999e-11,11276,1025456,530146288
960,2053568125,79038306,1.0670171309999999e-11,11276,1025456,531171744
961,2050955542,79038304,1.067017104e-11,11213,1025456,532197200
962,2050055375,79038305,1.0670171175e-11,11234,1025456,533222656
963,2051487833,79038305,1.0670171175e-11,11234,1025456,534248112
964,2051221958,79129137,1.0682433494999998e-11,11255,1025456,535273568
965,2052213625,79038305,1.0670171175e-11,11255,1025456,536299024
966,2074867958,79038305,1.0670171175e-11,11255,1025456,537324480
967,2129379833,79038712,1.067022612e-11,24465,1025904,538350384
968,2068481083,79038306,1.0670171309999999e-11,11276,1025456,539375840
969,2051110583,79129139,1.0682433765e-11,11297,1025456,540401296
970,2106555333,79038307,1.0670171445e-11,11297,1025456,541426752
971,2051312791,79038304,1.067017104e-11,11213,1025456,542452208
972,2107796334,79038305,1.0670171175e-11,11234,1025456,543477664
973,2052122625,79038305,1.0670171175e-11,11255,1025456,544503120
974,2105344500,79129137,1.0682433494999998e-11,11255,1025456,545528576
975,2050740125,79038305,1.0670171175e-11,11255,1025456,546554032
976,2106576167,79038305,1.0670171175e-11,11255,1025456,547579488
977,2052557417,79038306,1.0670171309999999e-11,11276,1025456,548604944
978,2103544125,79038306,1.0670171309999999e-11,11276,1025456,549630400
979,2052326208,79129138,1.0682433629999999e-11,11276,1025456,550655856
980,2054738542,79038306,1.0670171309999999e-11,11276,1025456,551681312
981,2051486917,79038304,1.067017104e-11,11213,1025456,552706768
982,2051969292,79038305,1.0670171175e-11,11234,1025456,553732224
983,2050879083,79038305,1.0670171175e-11,11234,1025456,554757680
984,2051134416,79129539,1.0682487764999998e-11,24312,1025904,555783584
985,2053687792,79038306,1.0670171309999999e-11,11276,1025456,556809040
986,3268629917,79038306,1.0670171309999999e-11,11276,1025456,557834496
987,2050983292,79038306,1.0670171309999999e-11,11276,1025456,558859952
988,3268432541,79129138,1.0682433629999999e-11,11276,1025456,559885408
989,3274182875,79038306,1.0670171309999999e-11,11276,1025456,560910864
990,3267309583,79038306,1.0670171309999999e-11,11276,1025456,561936320
991,2072948416,79129136,1.068243336e-11,11213,1025456,562961776
992,2137008417,79038305,1.0670171175e-11,11234,1025456,563987232
993,2386180792,79038305,1.0670171175e-11,11234,1025456,565012688
994,3855938750,79038305,1.0670171175e-11,11255,1025456,566038144
995,4086756791,79038305,1.0670171175e-11,11255,1025456,567063600
996,2324502417,79038305,1.0670171175e-11,11255,1025456,568089056
997,3240115250,79038305,1.0670171175e-11,11255,1025456,569114512
998,2338524750,79129138,1.0682433629999999e-11,11276,1025456,570139968
999,2238753333,79038306,1.0670171309999999e-11,11276,1025456,571165424
1000,2417098375,79038306,1.0670171309999999e-11,11276,1025456,572190880
1001,2179955250,79038691,1.0670223284999999e-11,23781,1025904,573216784
1002,2073352875,79129128,1.068243228e-11,10961,1025456,574242240
1003,2069770000,79038298,1.0670170229999999e-11,11024,1025456,575267696
1004,2115753583,79038298,1.0670170229999999e-11,11024,1025456,576293152
1005,2069543000,79038300,1.0670170499999999e-11,11087,1025456,577318608
1006,2053214250,79129132,1.0682432819999999e-11,11087,1025456,578344064
1007,2051094625,79038300,1.0670170499999999e-11,11087,1025456,579369520
1008,2052138042,79038300,1.0670170499999999e-11,11087,1025456,580394976
1009,2052333167,79038300,1.0670170499999999e-11,11087,1025456,581420432
1010,2052276709,79038300,1.0670170499999999e-11,11087,1025456,582445888
1011,2050546792,79038298,1.0670170229999999e-11,11024,1025456,583471344
1012,2051233750,79129131,1.0682432685e-11,11045,1025456,584496800
1013,2052163625,79038299,1.0670170365e-11,11045,1025456,585522256
1014,2101639416,79038300,1.0670170499999999e-11,11066,1025456,586547712
1015,2058932166,79038301,1.0670170635e-11,11108,1025456,587573168
1016,2121508250,79129133,1.0682432955e-11,11108,1025456,588598624
1017,2059481167,79038301,1.0670170635e-11,11108,1025456,589624080
1018,2052414541,79038695,1.0670223825e-11,23922,1025904,590649984
1019,2050844333,79038303,1.0670170904999999e-11,11192,1025456,591675440
1020,2051890250,79038303,1.0670170904999999e-11,11192,1025456,592700896
1021,2052369125,79129133,1.0682432955e-11,11108,1025456,593726352
1022,2048084333,79038301,1.0670170635e-11,11129,1025456,594751808
1023,2064739834,79038302,1.067017077e-11,11150,1025456,595777264
1024,2052616792,79038302,1.067017077e-11,11150,1025456,596802720
1025,2102256250,79038302,1.067017077e-11,11150,1025456,597828176
1026,2061952500,79129135,1.0682433224999999e-11,11171,1025456,598853632
1027,2084198041,79038303,1.0670170904999999e-11,11171,1025456,599879088
1028,2051985666,79038303,1.0670170904999999e-11,11171,1025456,600904544
1029,2051977209,79038303,1.0670170904999999e-11,11171,1025456,601930000
1030,2051173750,79038303,1.0670170904999999e-11,11171,1025456,602955456
1031,2052248417,79129133,1.0682432955e-11,11108,1025456,603980912
1032,2051740334,79038301,1.0670170635e-11,11129,1025456,605006368
1033,2051917000,79038301,1.0670170635e-11,11129,1025456,606031824
1034,3267504959,79038302,1.067017077e-11,11150,1025456,607057280
1035,3280403750,79129524,1.068248574e-11,23832,1025904,608083184
1036,3301746125,79038303,1.0670170904999999e-11,11171,1025456,609108640
1037,3275464125,79038303,1.0670170904999999e-11,11171,1025456,610134096
1038,2123263459,79038303,1.0670170904999999e-11,11171,1025456,611159552
1039,3276609042,79129135,1.0682433224999999e-11,11171,1025456,612185008
1040,2051555125,79038303,1.0670170904999999e-11,11171,1025456,613210464
1041,3267683916,79038301,1.0670170635e-11,11108,1025456,614235920
1042,3267986125,79129133,1.0682432955e-11,11129,1025456,615261376
1043,2051891667,79038302,1.067017077e-11,11150,1025456,616286832
1044,3267354541,79038302,1.067017077e-11,11150,1025456,617312288
1045,2083824000,79038302,1.067017077e-11,11150,1025456,618337744
1046,3275804416,79129134,1.068243309e-11,11150,1025456,619363200
1047,3341501458,79038303,1.0670170904999999e-11,11171,1025456,620388656
1048,2064604542,79038303,1.0670170904999999e-11,11171,1025456,621414112
1049,2662734958,79129135,1.0682433224999999e-11,11171,1025456,622439568
1050,2577611000,79038303,1.0670170904999999e-11,11171,1025456,623465024
1051,3214884375,79038301,1.0670170635e-11,11108,1025456,624490480
1052,2817587125,79038687,1.0670222745e-11,23658,1025904,625516384
1053,2916897458,79129135,1.0682433224999999e-11,11192,1025456,626541840
1054,2823977458,79038303,1.0670170904999999e-11,11192,1025456,627567296
1055,2741062625,79038304,1.067017104e-11,11213,1025456,628592752
1056,2317687416,79038304,1.067017104e-11,11213,1025456,629618208
1057,2381241458,79038304,1.067017104e-11,11213,1025456,630643664
1058,2052991000,79038304,1.067017104e-11,11213,1025456,631669120
1059,2051688500,79038304,1.067017104e-11,11213,1025456,632694576
1060,2051243500,79129136,1.068243336e-11,11213,1025456,633720032
1061,2051196875,79038302,1.067017077e-11,11150,1025456,634745488
1062,2051516666,79038303,1.0670170904999999e-11,11171,1025456,635770944
1063,2051085375,79038303,1.0670170904999999e-11,11171,1025456,636796400
1064,2051050042,79038303,1.0670170904999999e-11,11192,1025456,637821856
1065,2051973209,79129135,1.0682433224999999e-11,11192,1025456,638847312
1066,2119633708,79038303,1.0670170904999999e-11,11192,1025456,639872768
1067,2052232583,79038303,1.0670170904999999e-11,11192,1025456,640898224
1068,2050514792,79038304,1.067017104e-11,11213,1025456,641923680
1069,2053540958,79038686,1.067022261e-11,23631,1025904,642949584
1070,73326083625,79755881,1.0767043934999999e-11,11234,1025456,643975040
1071,2052751667,79038302,1.067017077e-11,11150,1025456,645000496
1072,2051326458,79038303,1.0670170904999999e-11,11171,1025456,646025952
1073,2051566208,79038303,1.0670170904999999e-11,11192,1025456,647051408
1074,2051574958,79038303,1.0670170904999999e-11,11192,1025456,648076864
1075,2051981417,79129135,1.0682433224999999e-11,11192,1025456,649102320
1076,2085258458,79038304,1.067017104e-11,11213,1025456,650127776
1077,2057032709,79038304,1.067017104e-11,11213,1025456,651153232
1078,2119023542,79038304,1.067017104e-11,11213,1025456,652178688
1079,2059867125,79038304,1.067017104e-11,11213,1025456,653204144
1080,2051669625,79129136,1.068243336e-11,11213,1025456,654229600
1081,2050620791,79038302,1.067017077e-11,11150,1025456,655255056
1082,2052294166,79038303,1.0670170904999999e-11,11171,1025456,656280512
1083,2050877417,79038303,1.0670170904999999e-11,11171,1025456,657305968
1084,2052155750,79038303,1.0670170904999999e-11,11192,1025456,658331424
1085,2051246250,79129135,1.0682433224999999e-11,11192,1025456,659356880
1086,2051793958,79038681,1.0670221935e-11,23478,1025904,660382784
1087,2051862458,79038304,1.067017104e-11,11213,1025456,661408240
1088,2049103792,79038304,1.067017104e-11,11213,1025456,662433696
1089,2100208792,79038304,1.067017104e-11,11213,1025456,663459152
1090,2048554291,79129137,1.0682433494999998e-11,11234,1025456,664484608
1091,2075035167,79038302,1.067017077e-11,11150,1025456,665510064
1092,2070395000,79038303,1.0670170904999999e-11,11171,1025456,666535520
1093,2073236791,79038303,1.0670170904999999e-11,11192,1025456,667560976
1094,2060126125,79038303,1.0670170904999999e-11,11192,1025456,668586432
1095,2088555917,79129135,1.0682433224999999e-11,11192,1025456,669611888
1096,2059308709,79038303,1.0670170904999999e-11,11192,1025456,670637344
1097,2087063500,79038304,1.067017104e-11,11213,1025456,671662800
1098,2061704459,79038304,1.067017104e-11,11213,1025456,672688256
1099,2087833750,79038304,1.067017104e-11,11213,1025456,673713712
1100,2081379958,79129136,1.068243336e-11,11213,1025456,674739168
1101,2089739750,79038298,1.0670170229999999e-11,11024,1025456,675764624
1102,2057232708,79038300,1.0670170499999999e-11,11066,1025456,676790080
1103,2088380667,79038673,1.0670220855e-11,23220,1025904,677815984
1104,3276322334,79038301,1.0670170635e-11,11108,1025456,678841440
1105,22066217833,138129982,1.864754757e-11,11150,-112939404,565902036
1106,3272967958,79151876,1.068550326e-11,11150,1025456,566927492
1107,3311056542,79038302,1.067017077e-11,11150,1025456,567952948
1108,3263405542,79038302,1.067017077e-11,11150,1025456,568978404
1109,3285100833,79151876,1.068550326e-11,11150,1025456,570003860
1110,3274849208,79038302,1.067017077e-11,11150,1025456,571029316
1111,2453924458,79038300,1.0670170499999999e-11,11087,1025456,572054772
1112,2539664958,79151875,1.0685503124999999e-11,11108,1025456,573080228
1113,2542601667,79038301,1.0670170635e-11,11129,1025456,574105684
1114,4489062000,79038302,1.067017077e-11,11150,1025456,575131140
1115,3100192125,79151876,1.068550326e-11,11150,1025456,576156596
1116,2365606167,79038302,1.067017077e-11,11150,1025456,577182052
1117,2490374667,79038302,1.067017077e-11,11150,1025456,578207508
1118,27839766375,79435812,1.0723834619999999e-11,11171,1025456,579232964
1119,2060466667,79038303,1.0670170904999999e-11,11171,1025456,580258420
1120,2051261541,79038673,1.0670220855e-11,23193,1025904,581284324
1121,2051245750,79038316,1.067017266e-11,11592,1025456,582309780
1122,2071999541,79038317,1.0670172794999999e-11,11613,1025456,583335236
1123,2051195333,79151891,1.0685505285e-11,11634,1025456,584360692
1124,2052019458,79038317,1.0670172794999999e-11,11634,1025456,585386148
1125,2049061500,79038317,1.0670172794999999e-11,11634,1025456,586411604
1126,2048922625,79038318,1.0670172929999999e-11,11655,1025456,587437060
1127,2050929708,79038318,1.0670172929999999e-11,11655,1025456,588462516
1128,2050638959,79151892,1.0685505419999999e-11,11655,1025456,589487972
1129,2065688125,79038318,1.0670172929999999e-11,11655,1025456,590513428
1130,2058012292,79038318,1.0670172929999999e-11,11655,1025456,591538884
1131,2090274334,79038316,1.067017266e-11,11592,1025456,592564340
1132,2056616042,79038317,1.0670172794999999e-11,11613,1025456,593589796
1133,2057797333,79151891,1.0685505285e-11,11613,1025456,594615252
1134,2060699750,79038317,1.0670172794999999e-11,11634,1025456,595640708
1135,2050780584,79038317,1.0670172794999999e-11,11634,1025456,596666164
1136,2037416375,79038317,1.0670172794999999e-11,11634,1025456,597691620
1137,2050623542,79039566,1.0670341409999998e-11,52228,1026708,598718328
1138,2059386458,79151894,1.068550569e-11,11731,1025456,599743784
1139,2069999917,79038321,1.0670173334999999e-11,11752,1025456,600769240
1140,2058238834,79038321,1.0670173334999999e-11,11752,1025456,601794696
1141,2096530250,79038318,1.0670172929999999e-11,11668,1025456,602820152
1142,2046776958,79038319,1.0670173065e-11,11689,1025456,603845608
1143,2082854000,79151893,1.0685505554999999e-11,11710,1025456,604871064
1144,2060839125,79038319,1.0670173065e-11,11710,1025456,605896520
1145,2084233917,79038319,1.0670173065e-11,11710,1025456,606921976
1146,2040904250,79038319,1.0670173065e-11,11710,1025456,607947432
1147,3314628042,79038320,1.0670173199999999e-11,11731,1025456,608972888
1148,3261703958,79151894,1.068550569e-11,11731,1025456,609998344
1149,3285856708,79038320,1.0670173199999999e-11,11731,1025456,611023800
1150,2056119000,79038320,1.0670173199999999e-11,11731,1025456,612049256
1151,3303756167,79151892,1.0685505419999999e-11,11668,1025456,613074712
1152,3285239167,79038319,1.0670173065e-11,11689,1025456,614100168
1153,2069368084,79038319,1.0670173065e-11,11689,1025456,615125624
1154,3274499083,79038749,1.0670231115e-11,25691,1025904,616151528
1155,3302261791,79151894,1.068550569e-11,11731,1025456,617176984
1156,2058954958,79038320,1.0670173199999999e-11,11731,1025456,618202440
1157,3306849208,79038320,1.0670173199999999e-11,11731,1025456,619227896
1158,3276732583,79151894,1.068550569e-11,11731,1025456,620253352
1159,2085314292,79038320,1.0670173199999999e-11,11731,1025456,621278808
1160,3295850916,79038320,1.0670173199999999e-11,11731,1025456,622304264
1161,2101731375,79038318,1.0670172929999999e-11,11668,1025456,623329720
1162,3261862583,79151893,1.0685505554999999e-11,11689,1025456,624355176
1163,3284607917,79038319,1.0670173065e-11,11689,1025456,625380632
1164,2060538333,79038319,1.0670173065e-11,11710,1025456,626406088
1165,3301187541,79038319,1.0670173065e-11,11710,1025456,627431544
1166,3273540666,79151893,1.0685505554999999e-11,11710,1025456,628457000
1167,2084976500,79038319,1.0670173065e-11,11710,1025456,629482456
1168,3276258834,79038320,1.0670173199999999e-11,11731,1025456,630507912
1169,3266025958,79151894,1.068550569e-11,11731,1025456,631533368
1170,3266438458,79038320,1.0670173199999999e-11,11731,1025456,632558824
1171,3265706959,79038744,1.067023044e-11,25517,1025904,633584728
1172,88905739750,80071843,1.0809698805e-11,11710,1025456,634610184
1173,2512218000,79038320,1.0670173199999999e-11,11731,1025456,635635640
1174,2985537542,79038320,1.0670173199999999e-11,11731,1025456,636661096
1175,2733481792,79151895,1.0685505824999999e-11,11752,1025456,637686552
1176,3805130541,79038321,1.0670173334999999e-11,11752,1025456,638712008
1177,3461949000,79038321,1.0670173334999999e-11,11752,1025456,639737464
1178,2422499584,79151895,1.0685505824999999e-11,11752,1025456,640762920
1179,2670212417,79038321,1.0670173334999999e-11,11752,1025456,641788376
1180,2628994625,79038321,1.0670173334999999e-11,11752,1025456,642813832
1181,2068900625,79151893,1.0685505554999999e-11,11689,1025456,643839288
1182,2076168500,79038319,1.0670173065e-11,11710,1025456,644864744
1183,2075050292,79038319,1.0670173065e-11,11710,1025456,645890200
1184,2055945083,79038320,1.0670173199999999e-11,11731,1025456,646915656
1185,2071899792,79038320,1.0670173199999999e-11,11731,1025456,647941112
1186,2053386959,79151894,1.068550569e-11,11731,1025456,648966568
1187,2052264416,79038320,1.0670173199999999e-11,11731,1025456,649992024
1188,2053691834,79038743,1.0670230304999999e-11,25469,1025904,651017928
1189,2053261041,79038321,1.0670173334999999e-11,11773,1025456,652043384
1190,2058756375,79038321,1.0670173334999999e-11,11773,1025456,653068840
1191,2061748917,79151893,1.0685505554999999e-11,11689,1025456,654094296
1192,2133255750,79038319,1.0670173065e-11,11710,1025456,655119752
1193,2063130667,79038320,1.0670173199999999e-11,11731,1025456,656145208
1194,2051374833,79038320,1.0670173199999999e-11,11731,1025456,657170664
1195,2051953875,79038320,1.0670173199999999e-11,11731,1025456,658196120
1196,2051566708,79151895,1.0685505824999999e-11,11752,1025456,659221576
1197,2051440583,79038321,1.0670173334999999e-11,11752,1025456,660247032
1198,2051476917,79038321,1.0670173334999999e-11,11752,1025456,661272488
1199,2051631417,79038321,1.0670173334999999e-11,11752,1025456,662297944
1200,2051762083,79038321,1.0670173334999999e-11,11752,1025456,663323400
1201,2073908750,79151888,1.068550488e-11,11542,1025456,664348856
1202,2051522708,79038316,1.067017266e-11,11584,1025456,665374312
1203,2051045791,79038316,1.067017266e-11,11584,1025456,666399768
1204,2051794917,79038317,1.0670172794999999e-11,11626,1025456,667425224
1205,2051768791,79038735,1.0670229225e-11,25232,1025904,668451128
1206,2050828542,79151892,1.0685505419999999e-11,11668,1025456,669476584
1207,2051121291,79038318,1.0670172929999999e-11,11668,1025456,670502040
1208,2050327750,79038318,1.0670172929999999e-11,11668,1025456,671527496
1209,2051555958,79038318,1.0670172929999999e-11,11668,1025456,672552952
1210,2051424333,79038318,1.0670172929999999e-11,11668,1025456,673578408
1211,2074369083,79151891,1.0685505285e-11,11626,1025456,674603864
1212,2057948625,79038317,1.0670172794999999e-11,11647,1025456,675629320
1213,2160008167,79038318,1.0670172929999999e-11,11668,1025456,676654776
1214,2222849000,79038318,1.0670172929999999e-11,11668,1025456,677680232
1215,2506249167,79151892,1.0685505419999999e-11,11668,1025456,678705688
1216,2253543916,79038318,1.0670172929999999e-11,11668,1025456,679731144
1217,3944715709,79038319,1.0670173065e-11,11689,1025456,680756600
1218,3195916125,79151893,1.0685505554999999e-11,11689,1025456,681782056
1219,2529603333,79038319,1.0670173065e-11,11689,1025456,682807512
1220,3058145792,79038319,1.0670173065e-11,11689,1025456,683832968
1221,4015326417,79151891,1.0685505285e-11,11626,1025456,684858424
1222,2809436583,79038731,1.0670228684999999e-11,25100,1025904,685884328
1223,2315859959,79038319,1.0670173065e-11,11689,1025456,686909784
1224,2060405291,79151893,1.0685505554999999e-11,11689,1025456,687935240
1225,2058620458,79038319,1.0670173065e-11,11710,1025456,688960696
1226,2128436875,79038319,1.0670173065e-11,11710,1025456,689986152
1227,2050922375,79038319,1.0670173065e-11,11710,1025456,691011608
1228,2051226500,79038319,1.0670173065e-11,11710,1025456,692037064
1229,2051515792,79151893,1.0685505554999999e-11,11710,1025456,693062520
1230,2055174791,79038319,1.0670173065e-11,11710,1025456,694087976
1231,2053685000,79038317,1.0670172794999999e-11,11647,1025456,695113432
1232,2049678666,79038318,1.0670172929999999e-11,11668,1025456,696138888
1233,2052538375,79038318,1.0670172929999999e-11,11668,1025456,697164344
1234,2056020042,79151893,1.0685505554999999e-11,11689,1025456,698189800
1235,2146705042,79038319,1.0670173065e-11,11689,1025456,699215256
1236,2049538917,79038319,1.0670173065e-11,11689,1025456,700240712
1237,2051461000,79038319,1.0670173065e-11,11689,1025456,701266168
1238,2051710958,79038319,1.0670173065e-11,11710,1025456,702291624
1239,2052027958,79038730,1.067022855e-11,25052,1025904,703317528
1240,2052061625,79151895,1.0685505824999999e-11,11752,1025456,704342984
1241,2051047875,79038318,1.0670172929999999e-11,11668,1025456,705368440
1242,2052443250,79038319,1.0670173065e-11,11689,1025456,706393896
1243,2052450333,79038319,1.0670173065e-11,11710,1025456,707419352
1244,2051920708,79038319,1.0670173065e-11,11710,1025456,708444808
1245,2061837000,79151893,1.0685505554999999e-11,11710,1025456,709470264
1246,2052469500,79038320,1.0670173199999999e-11,11731,1025456,710495720
1247,2051156666,79038320,1.0670173199999999e-11,11731,1025456,711521176
1248,2051260959,79038320,1.0670173199999999e-11,11731,1025456,712546632
1249,2052037542,79038320,1.0670173199999999e-11,11731,1025456,713572088
1250,2051977750,79151894,1.068550569e-11,11731,1025456,714597544
1251,40815913958,79038318,1.0670172929999999e-11,11668,1025456,715623000
1252,40830027583,79901483,1.0786700204999999e-11,11689,1025456,716648456
1253,2052575875,79038319,1.0670173065e-11,11689,1025456,717673912
1254,2050479584,79151893,1.0685505554999999e-11,11710,1025456,718699368
1255,2077330375,79038319,1.0670173065e-11,11710,1025456,719724824
1256,2242387292,79038726,1.067022801e-11,24920,1025904,720750728
1257,2836114000,79038320,1.0670173199999999e-11,11731,1025456,721776184
1258,3150541250,79151894,1.068550569e-11,11731,1025456,722801640
1259,4277095959,79038320,1.0670173199999999e-11,11731,1025456,723827096
1260,2747503042,79038321,1.0670173334999999e-11,11752,1025456,724852552
1261,2454961166,79151892,1.0685505419999999e-11,11668,1025456,725878008
1262,2917337709,79038319,1.0670173065e-11,11689,1025456,726903464
1263,2292821625,79038319,1.0670173065e-11,11710,1025456,727928920
1264,2225497458,79151893,1.0685505554999999e-11,11710,1025456,728954376
1265,2051765750,79038319,1.0670173065e-11,11710,1025456,729979832
1266,2051523208,79038319,1.0670173065e-11,11710,1025456,731005288
1267,2050804625,79038320,1.0670173199999999e-11,11731,1025456,732030744
1268,2120790375,79038320,1.0670173199999999e-11,11731,1025456,733056200
1269,2051049583,79151894,1.068550569e-11,11731,1025456,734081656
1270,2052643667,79038320,1.0670173199999999e-11,11731,1025456,735107112
1271,2052537584,79038318,1.0670172929999999e-11,11668,1025456,736132568
1272,2053364791,79038319,1.0670173065e-11,11689,1025456,737158024
1273,2053088208,79152295,1.0685559824999999e-11,24767,1025904,738183928
1274,2052026708,79038319,1.0670173065e-11,11710,1025456,739209384
1275,2051073792,79038320,1.0670173199999999e-11,11731,1025456,740234840
1276,2050270833,79038320,1.0670173199999999e-11,11731,1025456,741260296
1277,2080051541,79038320,1.0670173199999999e-11,11731,1025456,742285752
1278,2059922875,79151894,1.068550569e-11,11731,1025456,743311208
1279,2131461458,79038320,1.0670173199999999e-11,11731,1025456,744336664
1280,2056501459,79038320,1.0670173199999999e-11,11731,1025456,745362120
1281,2052576666,79038318,1.0670172929999999e-11,11668,1025456,746387576
1282,2053089042,79038319,1.0670173065e-11,11689,1025456,747413032
1283,2051033250,79151893,1.0685505554999999e-11,11689,1025456,748438488
1284,2050134625,79038319,1.0670173065e-11,11710,1025456,749463944
1285,2052183875,79038319,1.0670173065e-11,11710,1025456,750489400
1286,2051742166,79038319,1.0670173065e-11,11710,1025456,751514856
1287,2052197166,79038319,1.0670173065e-11,11710,1025456,752540312
1288,2053694208,79151894,1.068550569e-11,11731,1025456,753565768
1289,2085471833,79038320,1.0670173199999999e-11,11731,1025456,754591224
1290,2051432000,79038718,1.0670226929999998e-11,24677,1025904,755617128
1291,2051389583,79038318,1.0670172929999999e-11,11668,1025456,756642584
1292,2050187167,79038319,1.0670173065e-11,11689,1025456,757668040
1293,2052282500,79151893,1.0685505554999999e-11,11710,1025456,758693496
1294,2050745000,79038319,1.0670173065e-11,11710,1025456,759718952
1295,2051216000,79038319,1.0670173065e-11,11710,1025456,760744408
1296,2051914417,79038320,1.0670173199999999e-11,11731,1025456,761769864
1297,2046319000,79038320,1.0670173199999999e-11,11731,1025456,762795320
1298,2043727375,79151894,1.068550569e-11,11731,1025456,763820776
1299,2057385375,79038320,1.0670173199999999e-11,11731,1025456,764846232
1300,2054522417,79038320,1.0670173199999999e-11,11731,1025456,765871688
1301,2119124042,79038314,1.0670172389999998e-11,11542,1025456,766897144
1302,22075226917,79038316,1.067017266e-11,11584,1025456,767922600
1303,3257427750,79390395,1.0717703325e-11,11584,1025456,768948056
1304,2061299458,79038317,1.0670172794999999e-11,11626,1025456,769973512
1305,2079279042,79038317,1.0670172794999999e-11,11626,1025456,770998968
1306,2058317708,79038317,1.0670172794999999e-11,11626,1025456,772024424
1307,2124244583,79038711,1.0670225984999999e-11,24440,1025904,773050328
1308,2059427792,79151892,1.0685505419999999e-11,11668,1025456,774075784
1309,2053339833,79038319,1.0670173065e-11,11710,1025456,775101240
1310,2051214125,79038319,1.0670173065e-11,11710,1025456,776126696
1311,2051274250,79038317,1.0670172794999999e-11,11626,1025456,777152152
1312,3269777500,79038317,1.0670172794999999e-11,11647,1025456,778177608
1313,3269627667,79151892,1.0685505419999999e-11,11668,1025456,779203064
1314,3269461542,79038318,1.0670172929999999e-11,11668,1025456,780228520
1315,2051784333,79038318,1.0670172929999999e-11,11668,1025456,781253976
1316,2051364209,79038318,1.0670172929999999e-11,11668,1025456,782279432
1317,2037054500,79151893,1.0685505554999999e-11,11689,1025456,783304888
1318,60469783958,79038319,1.0670173065e-11,11689,1025456,784330344
1319,27358423333,80015057,1.0802032695e-11,11689,1025456,785355800
1320,3694181500,79038319,1.0670173065e-11,11689,1025456,786381256
1321,3037971167,79038317,1.0670172794999999e-11,11626,1025456,787406712
1322,2393895209,79151891,1.0685505285e-11,11647,1025456,788432168
1323,2607836625,79038317,1.0670172794999999e-11,11647,1025456,789457624
1324,2522714958,79038708,1.067022558e-11,24329,1025904,790483528
1325,2807539542,79038319,1.0670173065e-11,11710,1025456,791508984
1326,2452355500,79151893,1.0685505554999999e-11,11710,1025456,792534440
1327,2673290083,79038319,1.0670173065e-11,11710,1025456,793559896
1328,2282748583,79038319,1.0670173065e-11,11710,1025456,794585352
1329,2053441250,79151893,1.0685505554999999e-11,11710,1025456,795610808
1330,2037726083,79038319,1.0670173065e-11,11710,1025456,796636264
1331,2103234958,79038317,1.0670172794999999e-11,11647,1025456,797661720
1332,2048664000,79038318,1.0670172929999999e-11,11668,1025456,798687176
1333,2090350875,79038318,1.0670172929999999e-11,11668,1025456,799712632
1334,2035894917,79151893,1.0685505554999999e-11,11689,1025456,800738088
1335,2098777667,79038319,1.0670173065e-11,11689,1025456,801763544
1336,2060001917,79038319,1.0670173065e-11,11689,1025456,802789000
1337,2091349125,79038319,1.0670173065e-11,11689,1025456,803814456
1338,2061268625,79038319,1.0670173065e-11,11710,1025456,804839912
1339,2092091834,79151893,1.0685505554999999e-11,11710,1025456,805865368
1340,2123467417,79038319,1.0670173065e-11,11710,1025456,806890824
1341,2047786917,79038703,1.0670224904999999e-11,24176,1025904,807916728
1342,2133589333,79038318,1.0670172929999999e-11,11668,1025456,808942184
1343,2076411000,79038319,1.0670173065e-11,11689,1025456,809967640
1344,2059862709,79151893,1.0685505554999999e-11,11689,1025456,810993096
1345,2087204459,79038319,1.0670173065e-11,11710,1025456,812018552
1346,2062174083,79038319,1.0670173065e-11,11710,1025456,813044008
1347,2107466667,79038319,1.0670173065e-11,11710,1025456,814069464
1348,2048751542,79038319,1.0670173065e-11,11710,1025456,815094920
1349,2074670167,79151893,1.0685505554999999e-11,11710,1025456,816120376
1350,2059668167,79038319,1.0670173065e-11,11710,1025456,817145832
1351,2085272125,79038317,1.0670172794999999e-11,11647,1025456,818171288
1352,2054790292,79038318,1.0670172929999999e-11,11668,1025456,819196744
1353,2093173834,79151892,1.0685505419999999e-11,11668,1025456,820222200
1354,2060543834,79038319,1.0670173065e-11,11689,1025456,821247656
1355,2086458000,79038319,1.0670173065e-11,11689,1025456,822273112
1356,2083728792,79038319,1.0670173065e-11,11689,1025456,823298568
1357,2122848000,79038319,1.0670173065e-11,11689,1025456,824324024
1358,2047741541,79152275,1.0685557124999999e-11,24107,1025904,825349928
1359,3288695541,79038321,1.0670173334999999e-11,11752,1025456,826375384
1360,3265464334,79038321,1.0670173334999999e-11,11752,1025456,827400840
1361,3305371500,79038318,1.0670172929999999e-11,11668,1025456,828426296
1362,3272914333,79151893,1.0685505554999999e-11,11689,1025456,829451752
1363,73417074167,79038319,1.0670173065e-11,11710,1025456,830477208
1364,17685473208,80026414,1.080356589e-11,11710,1025456,831502664
1365,2097492958,79038319,1.0670173065e-11,11710,1025456,832528120
1366,3279415041,79038320,1.0670173199999999e-11,11731,1025456,833553576
1367,3311955958,79151894,1.068550569e-11,11731,1025456,834579032
1368,3275624375,79038320,1.0670173199999999e-11,11731,1025456,835604488
1369,2051831958,79038320,1.0670173199999999e-11,11731,1025456,836629944
1370,2052716375,79151894,1.068550569e-11,11731,1025456,837655400
1371,2048998834,79038318,1.0670172929999999e-11,11668,1025456,838680856
1372,3267845500,79038319,1.0670173065e-11,11689,1025456,839706312
1373,3267900125,79038319,1.0670173065e-11,11689,1025456,840731768
1374,3268260584,79151893,1.0685505554999999e-11,11710,1025456,841757224
1375,3269737416,79038697,1.0670224094999999e-11,23996,1025904,842783128
1376,3268021958,79038320,1.0670173199999999e-11,11731,1025456,843808584
1377,3315903500,79151894,1.068550569e-11,11731,1025456,844834040
1378,3274991208,79038320,1.0670173199999999e-11,11731,1025456,845859496
1379,3267875000,79038320,1.0670173199999999e-11,11731,1025456,846884952
1380,3273538875,79151894,1.068550569e-11,11731,1025456,847910408
1381,2061803750,79038318,1.0670172929999999e-11,11668,1025456,848935864
1382,51268723875,153453858,2.071627083e-11,11689,-141174360,707761504
1383,2053698125,79038319,1.0670173065e-11,11710,1025456,708786960
1384,2052258917,79038319,1.0670173065e-11,11710,1025456,709812416
1385,2052537042,79038319,1.0670173065e-11,11710,1025456,710837872
1386,2051329542,79038319,1.0670173065e-11,11710,1025456,711863328
1387,2051542792,79180276,1.0689337259999999e-11,11731,1025456,712888784
1388,2073640541,79038320,1.0670173199999999e-11,11731,1025456,713914240
1389,2048876959,79038320,1.0670173199999999e-11,11731,1025456,714939696
1390,2065451417,79038320,1.0670173199999999e-11,11731,1025456,715965152
1391,2051000917,79038318,1.0670172929999999e-11,11668,1025456,716990608
1392,2104992667,79180648,1.0689387479999998e-11,23822,1025904,718016512
1393,2051493208,79038319,1.0670173065e-11,11710,1025456,719041968
1394,2110820083,79038319,1.0670173065e-11,11710,1025456,720067424
1395,2051746417,79038320,1.0670173199999999e-11,11731,1025456,721092880
1396,2107352125,79180276,1.0689337259999999e-11,11731,1025456,722118336
1397,2052910542,79038320,1.0670173199999999e-11,11731,1025456,723143792
1398,2106531209,79038320,1.0670173199999999e-11,11731,1025456,724169248
1399,2051302000,79038320,1.0670173199999999e-11,11731,1025456,725194704
1400,2114658958,79038320,1.0670173199999999e-11,11731,1025456,726220160
1401,2082072958,79180270,1.0689336449999999e-11,11542,1025456,727245616
1402,33379459250,79038316,1.067017266e-11,11584,1025456,728271072
1403,60835839375,80330119,1.0844566064999999e-11,11584,1025456,729296528
1404,2644317041,79038317,1.0670172794999999e-11,11626,1025456,730321984
1405,4023131750,79038317,1.0670172794999999e-11,11626,1025456,731347440
1406,2548814875,79180273,1.0689336854999999e-11,11626,1025456,732372896
1407,3556844250,79038317,1.0670172794999999e-11,11626,1025456,733398352
1408,2453345334,79038318,1.0670172929999999e-11,11668,1025456,734423808
1409,3439531333,79180644,1.068938694e-11,23690,1025904,735449712
1410,2315180959,79038334,1.067017509e-11,12173,1025456,736475168
1411,2295599042,79038331,1.0670174685e-11,12089,1025456,737500624
1412,2699352208,79038332,1.0670174819999999e-11,12110,1025456,738526080
1413,2053553000,79194484,1.0691255339999999e-11,12131,1025456,739551536
1414,2054610167,79038332,1.0670174819999999e-11,12131,1025456,740576992
1415,2054415333,79038332,1.0670174819999999e-11,12131,1025456,741602448
1416,2053219083,79038333,1.0670174955e-11,12152,1025456,742627904
1417,2052377709,79038333,1.0670174955e-11,12152,1025456,743653360
1418,2053082375,79180289,1.0689339015e-11,12152,1025456,744678816
1419,2052184334,79038333,1.0670174955e-11,12152,1025456,745704272
1420,2052147334,79038333,1.0670174955e-11,12152,1025456,746729728
1421,2062551334,79038331,1.0670174685e-11,12089,1025456,747755184
1422,2052643208,79038332,1.0670174819999999e-11,12110,1025456,748780640
1423,2051884583,79180288,1.068933888e-11,12110,1025456,749806096
1424,2052191458,79038332,1.0670174819999999e-11,12131,1025456,750831552
1425,2051297291,79038332,1.0670174819999999e-11,12131,1025456,751857008
1426,2051460250,79039577,1.0670342894999998e-11,52593,1026708,752883716
1427,108279969375,80571449,1.0877145614999999e-11,11731,1025456,753909172
1428,2461678750,79038320,1.0670173199999999e-11,11731,1025456,754934628
1429,2262406500,79180276,1.0689337259999999e-11,11731,1025456,755960084
1430,2915650083,79038321,1.0670173334999999e-11,11752,1025456,756985540
1431,3747314000,79038318,1.0670172929999999e-11,11668,1025456,758010996
1432,2560471333,79180275,1.0689337125e-11,11689,1025456,759036452
1433,2442785291,79038319,1.0670173065e-11,11710,1025456,760061908
1434,2291922042,79038319,1.0670173065e-11,11710,1025456,761087364
1435,2126036958,79038319,1.0670173065e-11,11710,1025456,762112820
1436,2051609417,79180275,1.0689337125e-11,11710,1025456,763138276
1437,2065230167,79038320,1.0670173199999999e-11,11731,1025456,764163732
1438,2055073083,79038320,1.0670173199999999e-11,11731,1025456,765189188
1439,2068896792,79038320,1.0670173199999999e-11,11731,1025456,766214644
1440,2064439584,79038320,1.0670173199999999e-11,11731,1025456,767240100
1441,2063032084,79180274,1.0689336989999998e-11,11668,1025456,768265556
1442,2059209292,79038319,1.0670173065e-11,11689,1025456,769291012
1443,2051635584,79038749,1.0670231115e-11,25691,1025904,770316916
1444,2067010333,79038320,1.0670173199999999e-11,11731,1025456,771342372
1445,2059070208,79038321,1.0670173334999999e-11,11752,1025456,772367828
1446,40884720084,79038321,1.0670173334999999e-11,11752,1025456,773393284
1447,60498453666,80472080,1.0863730799999999e-11,11752,1025456,774418740
1448,2404934000,79038321,1.0670173334999999e-11,11752,1025456,775444196
1449,2266392083,79180277,1.0689337395e-11,11752,1025456,776469652
1450,2788203417,79038321,1.0670173334999999e-11,11752,1025456,777495108
1451,2333773583,79038319,1.0670173065e-11,11689,1025456,778520564
1452,2508135875,79038319,1.0670173065e-11,11710,1025456,779546020
1453,2404705333,79038319,1.0670173065e-11,11710,1025456,780571476
1454,2248633125,79038320,1.0670173199999999e-11,11731,1025456,781596932
1455,2477403209,79038320,1.0670173199999999e-11,11731,1025456,782622388
1456,2649748125,79038320,1.0670173199999999e-11,11731,1025456,783647844
1457,3716790666,79180276,1.0689337259999999e-11,11731,1025456,784673300
1458,2222695042,79038321,1.0670173334999999e-11,11752,1025456,785698756
1459,2236718333,79038321,1.0670173334999999e-11,11752,1025456,786724212
1460,2051849667,79180703,1.0689394905e-11,25622,1025904,787750116
1461,2059972208,79038319,1.0670173065e-11,11689,1025456,788775572
1462,2058672416,79038319,1.0670173065e-11,11710,1025456,789801028
1463,2123224458,79038320,1.0670173199999999e-11,11731,1025456,790826484
1464,2065058667,79038320,1.0670173199999999e-11,11731,1025456,791851940
1465,2052577583,79038320,1.0670173199999999e-11,11731,1025456,792877396
1466,107252379208,80656623,1.0888644105e-11,11752,1025456,793902852
1467,2051756583,79038321,1.0670173334999999e-11,11752,1025456,794928308
1468,2051879292,79038321,1.0670173334999999e-11,11752,1025456,795953764
1469,2052026833,79038321,1.0670173334999999e-11,11752,1025456,796979220
1470,2052092166,79180277,1.0689337395e-11,11752,1025456,798004676
1471,2052783750,79038319,1.0670173065e-11,11689,1025456,799030132
1472,2062951291,79038319,1.0670173065e-11,11710,1025456,800055588
1473,2077166209,79038319,1.0670173065e-11,11710,1025456,801081044
1474,2051299833,79038320,1.0670173199999999e-11,11731,1025456,802106500
1475,2052787959,79180276,1.0689337259999999e-11,11731,1025456,803131956
1476,88772545666,80301731,1.0840733684999999e-11,11731,1025456,804157412
1477,3366113417,79038743,1.0670230304999999e-11,25469,1025904,805183316
1478,3067882583,79038321,1.0670173334999999e-11,11773,1025456,806208772
1479,4022494834,79180278,1.0689337529999999e-11,11794,1025456,807234228
1480,2918800375,79038322,1.0670173469999998e-11,11794,1025456,808259684
1481,2755481000,79038319,1.0670173065e-11,11710,1025456,809285140
1482,2661405417,79180276,1.0689337259999999e-11,11731,1025456,810310596
1483,107615419250,80528862,1.087139637e-11,11752,1025456,811336052
1484,2063673208,79038321,1.0670173334999999e-11,11752,1025456,812361508
1485,2059701167,79038321,1.0670173334999999e-11,11752,1025456,813386964
1486,2075315125,79038321,1.0670173334999999e-11,11752,1025456,814412420
1487,2053798875,79180277,1.0689337395e-11,11773,1025456,815437876
1488,88746802125,80287536,1.0838817359999999e-11,11773,1025456,816463332
1489,2053382125,79038321,1.0670173334999999e-11,11773,1025456,817488788
1490,2051476167,79038321,1.0670173334999999e-11,11773,1025456,818514244
1491,2052096959,79038319,1.0670173065e-11,11710,1025456,819539700
1492,60467384625,79038320,1.0670173199999999e-11,11731,1025456,820565156
1493,27226578416,80230754,1.083115179e-11,11731,1025456,821590612
1494,2977053750,79180695,1.0689393824999999e-11,25337,1025904,822616516
1495,4376301708,79038321,1.0670173334999999e-11,11773,1025456,823641972
1496,2317030583,79038321,1.0670173334999999e-11,11773,1025456,824667428
1497,3073219625,79180277,1.0689337395e-11,11773,1025456,825692884
1498,130462666875,80741798,1.0900142729999998e-11,11773,1025456,826718340
1499,2039205458,79180277,1.0689337395e-11,11773,1025456,827743796
1500,88753781500,80287536,1.0838817359999999e-11,11773,1025456,828769252
1501,2051184000,79038315,1.0670172524999999e-11,11563,1025456,829794708
1502,88746135625,80173966,1.082348541e-11,11605,1025456,830820164
1503,89034864959,80401097,1.0854148094999999e-11,11605,1025456,831845620
1504,108165049625,79038317,1.0670172794999999e-11,11647,1025456,832871076
1505,17674791958,80784381,1.0905891435e-11,11647,1025456,833896532
1506,2051622042,79038317,1.0670172794999999e-11,11647,1025456,834921988
1507,2050616291,79038317,1.0670172794999999e-11,11647,1025456,835947444
1508,88751263041,80372709,1.0850315715e-11,11689,1025456,836972900
1509,27161384250,79038319,1.0670173065e-11,11689,1025456,837998356
1510,27169772750,79748101,1.0765993634999998e-11,11689,1025456,839023812
1511,2058528250,79038731,1.0670228684999999e-11,25079,1025904,840049716
1512,2075907792,79038318,1.0670172929999999e-11,11668,1025456,841075172
1513,2058310583,79038319,1.0670173065e-11,11689,1025456,842100628
1514,2097266833,79180275,1.0689337125e-11,11689,1025456,843126084
1515,2238293125,79038319,1.0670173065e-11,11710,1025456,844151540
1516,2191764833,79038319,1.0670173065e-11,11710,1025456,845176996
1517,2313875208,79038319,1.0670173065e-11,11710,1025456,846202452
1518,2408475000,79180275,1.0689337125e-11,11710,1025456,847227908
1519,2335384917,79038319,1.0670173065e-11,11710,1025456,848253364
1520,2357256292,79038319,1.0670173065e-11,11710,1025456,849278820
1521,2609627458,79038317,1.0670172794999999e-11,11647,1025456,850304276
1522,2333396000,79180274,1.0689336989999998e-11,11668,1025456,851329732
1523,2250520125,79038318,1.0670172929999999e-11,11668,1025456,852355188
1524,2182077584,79038319,1.0670173065e-11,11689,1025456,853380644
1525,2313181458,79038319,1.0670173065e-11,11689,1025456,854406100
1526,33617504959,79492579,1.0731498165e-11,11689,1025456,855431556
1527,2050095417,79180275,1.0689337125e-11,11689,1025456,856457012
1528,2057566125,79038729,1.0670228415e-11,25031,1025904,857482916
1529,2050617083,79038321,1.0670173334999999e-11,11752,1025456,858508372
1530,2053756083,79038321,1.0670173334999999e-11,11752,1025456,859533828
1531,2113861084,79038318,1.0670172929999999e-11,11668,1025456,860559284
1532,2070463250,79180275,1.0689337125e-11,11689,1025456,861584740
1533,2098526375,79038319,1.0670173065e-11,11710,1025456,862610196
1534,2080739500,79038319,1.0670173065e-11,11710,1025456,863635652
1535,2267125792,79038319,1.0670173065e-11,11710,1025456,864661108
1536,2402931917,79180276,1.0689337259999999e-11,11731,1025456,865686564
1537,2468599542,79038320,1.0670173199999999e-11,11731,1025456,866712020
1538,2298786292,79038320,1.0670173199999999e-11,11731,1025456,867737476
1539,2869971375,79038320,1.0670173199999999e-11,11731,1025456,868762932
1540,2472676709,79180276,1.0689337259999999e-11,11731,1025456,869788388
1541,2310194208,79038318,1.0670172929999999e-11,11668,1025456,870813844
1542,3801951125,79038319,1.0670173065e-11,11689,1025456,871839300
1543,2299282625,79038319,1.0670173065e-11,11689,1025456,872864756
1544,2359289875,79180275,1.0689337125e-11,11710,1025456,873890212
1545,2320790875,79038726,1.067022801e-11,24920,1025904,874916116
1546,2326366000,79038321,1.0670173334999999e-11,11752,1025456,875941572
1547,3270343125,79180277,1.0689337395e-11,11752,1025456,876967028
1548,2052584250,79038321,1.0670173334999999e-11,11752,1025456,877992484
1549,2051476917,79038321,1.0670173334999999e-11,11752,1025456,879017940
1550,2056672916,79038321,1.0670173334999999e-11,11752,1025456,880043396
1551,2095675500,79038319,1.0670173065e-11,11689,1025456,881068852
1552,2070284458,79180275,1.0689337125e-11,11710,1025456,882094308
1553,2080369750,79038320,1.0670173199999999e-11,11731,1025456,883119764
1554,2058059792,79038320,1.0670173199999999e-11,11731,1025456,884145220
1555,2101516000,79038320,1.0670173199999999e-11,11731,1025456,885170676
1556,2062286291,79038320,1.0670173199999999e-11,11731,1025456,886196132
1557,2094688542,79180277,1.0689337395e-11,11752,1025456,887221588
1558,2057337375,79038321,1.0670173334999999e-11,11752,1025456,888247044
1559,2102266375,79038321,1.0670173334999999e-11,11752,1025456,889272500
1560,2047544625,79038321,1.0670173334999999e-11,11752,1025456,890297956
1561,2231177084,79180275,1.0689337125e-11,11689,1025456,891323412
1562,2217383417,79038721,1.0670227335e-11,24767,1025904,892349316
1563,2324475333,79038320,1.0670173199999999e-11,11731,1025456,893374772
1564,2167905209,79038320,1.0670173199999999e-11,11731,1025456,894400228
1565,3055703083,79038321,1.0670173334999999e-11,11752,1025456,895425684
1566,2378367666,79038321,1.0670173334999999e-11,11752,1025456,896451140
1567,2406357250,79038321,1.0670173334999999e-11,11752,1025456,897476596
1568,2274355292,79038321,1.0670173334999999e-11,11752,1025456,898502052
1569,2301143209,79180277,1.0689337395e-11,11752,1025456,899527508
1570,2260166375,79038321,1.0670173334999999e-11,11752,1025456,900552964
1571,2214995791,79038319,1.0670173065e-11,11689,1025456,901578420
1572,2245951833,79038319,1.0670173065e-11,11710,1025456,902603876
1573,2188604333,79180275,1.0689337125e-11,11710,1025456,903629332
1574,2076571791,79038320,1.0670173199999999e-11,11731,1025456,904654788
1575,2048030458,79038320,1.0670173199999999e-11,11731,1025456,905680244
1576,2074187625,79038320,1.0670173199999999e-11,11731,1025456,906705700
1577,2144253250,79038320,1.0670173199999999e-11,11731,1025456,907731156
1578,2053791250,79180277,1.0689337395e-11,11752,1025456,908756612
1579,2065446750,79038719,1.0670227065e-11,24698,1025904,909782516
1580,2053819292,79038321,1.0670173334999999e-11,11773,1025456,910807972
1581,2055969292,79038319,1.0670173065e-11,11689,1025456,911833428
1582,2051482500,79180275,1.0689337125e-11,11710,1025456,912858884
1583,2050682583,79038320,1.0670173199999999e-11,11731,1025456,913884340
1584,2064540167,79038320,1.0670173199999999e-11,11731,1025456,914909796
1585,2163851583,79038320,1.0670173199999999e-11,11731,1025456,915935252
1586,2214437542,79038321,1.0670173334999999e-11,11752,1025456,916960708
1587,2260444875,79180277,1.0689337395e-11,11752,1025456,917986164
1588,2221575958,79038321,1.0670173334999999e-11,11752,1025456,919011620
1589,2586361583,79038321,1.0670173334999999e-11,11752,1025456,920037076
1590,2286283750,79038321,1.0670173334999999e-11,11752,1025456,921062532
1591,2592587416,79180275,1.0689337125e-11,11689,1025456,922087988
1592,2325148375,79038319,1.0670173065e-11,11710,1025456,923113444
1593,2697225500,79038319,1.0670173065e-11,11710,1025456,924138900
1594,2603697959,79038320,1.0670173199999999e-11,11731,1025456,925164356
1595,2389302875,79180276,1.0689337259999999e-11,11731,1025456,926189812
1596,2258588250,79038714,1.0670226389999999e-11,24545,1025904,927215716
1597,2156637708,79038321,1.0670173334999999e-11,11752,1025456,928241172
1598,2051841500,79038321,1.0670173334999999e-11,11752,1025456,929266628
1599,2051814958,79180277,1.0689337395e-11,11752,1025456,930292084
1600,2052941958,79038321,1.0670173334999999e-11,11773,1025456,931317540
1601,2052879917,79038315,1.0670172524999999e-11,11563,1025456,932342996
1602,2052146583,79038316,1.067017266e-11,11605,1025456,933368452
1603,2052836291,79038317,1.0670172794999999e-11,11647,1025456,934393908
1604,2051791667,79180273,1.0689336854999999e-11,11647,1025456,935419364
1605,2065010625,79038317,1.0670172794999999e-11,11647,1025456,936444820
1606,2053545292,79038317,1.0670172794999999e-11,11647,1025456,937470276
1607,2073689292,79038319,1.0670173065e-11,11689,1025456,938495732
1608,2053172584,79038319,1.0670173065e-11,11689,1025456,939521188
1609,2063825459,79180275,1.0689337125e-11,11689,1025456,940546644
1610,2053419667,79038319,1.0670173065e-11,11689,1025456,941572100
1611,2051636084,79038317,1.0670172794999999e-11,11626,1025456,942597556
1612,2149829750,79038317,1.0670172794999999e-11,11647,1025456,943623012
1613,2190134917,79180664,1.068938964e-11,24329,1025904,944648916
1614,2318048417,79038319,1.0670173065e-11,11689,1025456,945674372
1615,2618893083,79038319,1.0670173065e-11,11710,1025456,946699828
1616,2395984042,79038319,1.0670173065e-11,11710,1025456,947725284
1617,2350190792,79180275,1.0689337125e-11,11710,1025456,948750740
1618,2420321333,79038319,1.0670173065e-11,11710,1025456,949776196
1619,2407531583,79038319,1.0670173065e-11,11710,1025456,950801652
1620,2465938500,79038319,1.0670173065e-11,11710,1025456,951827108
1621,2482580292,79180273,1.0689336854999999e-11,11647,1025456,952852564
1622,2208141917,79038318,1.0670172929999999e-11,11668,1025456,953878020
1623,2347500709,79038318,1.0670172929999999e-11,11668,1025456,954903476
1624,2137041792,79038319,1.0670173065e-11,11689,1025456,955928932
1625,2173099500,79180275,1.0689337125e-11,11689,1025456,956954388
1626,2069783042,79038319,1.0670173065e-11,11689,1025456,957979844
1627,2053727166,79038319,1.0670173065e-11,11689,1025456,959005300
1628,2065769917,79038319,1.0670173065e-11,11710,1025456,960030756
1629,2054111292,79180275,1.0689337125e-11,11710,1025456,961056212
1630,2050549500,79038705,1.0670225174999999e-11,24260,1025904,962082116
1631,2051947083,79038318,1.0670172929999999e-11,11668,1025456,963107572
1632,2053291167,79038319,1.0670173065e-11,11689,1025456,964133028
1633,2054153292,79038319,1.0670173065e-11,11710,1025456,965158484
1634,2072453208,79180275,1.0689337125e-11,11710,1025456,966183940
1635,2193165208,79038319,1.0670173065e-11,11710,1025456,967209396
1636,3910090459,79038320,1.0670173199999999e-11,11731,1025456,968234852
1637,2390832833,79038320,1.0670173199999999e-11,11731,1025456,969260308
1638,2231375542,79180276,1.0689337259999999e-11,11731,1025456,970285764
1639,2901306750,79038320,1.0670173199999999e-11,11731,1025456,971311220
1640,2252826875,79038320,1.0670173199999999e-11,11731,1025456,972336676
1641,2499363375,79038318,1.0670172929999999e-11,11668,1025456,973362132
1642,2484817959,79180275,1.0689337125e-11,11689,1025456,974387588
1643,2513171125,79038319,1.0670173065e-11,11689,1025456,975413044
1644,2389760666,79038319,1.0670173065e-11,11710,1025456,976438500
1645,2300144125,79038319,1.0670173065e-11,11710,1025456,977463956
1646,2414499792,79180275,1.0689337125e-11,11710,1025456,978489412
1647,2136684708,79038701,1.0670224635e-11,24128,1025904,979515316
1648,2060928666,79038320,1.0670173199999999e-11,11731,1025456,980540772
1649,2099790542,79038321,1.0670173334999999e-11,11752,1025456,981566228
1650,2060153708,79180277,1.0689337395e-11,11752,1025456,982591684
1651,2095974000,79038318,1.0670172929999999e-11,11668,1025456,983617140
1652,2070451917,79038319,1.0670173065e-11,11689,1025456,984642596
1653,2087892500,79038319,1.0670173065e-11,11710,1025456,985668052
1654,2061649542,79038319,1.0670173065e-11,11710,1025456,986693508
1655,2110975916,79180275,1.0689337125e-11,11710,1025456,987718964
1656,2061134875,79038319,1.0670173065e-11,11710,1025456,988744420
1657,2100447292,79038320,1.0670173199999999e-11,11731,1025456,989769876
1658,2059396375,79038320,1.0670173199999999e-11,11731,1025456,990795332
1659,2104249917,79180276,1.0689337259999999e-11,11731,1025456,991820788
1660,2349447500,79038320,1.0670173199999999e-11,11731,1025456,992846244
1661,2555525333,79038318,1.0670172929999999e-11,11668,1025456,993871700
1662,2253684334,79038319,1.0670173065e-11,11689,1025456,994897156
1663,2805820708,79180275,1.0689337125e-11,11689,1025456,995922612
1664,2393387792,79038697,1.0670224094999999e-11,23975,1025904,996948516
1665,2560010292,79038321,1.0670173334999999e-11,11752,1025456,997973972
1666,2465199541,79038321,1.0670173334999999e-11,11752,1025456,998999428
1667,2493525375,79180277,1.0689337395e-11,11752,1025456,1000024884
1668,2480981375,79038321,1.0670173334999999e-11,11752,1025456,1001050340
1669,2303729459,79038321,1.0670173334999999e-11,11752,1025456,1002075796
1670,2325364959,79038321,1.0670173334999999e-11,11752,1025456,1003101252
1671,2206066458,79180275,1.0689337125e-11,11689,1025456,1004126708
1672,2089502708,79038319,1.0670173065e-11,11710,1025456,1005152164
1673,2122711792,79038319,1.0670173065e-11,11710,1025456,1006177620
1674,2036249333,79038320,1.0670173199999999e-11,11731,1025456,1007203076
1675,2123224458,79038320,1.0670173199999999e-11,11731,1025456,1008228532
1676,2057368167,79180276,1.0689337259999999e-11,11731,1025456,1009253988
1677,2105729000,79038320,1.0670173199999999e-11,11731,1025456,1010279444
1678,2062901292,79038321,1.0670173334999999e-11,11752,1025456,1011304900
1679,2099845708,79038321,1.0670173334999999e-11,11752,1025456,1012330356
1680,2059463542,79038321,1.0670173334999999e-11,11752,1025456,1013355812
1681,2125718250,79180648,1.0689387479999998e-11,23822,1025904,1014381716
1682,2071124459,79038319,1.0670173065e-11,11710,1025456,1015407172
1683,3085375042,79038320,1.0670173199999999e-11,11731,1025456,1016432628
1684,2338210583,79038320,1.0670173199999999e-11,11731,1025456,1017458084
1685,2376823584,79180277,1.0689337395e-11,11752,1025456,1018483540
1686,2525497875,79038321,1.0670173334999999e-11,11752,1025456,1019508996
1687,2380604584,79038321,1.0670173334999999e-11,11752,1025456,1020534452
1688,2436046250,79180277,1.0689337395e-11,11752,1025456,1021559908
1689,2342645500,79038321,1.0670173334999999e-11,11752,1025456,1022585364
1690,3802718333,79038321,1.0670173334999999e-11,11752,1025456,1023610820
1691,2372093833,79038319,1.0670173065e-11,11689,1025456,1024636276
1692,2298461834,79180275,1.0689337125e-11,11710,1025456,1025661732
1693,2551248417,79038319,1.0670173065e-11,11710,1025456,1026687188
1694,2118821834,79038320,1.0670173199999999e-11,11731,1025456,1027712644
1695,2052460959,79038320,1.0670173199999999e-11,11731,1025456,1028738100
1696,2037107792,79180276,1.0689337259999999e-11,11731,1025456,1029763556
1697,2109445042,79038320,1.0670173199999999e-11,11731,1025456,1030789012
1698,2087072083,79038690,1.0670223149999998e-11,23753,1025904,1031814916
1699,2115583500,79038336,1.0670175359999998e-11,12257,1025456,1032840372
1700,2083423458,79038336,1.0670175359999998e-11,12257,1025456,1033865828
1701,2112620541,79180285,1.0689338475e-11,12026,1025456,1034891284
1702,2080553083,79038330,1.067017455e-11,12068,1025456,1035916740
1703,2120462250,79038332,1.0670174819999999e-11,12110,1025456,1036942196
1704,2094076500,79038332,1.0670174819999999e-11,12110,1025456,1037967652
1705,2117541333,79038332,1.0670174819999999e-11,12110,1025456,1038993108
1706,2081494375,79180289,1.0689339015e-11,12152,1025456,1040018564
1707,2929110458,79038333,1.0670174955e-11,12152,1025456,1041044020
1708,2398417875,79038333,1.0670174955e-11,12152,1025456,1042069476
1709,2537212250,79038333,1.0670174955e-11,12152,1025456,1043094932
1710,2273038208,79038333,1.0670174955e-11,12152,1025456,1044120388
1711,2601726375,79038331,1.0670174685e-11,12089,1025456,1045145844
1712,2422521708,79038332,1.0670174819999999e-11,12110,1025456,1046171300
1713,2791585250,79180288,1.068933888e-11,12110,1025456,1047196756
1714,2561471916,79038332,1.0670174819999999e-11,12131,1025456,1048222212
1715,2307746292,79039573,1.0670342354999999e-11,52461,1026708,1049248920
1716,2192441292,79038319,1.0670173065e-11,11710,1025456,1050274376
1717,2345958500,79180275,1.0689337125e-11,11710,1025456,1051299832
1718,2202799666,79038319,1.0670173065e-11,11710,1025456,1052325288
1719,2051012167,79038319,1.0670173065e-11,11710,1025456,1053350744
1720,2050867125,79038319,1.0670173065e-11,11710,1025456,1054376200
1721,2051066166,79038317,1.0670172794999999e-11,11647,1025456,1055401656
1722,2072292000,79180274,1.0689336989999998e-11,11668,1025456,1056427112
1723,2061621833,79038319,1.0670173065e-11,11689,1025456,1057452568
1724,2050981167,79038319,1.0670173065e-11,11689,1025456,1058478024
1725,2060934292,79038319,1.0670173065e-11,11689,1025456,1059503480
1726,2072129917,79180275,1.0689337125e-11,11689,1025456,1060528936
1727,2065181958,79038319,1.0670173065e-11,11710,1025456,1061554392
1728,2061052041,79038319,1.0670173065e-11,11710,1025456,1062579848
1729,61237020375,171889748,2.3205115979999995e-11,11710,-177109676,885470172
1730,2060307417,79357926,1.071332001e-11,11710,1025456,886495628
1731,2096886125,79038317,1.0670172794999999e-11,11647,1025456,887521084
1732,2083433625,79216307,1.0694201445e-11,25649,1025904,888546988
1733,2103813875,79038319,1.0670173065e-11,11710,1025456,889572444
1734,2087195208,79038319,1.0670173065e-11,11710,1025456,890597900
1735,2105219000,79038320,1.0670173199999999e-11,11731,1025456,891623356
1736,2091383500,79215879,1.0694143665e-11,11731,1025456,892648812
1737,2095952542,79038320,1.0670173199999999e-11,11731,1025456,893674268
1738,2088894292,79038320,1.0670173199999999e-11,11731,1025456,894699724
1739,2111733375,79038320,1.0670173199999999e-11,11731,1025456,895725180
1740,2057408291,79038320,1.0670173199999999e-11,11731,1025456,896750636
1741,2092207292,79215877,1.0694143394999998e-11,11668,1025456,897776092
1742,2057583458,79038319,1.0670173065e-11,11689,1025456,898801548
1743,2100442792,79038319,1.0670173065e-11,11689,1025456,899827004
1744,2070345291,79038319,1.0670173065e-11,11710,1025456,900852460
1745,2089656917,79038319,1.0670173065e-11,11710,1025456,901877916
1746,2073200667,79215878,1.0694143529999999e-11,11710,1025456,902903372
1747,2089513208,79038319,1.0670173065e-11,11710,1025456,903928828
1748,2060347500,79038320,1.0670173199999999e-11,11731,1025456,904954284
1749,2283318666,79038747,1.0670230845e-11,25601,1025904,905980188
1750,2244588791,79215880,1.0694143799999998e-11,11773,1025456,907005644
1751,2238655875,79038319,1.0670173065e-11,11689,1025456,908031100
1752,2195243959,79038319,1.0670173065e-11,11710,1025456,909056556
1753,2761917958,79038320,1.0670173199999999e-11,11731,1025456,910082012
1754,2744028792,79215879,1.0694143665e-11,11731,1025456,911107468
1755,2878196625,79038320,1.0670173199999999e-11,11731,1025456,912132924
1756,2383553083,79038321,1.0670173334999999e-11,11752,1025456,913158380
1757,2413166292,79038321,1.0670173334999999e-11,11752,1025456,914183836
1758,2265312541,79215880,1.0694143799999998e-11,11752,1025456,915209292
1759,2281427250,79038321,1.0670173334999999e-11,11752,1025456,916234748
1760,2294766917,79038321,1.0670173334999999e-11,11752,1025456,917260204
1761,2257258500,79038319,1.0670173065e-11,11689,1025456,918285660
1762,2248974500,79215878,1.0694143529999999e-11,11710,1025456,919311116
1763,2073278083,79038319,1.0670173065e-11,11710,1025456,920336572
1764,2043420417,79038320,1.0670173199999999e-11,11731,1025456,921362028
1765,2101421208,79038320,1.0670173199999999e-11,11731,1025456,922387484
1766,2080730584,79038743,1.0670230304999999e-11,25469,1025904,923413388
1767,2090691125,79215880,1.0694143799999998e-11,11752,1025456,924438844
1768,2060485625,79038321,1.0670173334999999e-11,11752,1025456,925464300
1769,2100446000,79038321,1.0670173334999999e-11,11752,1025456,926489756
1770,2082222292,79038321,1.0670173334999999e-11,11773,1025456,927515212
1771,2099236875,79038319,1.0670173065e-11,11689,1025456,928540668
1772,2075472084,79215878,1.0694143529999999e-11,11710,1025456,929566124
1773,2320804625,79038320,1.0670173199999999e-11,11731,1025456,930591580
1774,2307097167,79038320,1.0670173199999999e-11,11731,1025456,931617036
1775,2505903750,79038320,1.0670173199999999e-11,11731,1025456,932642492
1776,2116286708,79215879,1.0694143665e-11,11731,1025456,933667948
1777,2611896791,79038321,1.0670173334999999e-11,11752,1025456,934693404
1778,2494597167,79038321,1.0670173334999999e-11,11752,1025456,935718860
1779,2381016667,79038321,1.0670173334999999e-11,11752,1025456,936744316
1780,51098210583,80068164,1.080920214e-11,11752,1025456,937769772
1781,2052346750,79038319,1.0670173065e-11,11689,1025456,938795228
1782,2052996750,79038319,1.0670173065e-11,11710,1025456,939820684
1783,2053233750,79038738,1.067022963e-11,25316,1025904,940846588
1784,2052739666,79215879,1.0694143665e-11,11731,1025456,941872044
1785,2052252875,79038321,1.0670173334999999e-11,11752,1025456,942897500
1786,2051744542,79038321,1.0670173334999999e-11,11752,1025456,943922956
1787,2052122750,79038321,1.0670173334999999e-11,11752,1025456,944948412
1788,2051115000,79038321,1.0670173334999999e-11,11752,1025456,945973868
1789,2052740125,79215880,1.0694143799999998e-11,11752,1025456,946999324
1790,2051141000,79038321,1.0670173334999999e-11,11752,1025456,948024780
1791,2064273208,79038319,1.0670173065e-11,11689,1025456,949050236
1792,2073043750,79038319,1.0670173065e-11,11710,1025456,950075692
1793,2667281083,79215878,1.0694143529999999e-11,11710,1025456,951101148
1794,2369970458,79038320,1.0670173199999999e-11,11731,1025456,952126604
1795,2769321500,79038320,1.0670173199999999e-11,11731,1025456,953152060
1796,2662184208,79038320,1.0670173199999999e-11,11731,1025456,954177516
1797,2316626250,79215879,1.0694143665e-11,11731,1025456,955202972
1798,2363728583,79038321,1.0670173334999999e-11,11752,1025456,956228428
1799,2508085458,79038321,1.0670173334999999e-11,11752,1025456,957253884
1800,2668638625,79038735,1.0670229225e-11,25226,1025904,958279788
1801,2364470667,79215874,1.069414299e-11,11563,1025456,959305244
1802,2500748000,79038316,1.067017266e-11,11605,1025456,960330700
1803,2396496042,79038317,1.0670172794999999e-11,11647,1025456,961356156
1804,2283971375,79038317,1.0670172794999999e-11,11647,1025456,962381612
1805,2053606500,79215876,1.069414326e-11,11647,1025456,963407068
1806,2058429875,79038319,1.0670173065e-11,11689,1025456,964432524
1807,2074517542,79038319,1.0670173065e-11,11689,1025456,965457980
1808,2065367791,79038319,1.0670173065e-11,11689,1025456,966483436
1809,2091343500,79038319,1.0670173065e-11,11689,1025456,967508892
1810,2059747209,79215878,1.0694143529999999e-11,11689,1025456,968534348
1811,2101997042,79038317,1.0670172794999999e-11,11626,1025456,969559804
1812,2069864250,79038317,1.0670172794999999e-11,11647,1025456,970585260
1813,2094929500,79038317,1.0670172794999999e-11,11647,1025456,971610716
1814,2274692458,79215877,1.0694143394999998e-11,11668,1025456,972636172
1815,2909242250,79038318,1.0670172929999999e-11,11668,1025456,973661628
1816,2466488833,79038319,1.0670173065e-11,11689,1025456,974687084
1817,2374929625,79038729,1.0670228415e-11,25031,1025904,975712988
1818,2475619250,79215879,1.0694143665e-11,11731,1025456,976738444
1819,2335633708,79038321,1.0670173334999999e-11,11752,1025456,977763900
1820,2411699667,79038321,1.0670173334999999e-11,11752,1025456,978789356
1821,2471401958,79038318,1.0670172929999999e-11,11668,1025456,979814812
1822,2312018583,79215878,1.0694143529999999e-11,11689,1025456,980840268
1823,2936503125,79038319,1.0670173065e-11,11710,1025456,981865724
1824,2150983292,79038319,1.0670173065e-11,11710,1025456,982891180
1825,2501081666,79215878,1.0694143529999999e-11,11710,1025456,983916636
1826,2176931792,79038319,1.0670173065e-11,11710,1025456,984942092
1827,2242100708,79038320,1.0670173199999999e-11,11731,1025456,985967548
1828,2058400458,79038320,1.0670173199999999e-11,11731,1025456,986993004
1829,2092722875,79038320,1.0670173199999999e-11,11731,1025456,988018460
1830,2059421584,79215879,1.0694143665e-11,11731,1025456,989043916
1831,2109412250,79038318,1.0670172929999999e-11,11668,1025456,990069372
1832,2048536958,79038319,1.0670173065e-11,11689,1025456,991094828
1833,2075776959,79038319,1.0670173065e-11,11689,1025456,992120284
1834,2058777667,79038725,1.0670227874999999e-11,24899,1025904,993146188
1835,2112773500,79215880,1.0694143799999998e-11,11752,1025456,994171644
1836,2037053333,79038321,1.0670173334999999e-11,11752,1025456,995197100
1837,2094226208,79038321,1.0670173334999999e-11,11752,1025456,996222556
1838,2060345208,79038321,1.0670173334999999e-11,11752,1025456,997248012
1839,2095239250,79215880,1.0694143799999998e-11,11752,1025456,998273468
1840,2063352542,79038321,1.0670173334999999e-11,11752,1025456,999298924
1841,2096076917,79038319,1.0670173065e-11,11689,1025456,1000324380
1842,2056585250,79038319,1.0670173065e-11,11710,1025456,1001349836
1843,2094807917,79038319,1.0670173065e-11,11710,1025456,1002375292
1844,2058967625,79215879,1.0694143665e-11,11731,1025456,1003400748
1845,2094867541,79038320,1.0670173199999999e-11,11731,1025456,1004426204
1846,2060804459,79038320,1.0670173199999999e-11,11731,1025456,1005451660
1847,2094759458,79038320,1.0670173199999999e-11,11731,1025456,1006477116
1848,2062302708,79038321,1.0670173334999999e-11,11752,1025456,1007502572
1849,2158335333,79215880,1.0694143799999998e-11,11752,1025456,1008528028
1850,2237170000,79038321,1.0670173334999999e-11,11752,1025456,1009553484
1851,2799643458,79038721,1.0670227335e-11,24746,1025904,1010579388
1852,2203743625,79038319,1.0670173065e-11,11710,1025456,1011604844
1853,2359817166,79215879,1.0694143665e-11,11731,1025456,1012630300
1854,2360755417,79038320,1.0670173199999999e-11,11731,1025456,1013655756
1855,2401507625,79038321,1.0670173334999999e-11,11752,1025456,1014681212
1856,2396733084,79038321,1.0670173334999999e-11,11752,1025456,1015706668
1857,2239473166,79215880,1.0694143799999998e-11,11752,1025456,1016732124
1858,2477053583,79038321,1.0670173334999999e-11,11752,1025456,1017757580
1859,2329121458,79038321,1.0670173334999999e-11,11752,1025456,1018783036
1860,2143289083,79038321,1.0670173334999999e-11,11752,1025456,1019808492
1861,2313892250,79215878,1.0694143529999999e-11,11689,1025456,1020833948
1862,2245009916,79038319,1.0670173065e-11,11710,1025456,1021859404
1863,2070443042,79038319,1.0670173065e-11,11710,1025456,1022884860
1864,2069335750,79038320,1.0670173199999999e-11,11731,1025456,1023910316
1865,2062443583,79215879,1.0694143665e-11,11731,1025456,1024935772
1866,2057860292,79038320,1.0670173199999999e-11,11731,1025456,1025961228
1867,2055857833,79038320,1.0670173199999999e-11,11731,1025456,1026986684
1868,2051721375,79038718,1.0670226929999998e-11,24677,1025904,1028012588
1869,2052876792,79038321,1.0670173334999999e-11,11773,1025456,1029038044
1870,2064106833,79215880,1.0694143799999998e-11,11773,1025456,1030063500
1871,2070025584,79038319,1.0670173065e-11,11689,1025456,1031088956
1872,2057322750,79038319,1.0670173065e-11,11710,1025456,1032114412
1873,2090284958,79038320,1.0670173199999999e-11,11731,1025456,1033139868
1874,2239475542,79038320,1.0670173199999999e-11,11731,1025456,1034165324
1875,2562145333,79215879,1.0694143665e-11,11731,1025456,1035190780
1876,2156813250,79038321,1.0670173334999999e-11,11752,1025456,1036216236
1877,2507438250,79038321,1.0670173334999999e-11,11752,1025456,1037241692
1878,2246266084,79038321,1.0670173334999999e-11,11752,1025456,1038267148
1879,2262047084,79215880,1.0694143799999998e-11,11752,1025456,1039292604
1880,2304279375,79038321,1.0670173334999999e-11,11752,1025456,1040318060
1881,2255250125,79038319,1.0670173065e-11,11689,1025456,1041343516
1882,2201491625,79038319,1.0670173065e-11,11710,1025456,1042368972
1883,2282497333,79215878,1.0694143529999999e-11,11710,1025456,1043394428
1884,2178282958,79038320,1.0670173199999999e-11,11731,1025456,1044419884
1885,2205332084,79038714,1.0670226389999999e-11,24545,1025904,1045445788
1886,2274190208,79038321,1.0670173334999999e-11,11752,1025456,1046471244
1887,2052254084,79038321,1.0670173334999999e-11,11752,1025456,1047496700
1888,2051292959,79038321,1.0670173334999999e-11,11752,1025456,1048522156
1889,2051699625,79038321,1.0670173334999999e-11,11752,1025456,1049547612
1890,2051835584,79038321,1.0670173334999999e-11,11752,1025456,1050573068
1891,2051799500,79038319,1.0670173065e-11,11689,1025456,1051598524
1892,2053099125,79215878,1.0694143529999999e-11,11710,1025456,1052623980
1893,2051806292,79038320,1.0670173199999999e-11,11731,1025456,1053649436
1894,2050917916,79038320,1.0670173199999999e-11,11731,1025456,1054674892
1895,2051631958,79038320,1.0670173199999999e-11,11731,1025456,1055700348
1896,2051271875,79038320,1.0670173199999999e-11,11731,1025456,1056725804
1897,2051514792,79215880,1.0694143799999998e-11,11752,1025456,1057751260
1898,2050866958,79038321,1.0670173334999999e-11,11752,1025456,1058776716
1899,2050968542,79038321,1.0670173334999999e-11,11752,1025456,1059802172
1900,2050733209,79038321,1.0670173334999999e-11,11752,1025456,1060827628
1901,2051404417,79038315,1.0670172524999999e-11,11563,1025456,1061853084
1902,2083851542,79216264,1.069419564e-11,24245,1025904,1062878988
1903,2168729375,79038317,1.0670172794999999e-11,11647,1025456,1063904444
1904,2332076958,79038317,1.0670172794999999e-11,11647,1025456,1064929900
1905,2294310542,79038319,1.0670173065e-11,11689,1025456,1065955356
1906,2158147750,79215878,1.0694143529999999e-11,11689,1025456,1066980812
1907,2799849458,79038319,1.0670173065e-11,11689,1025456,1068006268
1908,2134738542,79038319,1.0670173065e-11,11689,1025456,1069031724
1909,2234851000,79038319,1.0670173065e-11,11689,1025456,1070057180
1910,2206685750,79215878,1.0694143529999999e-11,11689,1025456,1071082636
1911,2264640291,79038317,1.0670172794999999e-11,11626,1025456,1072108092
1912,2276803500,79038317,1.0670172794999999e-11,11647,1025456,1073133548
1913,2359763458,79038316,1.067017266e-11,11611,1025456,1074159004
1914,2571301959,79038318,1.0670172929999999e-11,11653,1025456,1075184460
1915,2239149500,79215877,1.0694143394999998e-11,11653,1025456,1076209916
1916,2156814834,79038318,1.0670172929999999e-11,11653,1025456,1077235372
1917,2054458500,79038318,1.0670172929999999e-11,11653,1025456,1078260828
1918,2051773875,79038318,1.0670172929999999e-11,11674,1025456,1079286284
1919,2051889541,79216264,1.069419564e-11,24224,1025904,1080312188
1920,2051665750,79038320,1.0670173199999999e-11,11716,1025456,1081337644
1921,2051736708,79038317,1.0670172794999999e-11,11632,1025456,1082363100
1922,2052141000,79038318,1.0670172929999999e-11,11653,1025456,1083388556
1923,2050274416,79038318,1.0670172929999999e-11,11674,1025456,1084414012
1924,2050088167,79215877,1.0694143394999998e-11,11674,1025456,1085439468
1925,2052162041,79038318,1.0670172929999999e-11,11674,1025456,1086464924
1926,2051555667,79038319,1.0670173065e-11,11695,1025456,1087490380
1927,2055295625,79038319,1.0670173065e-11,11695,1025456,1088515836
1928,2066601041,79038319,1.0670173065e-11,11695,1025456,1089541292
1929,2051804500,79215878,1.0694143529999999e-11,11695,1025456,1090566748
1930,2111852292,79038319,1.0670173065e-11,11695,1025456,1091592204
1931,2050878917,79038317,1.0670172794999999e-11,11632,1025456,1092617660
1932,2115626208,79038318,1.0670172929999999e-11,11653,1025456,1093643116
1933,2051631083,79215877,1.0694143394999998e-11,11653,1025456,1094668572
1934,2115654542,79038318,1.0670172929999999e-11,11674,1025456,1095694028
1935,2055509625,79038318,1.0670172929999999e-11,11674,1025456,1096719484
1936,2299717333,79038700,1.0670224499999999e-11,24092,1025904,1097745388
1937,2238820333,79038319,1.0670173065e-11,11695,1025456,1098770844
1938,2273768750,79215878,1.0694143529999999e-11,11695,1025456,1099796300
1939,2180105000,79038319,1.0670173065e-11,11695,1025456,1100821756
1940,2539602875,79038320,1.0670173199999999e-11,11716,1025456,1101847212
1941,2530938125,79038317,1.0670172794999999e-11,11632,1025456,1102872668
1942,2408645458,79215877,1.0694143394999998e-11,11653,1025456,1103898124
1943,2533565541,79038318,1.0670172929999999e-11,11674,1025456,1104923580
1944,2720786791,79038318,1.0670172929999999e-11,11674,1025456,1105949036
1945,2255794291,79038318,1.0670172929999999e-11,11674,1025456,1106974492
1946,2324546250,79038318,1.0670172929999999e-11,11674,1025456,1107999948
1947,2208464750,79038319,1.0670173065e-11,11695,1025456,1109025404
1948,2190316834,79038319,1.0670173065e-11,11695,1025456,1110050860
1949,2062469750,79038319,1.0670173065e-11,11695,1025456,1111076316
1950,2050842333,79215878,1.0694143529999999e-11,11695,1025456,1112101772
1951,2055921334,79038317,1.0670172794999999e-11,11632,1025456,1113127228
1952,2053217750,79038318,1.0670172929999999e-11,11653,1025456,1114152684
1953,2052618125,79038696,1.0670223959999998e-11,23939,1025904,1115178588
1954,2051331167,79038319,1.0670173065e-11,11695,1025456,1116204044
1955,2048459084,79215879,1.0694143665e-11,11716,1025456,1117229500
1956,2103925334,79038320,1.0670173199999999e-11,11716,1025456,1118254956
1957,2050042916,79038320,1.0670173199999999e-11,11716,1025456,1119280412
1958,2189040750,79038320,1.0670173199999999e-11,11716,1025456,1120305868
1959,2205235209,79215879,1.0694143665e-11,11716,1025456,1121331324
1960,2344585166,79038320,1.0670173199999999e-11,11716,1025456,1122356780
1961,2455281084,79038318,1.0670172929999999e-11,11653,1025456,1123382236
1962,2218506375,79038318,1.0670172929999999e-11,11674,1025456,1124407692
1963,2640786833,79215877,1.0694143394999998e-11,11674,1025456,1125433148
1964,2443852250,79038319,1.0670173065e-11,11695,1025456,1126458604
1965,3780231417,79038319,1.0670173065e-11,11695,1025456,1127484060
1966,2377566125,79038319,1.0670173065e-11,11695,1025456,1128509516
1967,3785128208,79215878,1.0694143529999999e-11,11695,1025456,1129534972
1968,2197170125,79038320,1.0670173199999999e-11,11716,1025456,1130560428
1969,3582815083,79038320,1.0670173199999999e-11,11716,1025456,1131585884
1970,2181752958,79216252,1.069419402e-11,23870,1025904,1132611788
1971,2051997958,79038318,1.0670172929999999e-11,11653,1025456,1133637244
1972,2052488000,79038318,1.0670172929999999e-11,11674,1025456,1134662700
1973,2051757875,79038319,1.0670173065e-11,11695,1025456,1135688156
1974,2052766208,79215878,1.0694143529999999e-11,11695,1025456,1136713612
1975,2050288416,79038319,1.0670173065e-11,11695,1025456,1137739068
1976,2053875375,79038320,1.0670173199999999e-11,11716,1025456,1138764524
1977,2052218250,79038320,1.0670173199999999e-11,11716,1025456,1139789980
1978,2051712917,79038320,1.0670173199999999e-11,11716,1025456,1140815436
1979,2051431625,79215879,1.0694143665e-11,11716,1025456,1141840892
1980,2051527625,79038320,1.0670173199999999e-11,11716,1025456,1142866348
1981,2059877209,79038318,1.0670172929999999e-11,11653,1025456,1143891804
1982,2052661625,79038318,1.0670172929999999e-11,11674,1025456,1144917260
1983,2051606917,79038318,1.0670172929999999e-11,11674,1025456,1145942716
1984,2051015083,79215878,1.0694143529999999e-11,11695,1025456,1146968172
1985,2052743750,79038319,1.0670173065e-11,11695,1025456,1147993628
1986,2079861208,79038319,1.0670173065e-11,11695,1025456,1149019084
1987,2633501125,79038689,1.0670223015e-11,23717,1025904,1150044988
1988,2532862167,79215893,1.0694145555e-11,12200,1025456,1151070444
1989,2222684792,79038335,1.0670175224999999e-11,12221,1025456,1152095900
1990,2636490459,79038335,1.0670175224999999e-11,12221,1025456,1153121356
1991,2442192584,79038333,1.0670174955e-11,12137,1025456,1154146812
1992,2498948958,79215892,1.069414542e-11,12158,1025456,1155172268
1993,2379511792,79038334,1.067017509e-11,12179,1025456,1156197724
1994,2596978583,79038334,1.067017509e-11,12179,1025456,1157223180
1995,2479914292,79038334,1.067017509e-11,12179,1025456,1158248636
1996,2307578625,79215893,1.0694145555e-11,12179,1025456,1159274092
1997,2219018000,79038334,1.067017509e-11,12200,1025456,1160299548
1998,2447290708,79038334,1.067017509e-11,12200,1025456,1161325004
1999,2125566375,79038334,1.067017509e-11,12200,1025456,1162350460
2000,2053507709,79215893,1.0694145555e-11,12200,1025456,1163375916
2001,2053591666,79038321,1.0670173334999999e-11,11780,1025456,1164401372
2002,2053725375,79038324,1.067017374e-11,11843,1025456,1165426828
2003,2067765291,79038324,1.067017374e-11,11843,1025456,1166452284
2004,2087951041,79039560,1.0670340599999998e-11,52041,1026708,1167478992
2005,2076269167,79215873,1.0694142855e-11,11527,1025456,1168504448
2006,2107954292,79038314,1.0670172389999998e-11,11527,1025456,1169529904
2007,2062294708,79038314,1.0670172389999998e-11,11527,1025456,1170555360
2008,2104007750,79038314,1.0670172389999998e-11,11527,1025456,1171580816
2009,2061320833,79038314,1.0670172389999998e-11,11527,1025456,1172606272
2010,2976274625,79215873,1.0694142855e-11,11527,1025456,1173631728
2011,2607814375,79038312,1.0670172119999999e-11,11464,1025456,1174657184
2012,2335681709,79038314,1.0670172389999998e-11,11527,1025456,1175682640
2013,2236047334,79215873,1.0694142855e-11,11527,1025456,1176708096
2014,2534519667,79038314,1.0670172389999998e-11,11548,1025456,1177733552
2015,2293236208,79038314,1.0670172389999998e-11,11548,1025456,1178759008
2016,2248665708,79038314,1.0670172389999998e-11,11548,1025456,1179784464
2017,2559924208,79215873,1.0694142855e-11,11548,1025456,1180809920
2018,2310773583,79038315,1.0670172524999999e-11,11569,1025456,1181835376
2019,2544255041,79038315,1.0670172524999999e-11,11569,1025456,1182860832
2020,2288657000,79038315,1.0670172524999999e-11,11569,1025456,1183886288
2021,2587414541,79216302,1.069420077e-11,25487,1025904,1184912192
2022,2209745250,79038315,1.0670172524999999e-11,11569,1025456,1185937648
2023,2064068333,79038316,1.067017266e-11,11590,1025456,1186963104
2024,2072048916,79038316,1.067017266e-11,11590,1025456,1187988560
2025,2071926958,79038316,1.067017266e-11,11611,1025456,1189014016
2026,2063446958,79215875,1.0694143124999999e-11,11611,1025456,1190039472
2027,2060461834,79038316,1.067017266e-11,11611,1025456,1191064928
2028,2053505459,79038316,1.067017266e-11,11611,1025456,1192090384
2029,2055353875,79038316,1.067017266e-11,11611,1025456,1193115840
2030,2073908375,79215875,1.0694143124999999e-11,11611,1025456,1194141296
2031,2074873459,79038314,1.0670172389999998e-11,11548,1025456,1195166752
2032,2052644834,79038315,1.0670172524999999e-11,11569,1025456,1196192208
2033,2052433166,79038315,1.0670172524999999e-11,11569,1025456,1197217664
2034,2054495750,79038316,1.067017266e-11,11590,1025456,1198243120
2035,2059780666,79215875,1.0694143124999999e-11,11590,1025456,1199268576
2036,2052779458,79038316,1.067017266e-11,11590,1025456,1200294032
2037,2071098792,79038316,1.067017266e-11,11590,1025456,1201319488
2038,2150512291,79038742,1.0670230169999999e-11,25460,1025904,1202345392
2039,2200636292,79038318,1.0670172929999999e-11,11674,1025456,1203370848
2040,2246237291,79215877,1.0694143394999998e-11,11674,1025456,1204396304
2041,2293545750,79038316,1.067017266e-11,11590,1025456,1205421760
2042,2129302125,79038316,1.067017266e-11,11611,1025456,1206447216
2043,2378813292,79038317,1.0670172794999999e-11,11632,1025456,1207472672
2044,2682219041,79215876,1.069414326e-11,11632,1025456,1208498128
2045,2293909708,79038317,1.0670172794999999e-11,11632,1025456,1209523584
2046,2235672042,79038318,1.0670172929999999e-11,11653,1025456,1210549040
2047,2752360375,79038318,1.0670172929999999e-11,11653,1025456,1211574496
2048,3836780291,79215877,1.0694143394999998e-11,11653,1025456,1212599952
2049,2250634291,79038318,1.0670172929999999e-11,11653,1025456,1213625408
2050,2268665625,79038318,1.0670172929999999e-11,11653,1025456,1214650864
2051,2191304042,79038316,1.067017266e-11,11590,1025456,1215676320
2052,2060251875,79215875,1.0694143124999999e-11,11611,1025456,1216701776
2053,2052751625,79038316,1.067017266e-11,11611,1025456,1217727232
2054,2052707291,79038317,1.0670172794999999e-11,11632,1025456,1218752688
2055,2061122917,79038740,1.0670229899999999e-11,25370,1025904,1219778592
2056,2052190459,79038318,1.0670172929999999e-11,11653,1025456,1220804048
2057,2062695792,79215877,1.0694143394999998e-11,11653,1025456,1221829504
2058,2070476667,79038318,1.0670172929999999e-11,11653,1025456,1222854960
2059,2073485125,79038318,1.0670172929999999e-11,11653,1025456,1223880416
2060,2052727334,79038318,1.0670172929999999e-11,11653,1025456,1224905872
2061,2051486292,79038316,1.067017266e-11,11590,1025456,1225931328
2062,2052144709,79215875,1.0694143124999999e-11,11611,1025456,1226956784
2063,2050801750,79038317,1.0670172794999999e-11,11632,1025456,1227982240
2064,2051693709,79038317,1.0670172794999999e-11,11632,1025456,1229007696
2065,2051433959,79038317,1.0670172794999999e-11,11632,1025456,1230033152
2066,2064530375,79215876,1.069414326e-11,11632,1025456,1231058608
2067,2622009334,79038318,1.0670172929999999e-11,11653,1025456,1232084064
2068,2349578208,79038318,1.0670172929999999e-11,11653,1025456,1233109520
2069,2136469375,79038318,1.0670172929999999e-11,11653,1025456,1234134976
2070,2146737750,79215877,1.0694143394999998e-11,11653,1025456,1235160432
2071,2793211166,79038316,1.067017266e-11,11590,1025456,1236185888
2072,2324445875,79038734,1.0670229089999999e-11,25196,1025904,1237211792
2073,2477948250,79038317,1.0670172794999999e-11,11632,1025456,1238237248
2074,2609702666,79215876,1.069414326e-11,11632,1025456,1239262704
2075,2161119167,79038318,1.0670172929999999e-11,11653,1025456,1240288160
2076,3812898084,79038318,1.0670172929999999e-11,11653,1025456,1241313616
2077,2307100500,79038318,1.0670172929999999e-11,11653,1025456,1242339072
2078,2236719458,79038318,1.0670172929999999e-11,11653,1025456,1243364528
2079,2151605916,79038318,1.0670172929999999e-11,11653,1025456,1244389984
2080,2062285833,79038318,1.0670172929999999e-11,11653,1025456,1245415440
2081,2055583833,79038316,1.067017266e-11,11590,1025456,1246440896
2082,40826736292,79855088,1.078043688e-11,11611,1025456,1247466352
2083,2062401375,79038316,1.067017266e-11,11611,1025456,1248491808
2084,2050788000,79038317,1.0670172794999999e-11,11632,1025456,1249517264
2085,2056415875,79038317,1.0670172794999999e-11,11632,1025456,1250542720
2086,2060883042,79038317,1.0670172794999999e-11,11632,1025456,1251568176
2087,2096660500,79215876,1.069414326e-11,11632,1025456,1252593632
2088,2084018250,79038318,1.0670172929999999e-11,11653,1025456,1253619088
2089,2238540417,79038732,1.067022882e-11,25127,1025904,1254644992
2090,2250758375,79038320,1.0670173199999999e-11,11716,1025456,1255670448
2091,2769789958,79215876,1.069414326e-11,11632,1025456,1256695904
2092,2257181916,79038318,1.0670172929999999e-11,11653,1025456,1257721360
2093,2614133500,79038318,1.0670172929999999e-11,11674,1025456,1258746816
2094,2408101500,79038318,1.0670172929999999e-11,11674,1025456,1259772272
2095,2217611959,79215877,1.0694143394999998e-11,11674,1025456,1260797728
2096,2536122709,79038319,1.0670173065e-11,11695,1025456,1261823184
2097,2353443042,79038319,1.0670173065e-11,11695,1025456,1262848640
2098,2582511292,79038319,1.0670173065e-11,11695,1025456,1263874096
2099,2368802333,79215878,1.0694143529999999e-11,11695,1025456,1264899552
2100,2191138834,79038319,1.0670173065e-11,11695,1025456,1265925008
2101,2335859625,79038313,1.0670172255e-11,11485,1025456,1266950464
2102,2177160833,79038314,1.0670172389999998e-11,11527,1025456,1267975920
2103,2057126292,79215873,1.0694142855e-11,11527,1025456,1269001376
2104,2119571208,79038315,1.0670172524999999e-11,11569,1025456,1270026832
2105,2053321125,79038315,1.0670172524999999e-11,11569,1025456,1271052288
2106,2058808417,79038725,1.0670227874999999e-11,24911,1025904,1272078192
2107,2071092542,79038316,1.067017266e-11,11611,1025456,1273103648
2108,2053976167,79215875,1.0694143124999999e-11,11611,1025456,1274129104
2109,2051827375,79038316,1.067017266e-11,11611,1025456,1275154560
2110,2052372917,79038318,1.0670172929999999e-11,11653,1025456,1276180016
2111,2051460333,79038315,1.0670172524999999e-11,11569,1025456,1277205472
2112,2052265583,79038316,1.067017266e-11,11590,1025456,1278230928
2113,2052699042,79215875,1.0694143124999999e-11,11611,1025456,1279256384
2114,2052540750,79038316,1.067017266e-11,11611,1025456,1280281840
2115,2051908709,79038316,1.067017266e-11,11611,1025456,1281307296
2116,2051539333,79038316,1.067017266e-11,11611,1025456,1282332752
2117,2052128542,79038317,1.0670172794999999e-11,11632,1025456,1283358208
2118,2051788958,79215876,1.069414326e-11,11632,1025456,1284383664
2119,2051207292,79038317,1.0670172794999999e-11,11632,1025456,1285409120
2120,2050828500,79038317,1.0670172794999999e-11,11632,1025456,1286434576
2121,2051320250,79038315,1.0670172524999999e-11,11569,1025456,1287460032
2122,2064669833,79215875,1.0694143124999999e-11,11590,1025456,1288485488
2123,2154655917,79038722,1.067022747e-11,24800,1025904,1289511392
2124,2296161750,79038317,1.0670172794999999e-11,11632,1025456,1290536848
2125,2422224458,79038318,1.0670172929999999e-11,11653,1025456,1291562304
2126,2187282542,79215877,1.0694143394999998e-11,11653,1025456,1292587760
2127,2239628875,79038318,1.0670172929999999e-11,11653,1025456,1293613216
2128,2476902125,79038318,1.0670172929999999e-11,11653,1025456,1294638672
2129,2256345584,79038318,1.0670172929999999e-11,11653,1025456,1295664128
2130,2344897042,79038318,1.0670172929999999e-11,11653,1025456,1296689584
2131,2343218834,79215875,1.0694143124999999e-11,11590,1025456,1297715040
2132,2340992750,79038316,1.067017266e-11,11611,1025456,1298740496
2133,2280425917,79038316,1.067017266e-11,11611,1025456,1299765952
2134,2145897541,79038317,1.0670172794999999e-11,11632,1025456,1300791408
2135,2332750666,79215876,1.069414326e-11,11632,1025456,1301816864
2136,2270723250,79038317,1.0670172794999999e-11,11632,1025456,1302842320
2137,2057639375,79038317,1.0670172794999999e-11,11632,1025456,1303867776
2138,2055388167,79038318,1.0670172929999999e-11,11653,1025456,1304893232
2139,2049005709,79215877,1.0694143394999998e-11,11653,1025456,1305918688
2140,2062912625,79038720,1.0670227199999999e-11,24731,1025904,1306944592
2141,2071779625,79038316,1.067017266e-11,11590,1025456,1307970048
2142,2062870541,79038316,1.067017266e-11,11611,1025456,1308995504
2143,2055939250,79038317,1.0670172794999999e-11,11632,1025456,1310020960
2144,2056482334,79215876,1.069414326e-11,11632,1025456,1311046416
2145,2054183459,79038317,1.0670172794999999e-11,11632,1025456,1312071872
2146,2050485959,79038318,1.0670172929999999e-11,11653,1025456,1313097328
2147,2266906709,79038318,1.0670172929999999e-11,11653,1025456,1314122784
2148,2255820375,79215877,1.0694143394999998e-11,11653,1025456,1315148240
2149,2314604458,79038318,1.0670172929999999e-11,11653,1025456,1316173696
2150,2365605708,79038318,1.0670172929999999e-11,11653,1025456,1317199152
2151,2391290541,79038316,1.067017266e-11,11590,1025456,1318224608
2152,2312411584,79215875,1.0694143124999999e-11,11611,1025456,1319250064
2153,2518769917,79038316,1.067017266e-11,11611,1025456,1320275520
2154,2251125833,79038317,1.0670172794999999e-11,11632,1025456,1321300976
2155,2419775167,79038317,1.0670172794999999e-11,11632,1025456,1322326432
2156,2300454500,79038317,1.0670172794999999e-11,11632,1025456,1323351888
2157,2251246708,79216274,1.0694196989999999e-11,24578,1025904,1324377792
2158,2243205791,79038318,1.0670172929999999e-11,11674,1025456,1325403248
2159,2215660375,79038319,1.0670173065e-11,11695,1025456,1326428704
2160,2207104416,79038319,1.0670173065e-11,11695,1025456,1327454160
2161,2141070583,79215875,1.0694143124999999e-11,11611,1025456,1328479616
2162,40825745375,194232476,2.6221384259999997e-11,11632,-221258000,1107221616
2163,2053874500,79859450,1.078102575e-11,11653,1025456,1108247072
2164,2050132500,79038318,1.0670172929999999e-11,11653,1025456,1109272528
2165,2052029250,79260246,1.070013321e-11,11653,1025456,1110297984
2166,2052388333,79038318,1.0670172929999999e-11,11653,1025456,1111323440
2167,2052459750,79038318,1.0670172929999999e-11,11674,1025456,1112348896
2168,2050752292,79038318,1.0670172929999999e-11,11674,1025456,1113374352
2169,2052490708,79038318,1.0670172929999999e-11,11674,1025456,1114399808
2170,2052897042,79260246,1.070013321e-11,11674,1025456,1115425264
2171,2050990917,79038316,1.067017266e-11,11611,1025456,1116450720
2172,2050815917,79038317,1.0670172794999999e-11,11632,1025456,1117476176
2173,2051402083,79038317,1.0670172794999999e-11,11632,1025456,1118501632
2174,2060020083,79038711,1.0670225984999999e-11,24446,1025904,1119527536
2175,2050352583,79260246,1.070013321e-11,11674,1025456,1120552992
2176,2051661375,79038318,1.0670172929999999e-11,11674,1025456,1121578448
2177,2051556584,79038318,1.0670172929999999e-11,11674,1025456,1122603904
2178,2049456250,79038318,1.0670172929999999e-11,11674,1025456,1123629360
2179,2049116458,79038318,1.0670172929999999e-11,11674,1025456,1124654816
2180,2048565125,79260246,1.070013321e-11,11674,1025456,1125680272
2181,2049288500,79038316,1.067017266e-11,11611,1025456,1126705728
2182,2226690250,79038317,1.0670172794999999e-11,11632,1025456,1127731184
2183,2362174917,79038317,1.0670172794999999e-11,11632,1025456,1128756640
2184,2750247792,79260246,1.070013321e-11,11653,1025456,1129782096
2185,2539158458,79038318,1.0670172929999999e-11,11653,1025456,1130807552
2186,2405220042,79038318,1.0670172929999999e-11,11653,1025456,1131833008
2187,2405067042,79038318,1.0670172929999999e-11,11653,1025456,1132858464
2188,2390832833,79260246,1.070013321e-11,11674,1025456,1133883920
2189,2450790500,79038318,1.0670172929999999e-11,11674,1025456,1134909376
2190,2385462458,79038318,1.0670172929999999e-11,11674,1025456,1135934832
2191,2330992250,79038706,1.067022531e-11,24272,1025904,1136960736
2192,2319992042,79260245,1.0700133075e-11,11632,1025456,1137986192
2193,2239186125,79038318,1.0670172929999999e-11,11653,1025456,1139011648
2194,2222054500,79038318,1.0670172929999999e-11,11653,1025456,1140037104
2195,2269534375,79038318,1.0670172929999999e-11,11674,1025456,1141062560
2196,2077251375,79282438,1.0703129129999998e-11,11674,1025456,1142088016
2197,2056018875,79038318,1.0670172929999999e-11,11674,1025456,1143113472
2198,2093169792,79038318,1.0670172929999999e-11,11674,1025456,1144138928
2199,2062136250,79038318,1.0670172929999999e-11,11674,1025456,1145164384
2200,2123945709,79038318,1.0670172929999999e-11,11674,1025456,1146189840
2201,2061908834,79260241,1.0700132534999999e-11,11485,1025456,1147215296
2202,2115668834,79038314,1.0670172389999998e-11,11527,1025456,1148240752
2203,2054895084,79038314,1.0670172389999998e-11,11527,1025456,1149266208
2204,2102303417,79038315,1.0670172524999999e-11,11569,1025456,1150291664
2205,2057331416,79038315,1.0670172524999999e-11,11569,1025456,1151317120
2206,2171359583,79260243,1.0700132805e-11,11569,1025456,1152342576
2207,2300105208,79038315,1.0670172524999999e-11,11569,1025456,1153368032
2208,2277266958,79038701,1.0670224635e-11,24119,1025904,1154393936
2209,2299684083,79038318,1.0670172929999999e-11,11653,1025456,1155419392
2210,2165669125,79260246,1.070013321e-11,11653,1025456,1156444848
2211,2612824125,79038315,1.0670172524999999e-11,11569,1025456,1157470304
2212,2303310666,79038316,1.067017266e-11,11590,1025456,1158495760
2213,2397778458,79038316,1.067017266e-11,11611,1025456,1159521216
2214,3082143250,79260244,1.0700132939999999e-11,11611,1025456,1160546672
2215,2182850875,79038316,1.067017266e-11,11611,1025456,1161572128
2216,2335753375,79038317,1.0670172794999999e-11,11632,1025456,1162597584
2217,2449769750,79260245,1.0700133075e-11,11632,1025456,1163623040
2218,2377142000,79038317,1.0670172794999999e-11,11632,1025456,1164648496
2219,2274617084,79038317,1.0670172794999999e-11,11632,1025456,1165673952
2220,2195025583,79038317,1.0670172794999999e-11,11632,1025456,1166699408
2221,2056476208,79038315,1.0670172524999999e-11,11569,1025456,1167724864
2222,2070107291,79260244,1.0700132939999999e-11,11590,1025456,1168750320
2223,2055715417,79038316,1.067017266e-11,11590,1025456,1169775776
2224,2074201750,79038316,1.067017266e-11,11611,1025456,1170801232
2225,2066152250,79038698,1.067022423e-11,24029,1025904,1171827136
2226,2051566709,79038318,1.0670172929999999e-11,11653,1025456,1172852592
2227,2058538125,79260246,1.070013321e-11,11653,1025456,1173878048
2228,2072163458,79038318,1.0670172929999999e-11,11653,1025456,1174903504
2229,2053174792,79038318,1.0670172929999999e-11,11653,1025456,1175928960
2230,2061468458,79038318,1.0670172929999999e-11,11653,1025456,1176954416
2231,2053499750,79260244,1.0700132939999999e-11,11590,1025456,1177979872
2232,2054269875,79038316,1.067017266e-11,11611,1025456,1179005328
2233,2053713083,79038317,1.0670172794999999e-11,11632,1025456,1180030784
2234,2323158459,79038317,1.0670172794999999e-11,11632,1025456,1181056240
2235,2130768209,79038317,1.0670172794999999e-11,11632,1025456,1182081696
2236,2399806500,79260245,1.0700133075e-11,11632,1025456,1183107152
2237,2247444792,79038318,1.0670172929999999e-11,11653,1025456,1184132608
2238,2143624583,79038318,1.0670172929999999e-11,11653,1025456,1185158064
2239,2217866042,79038318,1.0670172929999999e-11,11653,1025456,1186183520
2240,2384890625,79260246,1.070013321e-11,11653,1025456,1187208976
2241,2568863000,79038316,1.067017266e-11,11590,1025456,1188234432
2242,2303260167,79038694,1.0670223689999999e-11,23876,1025904,1189260336
2243,2364932583,79038317,1.0670172794999999e-11,11632,1025456,1190285792
2244,2392036459,79260245,1.0700133075e-11,11632,1025456,1191311248
2245,2302838208,79038318,1.0670172929999999e-11,11653,1025456,1192336704
2246,2261754875,79038318,1.0670172929999999e-11,11653,1025456,1193362160
2247,2254773875,79038318,1.0670172929999999e-11,11653,1025456,1194387616
2248,2328470542,79260246,1.070013321e-11,11653,1025456,1195413072
2249,2053795000,79038318,1.0670172929999999e-11,11653,1025456,1196438528
2250,2070286041,79038318,1.0670172929999999e-11,11653,1025456,1197463984
2251,2052048292,79038316,1.067017266e-11,11590,1025456,1198489440
2252,2050197458,79038316,1.067017266e-11,11611,1025456,1199514896
2253,2050354708,79260244,1.0700132939999999e-11,11611,1025456,1200540352
2254,2054630166,79038317,1.0670172794999999e-11,11632,1025456,1201565808
2255,2050538166,79038317,1.0670172794999999e-11,11632,1025456,1202591264
2256,2051239083,79038317,1.0670172794999999e-11,11632,1025456,1203616720
2257,2051422958,79260245,1.0700133075e-11,11632,1025456,1204642176
2258,2049980083,79038318,1.0670172929999999e-11,11653,1025456,1205667632
2259,2050436542,79038692,1.067022342e-11,23807,1025904,1206693536
2260,2049111958,79038320,1.0670173199999999e-11,11716,1025456,1207718992
2261,2049641917,79038317,1.0670172794999999e-11,11632,1025456,1208744448
2262,2176145791,79260246,1.070013321e-11,11653,1025456,1209769904
2263,2623715417,79038318,1.0670172929999999e-11,11674,1025456,1210795360
2264,2513699583,79038318,1.0670172929999999e-11,11674,1025456,1211820816
2265,2257940750,79038318,1.0670172929999999e-11,11674,1025456,1212846272
2266,2232615125,79260247,1.0700133344999999e-11,11695,1025456,1213871728
2267,2589766583,79038319,1.0670173065e-11,11695,1025456,1214897184
2268,2595723417,79038319,1.0670173065e-11,11695,1025456,1215922640
2269,2325487125,79038319,1.0670173065e-11,11695,1025456,1216948096
2270,2432894625,79260247,1.0700133344999999e-11,11695,1025456,1217973552
2271,2493580334,79038317,1.0670172794999999e-11,11632,1025456,1218999008
2272,3722872583,79038318,1.0670172929999999e-11,11653,1025456,1220024464
2273,2501472500,79260246,1.070013321e-11,11653,1025456,1221049920
2274,2244940208,79038318,1.0670172929999999e-11,11674,1025456,1222075376
2275,2136815833,79038318,1.0670172929999999e-11,11674,1025456,1223100832
2276,2065992500,79038688,1.0670222879999999e-11,23696,1025904,1224126736
2277,2072202875,79260262,1.0700135369999999e-11,12179,1025456,1225152192
2278,2064528000,79038334,1.067017509e-11,12179,1025456,1226177648
2279,2052861167,79038334,1.067017509e-11,12179,1025456,1227203104
2280,2069385625,79038334,1.067017509e-11,12200,1025456,1228228560
2281,2068804125,79038332,1.0670174819999999e-11,12116,1025456,1229254016
2282,2048450416,79260261,1.0700135234999999e-11,12137,1025456,1230279472
2283,2049519417,79038333,1.0670174955e-11,12158,1025456,1231304928
2284,2050135291,79038333,1.0670174955e-11,12158,1025456,1232330384
2285,2089002125,79038333,1.0670174955e-11,12158,1025456,1233355840
2286,2420687500,79038333,1.0670174955e-11,12158,1025456,1234381296
2287,2420807292,79260262,1.0700135369999999e-11,12179,1025456,1235406752
2288,2248810833,79038334,1.067017509e-11,12179,1025456,1236432208
2289,2309663375,79038334,1.067017509e-11,12179,1025456,1237457664
2290,2138455958,79038334,1.067017509e-11,12179,1025456,1238483120
2291,2306604958,79260260,1.07001351e-11,12116,1025456,1239508576
2292,2431847834,79038333,1.0670174955e-11,12137,1025456,1240534032
2293,2620498208,79039565,1.0670341275e-11,52203,1026708,1241560740
2294,2479248584,79038334,1.067017509e-11,12192,1025456,1242586196
2295,2725877000,79260263,1.0700135505e-11,12213,1025456,1243611652
2296,3799374375,79038335,1.0670175224999999e-11,12213,1025456,1244637108
2297,2344024292,79038335,1.0670175224999999e-11,12213,1025456,1245662564
2298,2247204750,79260263,1.0700135505e-11,12213,1025456,1246688020
2299,2051412875,79038335,1.0670175224999999e-11,12213,1025456,1247713476
2300,2049482625,79038335,1.0670175224999999e-11,12213,1025456,1248738932
2301,2063972875,79038329,1.0670174414999999e-11,12003,1025456,1249764388
2302,2058667166,79038330,1.067017455e-11,12045,1025456,1250789844
2303,2099910125,79260258,1.0700134829999999e-11,12045,1025456,1251815300
2304,2057862208,79038331,1.0670174685e-11,12087,1025456,1252840756
2305,2095168958,79038331,1.0670174685e-11,12087,1025456,1253866212
2306,2055920542,79038331,1.0670174685e-11,12087,1025456,1254891668
2307,2094606792,79038331,1.0670174685e-11,12087,1025456,1255917124
2308,2059328292,79260260,1.07001351e-11,12129,1025456,1256942580
2309,2096986375,79038332,1.0670174819999999e-11,12129,1025456,1257968036
2310,2057746959,79038763,1.0670233004999999e-11,26131,1025904,1258993940
2311,2093981041,79038331,1.0670174685e-11,12087,1025456,1260019396
2312,2053474208,79038332,1.0670174819999999e-11,12108,1025456,1261044852
2313,2088753959,79260260,1.07001351e-11,12129,1025456,1262070308
2314,2059613833,79038332,1.0670174819999999e-11,12129,1025456,1263095764
2315,2096109500,79038332,1.0670174819999999e-11,12129,1025456,1264121220
2316,2059413458,79038333,1.0670174955e-11,12150,1025456,1265146676
2317,2098172959,79260261,1.0700135234999999e-11,12150,1025456,1266172132
2318,2058133792,79038333,1.0670174955e-11,12150,1025456,1267197588
2319,2126220375,79038333,1.0670174955e-11,12150,1025456,1268223044
2320,2313578292,79038333,1.0670174955e-11,12150,1025456,1269248500
2321,2413633667,79260259,1.0700134964999999e-11,12087,1025456,1270273956
2322,2318139125,79038332,1.0670174819999999e-11,12108,1025456,1271299412
2323,2364890125,79038332,1.0670174819999999e-11,12108,1025456,1272324868
2324,2357988917,79038332,1.0670174819999999e-11,12129,1025456,1273350324
2325,2530942500,79260260,1.07001351e-11,12129,1025456,1274375780
2326,2494230000,79038332,1.0670174819999999e-11,12129,1025456,1275401236
2327,2359330834,79038759,1.0670232464999998e-11,25999,1025904,1276427140
2328,2319851125,79038333,1.0670174955e-11,12171,1025456,1277452596
2329,2606151125,79260262,1.0700135369999999e-11,12192,1025456,1278478052
2330,2225502459,79038334,1.067017509e-11,12192,1025456,1279503508
2331,2408404875,79038332,1.0670174819999999e-11,12108,1025456,1280528964
2332,2670413459,79038332,1.0670174819999999e-11,12129,1025456,1281554420
2333,2101354041,79260261,1.0700135234999999e-11,12150,1025456,1282579876
2334,2070561708,79038333,1.0670174955e-11,12150,1025456,1283605332
2335,2072456833,79038333,1.0670174955e-11,12150,1025456,1284630788
2336,2053697000,79038333,1.0670174955e-11,12150,1025456,1285656244
2337,2074772166,79038333,1.0670174955e-11,12171,1025456,1286681700
2338,2059654834,79260261,1.0700135234999999e-11,12171,1025456,1287707156
2339,2071971916,79038333,1.0670174955e-11,12171,1025456,1288732612
2340,2077127458,79038333,1.0670174955e-11,12171,1025456,1289758068
2341,2069125125,79038332,1.0670174819999999e-11,12108,1025456,1290783524
2342,2062928083,79038332,1.0670174819999999e-11,12129,1025456,1291808980
2343,2156632250,79260260,1.07001351e-11,12129,1025456,1292834436
2344,2703096083,79038755,1.0670231925e-11,25867,1025904,1293860340
2345,2247150667,79038334,1.067017509e-11,12192,1025456,1294885796
2346,2406845958,79038334,1.067017509e-11,12192,1025456,1295911252
2347,2233610166,79260262,1.0700135369999999e-11,12192,1025456,1296936708
2348,2501677333,79038334,1.067017509e-11,12192,1025456,1297962164
2349,2478813916,79038334,1.067017509e-11,12192,1025456,1298987620
2350,2541578958,79038334,1.067017509e-11,12192,1025456,1300013076
2351,2274049917,79260260,1.07001351e-11,12129,1025456,1301038532
2352,2228389125,79038333,1.0670174955e-11,12150,1025456,1302063988
2353,2388733500,79038333,1.0670174955e-11,12150,1025456,1303089444
2354,2300138084,79038333,1.0670174955e-11,12171,1025456,1304114900
2355,2214745250,79038333,1.0670174955e-11,12171,1025456,1305140356
2356,2231646416,79038333,1.0670174955e-11,12171,1025456,1306165812
2357,2172310084,79038333,1.0670174955e-11,12171,1025456,1307191268
2358,2051998042,79038334,1.067017509e-11,12192,1025456,1308216724
2359,2052880792,79260262,1.0700135369999999e-11,12192,1025456,1309242180
2360,2051526584,79038334,1.067017509e-11,12192,1025456,1310267636
2361,2052661291,79038750,1.0670231249999998e-11,25714,1025904,1311293540
2362,2051275792,79038333,1.0670174955e-11,12150,1025456,1312318996
2363,2052591750,79038333,1.0670174955e-11,12171,1025456,1313344452
2364,2052156500,79260261,1.0700135234999999e-11,12171,1025456,1314369908
2365,2051216958,79038334,1.067017509e-11,12192,1025456,1315395364
2366,2050910750,79038334,1.067017509e-11,12192,1025456,1316420820
2367,2051974209,79038334,1.067017509e-11,12192,1025456,1317446276
2368,2052039083,79038334,1.067017509e-11,12192,1025456,1318471732
2369,2052526459,79260262,1.0700135369999999e-11,12192,1025456,1319497188
2370,2052408584,79038334,1.067017509e-11,12192,1025456,1320522644
2371,2052851500,79038332,1.0670174819999999e-11,12129,1025456,1321548100
2372,2051208042,79038333,1.0670174955e-11,12150,1025456,1322573556
2373,2052005792,79038333,1.0670174955e-11,12150,1025456,1323599012
2374,2051667416,79260261,1.0700135234999999e-11,12171,1025456,1324624468
2375,2051876209,79038333,1.0670174955e-11,12171,1025456,1325649924
2376,2050077375,79038333,1.0670174955e-11,12171,1025456,1326675380
2377,2052570583,79038333,1.0670174955e-11,12171,1025456,1327700836
2378,2109041375,79260676,1.070019126e-11,25645,1025904,1328726740
2379,2320276375,79038335,1.0670175224999999e-11,12213,1025456,1329752196
2380,2356700125,79038335,1.0670175224999999e-11,12213,1025456,1330777652
2381,2330772166,79038332,1.0670174819999999e-11,12129,1025456,1331803108
2382,2168150834,79260261,1.0700135234999999e-11,12150,1025456,1332828564
2383,2307968292,79038333,1.0670174955e-11,12171,1025456,1333854020
2384,2270000208,79038333,1.0670174955e-11,12171,1025456,1334879476
2385,2424838917,79038333,1.0670174955e-11,12171,1025456,1335904932
2386,2543890292,79260262,1.0700135369999999e-11,12192,1025456,1336930388
2387,2437691292,79038334,1.067017509e-11,12192,1025456,1337955844
2388,2417188708,79038334,1.067017509e-11,12192,1025456,1338981300
2389,2260175250,79038334,1.067017509e-11,12192,1025456,1340006756
2390,2277768917,79038334,1.067017509e-11,12192,1025456,1341032212
2391,2181630041,79260260,1.07001351e-11,12129,1025456,1342057668
2392,2287288041,79038333,1.0670174955e-11,12150,1025456,1343083124
2393,2065999250,79038333,1.0670174955e-11,12150,1025456,1344108580
2394,2132249709,79038333,1.0670174955e-11,12171,1025456,1345134036
2395,2069928917,79260672,1.0700190719999999e-11,25513,1025904,1346159940
2396,2115922333,79038335,1.0670175224999999e-11,12213,1025456,1347185396
2397,2053421250,79038335,1.0670175224999999e-11,12213,1025456,1348210852
2398,2149339750,79038335,1.0670175224999999e-11,12213,1025456,1349236308
2399,2067533042,79038335,1.0670175224999999e-11,12213,1025456,1350261764
2400,2052019708,79260263,1.0700135505e-11,12213,1025456,1351287220
2401,2063787542,79038329,1.0670174414999999e-11,12003,1025456,1352312676
2402,2199180250,79038330,1.067017455e-11,12045,1025456,1353338132
2403,2269077000,79038331,1.0670174685e-11,12087,1025456,1354363588
2404,2285606959,79260259,1.0700134964999999e-11,12087,1025456,1355389044
2405,2349965375,79038331,1.0670174685e-11,12087,1025456,1356414500
2406,2443520208,79038331,1.0670174685e-11,12087,1025456,1357439956
2407,2221981583,79038332,1.0670174819999999e-11,12129,1025456,1358465412
2408,2792637208,79260260,1.07001351e-11,12129,1025456,1359490868
2409,2278366208,79038332,1.0670174819999999e-11,12129,1025456,1360516324
2410,2363742250,79038332,1.0670174819999999e-11,12129,1025456,1361541780
2411,2237972250,79038330,1.067017455e-11,12066,1025456,1362567236
2412,2481026292,79260665,1.0700189774999998e-11,25276,1025904,1363593140
2413,2280110458,79038332,1.0670174819999999e-11,12129,1025456,1364618596
2414,2200358084,79038332,1.0670174819999999e-11,12129,1025456,1365644052
2415,2227800542,79038333,1.0670174955e-11,12150,1025456,1366669508
2416,2240625250,79260261,1.0700135234999999e-11,12150,1025456,1367694964
2417,2053263000,79038333,1.0670174955e-11,12150,1025456,1368720420
2418,2050898833,79038333,1.0670174955e-11,12150,1025456,1369745876
2419,2051503833,79038333,1.0670174955e-11,12150,1025456,1370771332
2420,2066333625,79038333,1.0670174955e-11,12150,1025456,1371796788
2421,2077375250,79260259,1.0700134964999999e-11,12087,1025456,1372822244
2422,2049178958,79038332,1.0670174819999999e-11,12108,1025456,1373847700
2423,2064721542,79038332,1.0670174819999999e-11,12108,1025456,1374873156
2424,2054232791,79038332,1.0670174819999999e-11,12129,1025456,1375898612
2425,2055424584,79038332,1.0670174819999999e-11,12129,1025456,1376924068
2426,2050981625,79260260,1.07001351e-11,12129,1025456,1377949524
2427,2052244417,79038332,1.0670174819999999e-11,12129,1025456,1378974980
2428,2051697000,79038333,1.0670174955e-11,12150,1025456,1380000436
2429,2063205583,79038735,1.0670229225e-11,25228,1025904,1381026340
2430,2891468042,79260262,1.0700135369999999e-11,12192,1025456,1382051796
2431,2429588875,79038332,1.0670174819999999e-11,12108,1025456,1383077252
2432,2290498334,79038332,1.0670174819999999e-11,12129,1025456,1384102708
2433,2212283084,79038333,1.0670174955e-11,12150,1025456,1385128164
2434,2453648166,79260261,1.0700135234999999e-11,12150,1025456,1386153620
2435,2538063375,79038333,1.0670174955e-11,12150,1025456,1387179076
2436,2584760458,79038333,1.0670174955e-11,12171,1025456,1388204532
2437,61658912916,80503055,1.0867912425e-11,12171,1025456,1389229988
2438,2061706834,79038333,1.0670174955e-11,12171,1025456,1390255444
2439,2056577542,79038333,1.0670174955e-11,12171,1025456,1391280900
2440,2054063167,79038333,1.0670174955e-11,12171,1025456,1392306356
2441,2052195834,79038332,1.0670174819999999e-11,12108,1025456,1393331812
2442,2057650542,79260260,1.07001351e-11,12129,1025456,1394357268
2443,2073753125,79038332,1.0670174819999999e-11,12129,1025456,1395382724
2444,2055922125,79038333,1.0670174955e-11,12150,1025456,1396408180
2445,2050265584,79038333,1.0670174955e-11,12150,1025456,1397433636
2446,2051873791,79038731,1.0670228684999999e-11,25096,1025904,1398459540
2447,2054082500,79260261,1.0700135234999999e-11,12171,1025456,1399484996
2448,2048908667,79038333,1.0670174955e-11,12171,1025456,1400510452
2449,2053159375,79038333,1.0670174955e-11,12171,1025456,1401535908
2450,2554215083,79038334,1.067017509e-11,12192,1025456,1402561364
2451,2405391875,79260260,1.07001351e-11,12108,1025456,1403586820
2452,2143526167,79038332,1.0670174819999999e-11,12129,1025456,1404612276
2453,2358889125,79038333,1.0670174955e-11,12150,1025456,1405637732
2454,2383488917,79038333,1.0670174955e-11,12150,1025456,1406663188
2455,3587678125,79260261,1.0700135234999999e-11,12150,1025456,1407688644
2456,2711290792,79038333,1.0670174955e-11,12150,1025456,1408714100
2457,2466556375,79038333,1.0670174955e-11,12171,1025456,1409739556
2458,2375541625,79038333,1.0670174955e-11,12171,1025456,1410765012
2459,2522844041,79260261,1.0700135234999999e-11,12171,1025456,1411790468
2460,2263412917,79038333,1.0670174955e-11,12171,1025456,1412815924
2461,2280080667,79038332,1.0670174819999999e-11,12108,1025456,1413841380
2462,2207867542,79038332,1.0670174819999999e-11,12129,1025456,1414866836
2463,2053275291,79282847,1.0703184344999999e-11,24943,1025904,1415892740
2464,2050603916,79038333,1.0670174955e-11,12171,1025456,1416918196
2465,2052397083,79038334,1.067017509e-11,12192,1025456,1417943652
2466,2052187167,79038334,1.067017509e-11,12192,1025456,1418969108
2467,2056481791,79038334,1.067017509e-11,12192,1025456,1419994564
2468,2049969416,79260262,1.0700135369999999e-11,12192,1025456,1421020020
2469,2052143541,79038334,1.067017509e-11,12192,1025456,1422045476
2470,2051128959,79038334,1.067017509e-11,12192,1025456,1423070932
2471,2048742291,79038332,1.0670174819999999e-11,12129,1025456,1424096388
2472,2074992584,79038333,1.0670174955e-11,12150,1025456,1425121844
2473,2060370000,79260261,1.0700135234999999e-11,12150,1025456,1426147300
2474,2094311291,79038333,1.0670174955e-11,12171,1025456,1427172756
2475,2058680083,79038333,1.0670174955e-11,12171,1025456,1428198212
2476,2175837125,79038333,1.0670174955e-11,12171,1025456,1429223668
2477,2532130500,79260261,1.0700135234999999e-11,12171,1025456,1430249124
2478,2368394000,79038334,1.067017509e-11,12192,1025456,1431274580
2479,2262366334,79038334,1.067017509e-11,12192,1025456,1432300036
2480,2443481625,79038725,1.0670227874999999e-11,24874,1025904,1433325940
2481,2282373417,79260260,1.07001351e-11,12129,1025456,1434351396
2482,2731139334,79038333,1.0670174955e-11,12150,1025456,1435376852
2483,2242697792,79038333,1.0670174955e-11,12171,1025456,1436402308
2484,2616821041,79038333,1.0670174955e-11,12171,1025456,1437427764
2485,2407093417,79260261,1.0700135234999999e-11,12171,1025456,1438453220
2486,2366502291,79038334,1.067017509e-11,12192,1025456,1439478676
2487,2324347458,79038334,1.067017509e-11,12192,1025456,1440504132
2488,2236253708,79038334,1.067017509e-11,12192,1025456,1441529588
2489,2734800333,79260262,1.0700135369999999e-11,12192,1025456,1442555044
2490,2243312959,79038334,1.067017509e-11,12192,1025456,1443580500
2491,2072452792,79038332,1.0670174819999999e-11,12129,1025456,1444605956
2492,2072056333,79038333,1.0670174955e-11,12150,1025456,1445631412
2493,2064149584,79260261,1.0700135234999999e-11,12150,1025456,1446656868
2494,2069768416,79038333,1.0670174955e-11,12171,1025456,1447682324
2495,2054012709,79038333,1.0670174955e-11,12171,1025456,1448707780
2496,2056749750,79038333,1.0670174955e-11,12171,1025456,1449733236
2497,2070793875,79038720,1.0670227199999999e-11,24721,1025904,1450759140
2498,2067292500,79260262,1.0700135369999999e-11,12192,1025456,1451784596
2499,2063669958,79038335,1.0670175224999999e-11,12213,1025456,1452810052
2500,2098052084,79038335,1.0670175224999999e-11,12213,1025456,1453835508
2501,2720734917,79038329,1.0670174414999999e-11,12003,1025456,1454860964
2502,2642428875,79260258,1.0700134829999999e-11,12045,1025456,1455886420
2503,2396329250,79038331,1.0670174685e-11,12087,1025456,1456911876
2504,2493478833,79038331,1.0670174685e-11,12087,1025456,1457937332
2505,2341821042,79038331,1.0670174685e-11,12087,1025456,1458962788
2506,2382371958,79260259,1.0700134964999999e-11,12087,1025456,1459988244
2507,2317052292,79038332,1.0670174819999999e-11,12129,1025456,1461013700
2508,2370780166,79038332,1.0670174819999999e-11,12129,1025456,1462039156
2509,2515242917,79038332,1.0670174819999999e-11,12129,1025456,1463064612
2510,2516067542,79260260,1.07001351e-11,12129,1025456,1464090068
2511,2190520292,79038330,1.067017455e-11,12066,1025456,1465115524
2512,2213201375,79038331,1.0670174685e-11,12087,1025456,1466140980
2513,2410750917,79038331,1.0670174685e-11,12087,1025456,1467166436
2514,2184805250,79038713,1.0670226254999998e-11,24505,1025904,1468192340
2515,2056325084,79282453,1.0703131154999999e-11,12150,1025456,1469217796
2516,2051701000,79038333,1.0670174955e-11,12150,1025456,1470243252
2517,2056305000,79038333,1.0670174955e-11,12150,1025456,1471268708
2518,2052122209,79038333,1.0670174955e-11,12150,1025456,1472294164
2519,2051901167,79038333,1.0670174955e-11,12150,1025456,1473319620
2520,2050820500,79038333,1.0670174955e-11,12150,1025456,1474345076
2521,2050513583,79038331,1.0670174685e-11,12087,1025456,1475370532
2522,2051579417,79038332,1.0670174819999999e-11,12108,1025456,1476395988
2523,2052185875,79038332,1.0670174819999999e-11,12108,1025456,1477421444
2524,2053050875,79260260,1.07001351e-11,12129,1025456,1478446900
2525,2061557166,79038332,1.0670174819999999e-11,12129,1025456,1479472356
2526,2095453417,79038332,1.0670174819999999e-11,12129,1025456,1480497812
2527,2049388750,79038332,1.0670174819999999e-11,12129,1025456,1481523268
2528,2104408083,79038333,1.0670174955e-11,12150,1025456,1482548724
2529,2052516958,79260261,1.0700135234999999e-11,12150,1025456,1483574180
2530,2107052292,79038333,1.0670174955e-11,12150,1025456,1484599636
2531,3957183959,79038708,1.067022558e-11,24352,1025904,1485625540
2532,2591275625,79260260,1.07001351e-11,12129,1025456,1486650996
2533,2133404833,79038333,1.0670174955e-11,12150,1025456,1487676452
2534,2439198666,79038333,1.0670174955e-11,12150,1025456,1488701908
2535,2258359708,79038333,1.0670174955e-11,12171,1025456,1489727364
2536,2468672125,79038333,1.0670174955e-11,12171,1025456,1490752820
2537,2466060250,79038333,1.0670174955e-11,12171,1025456,1491778276
2538,2339431625,79038333,1.0670174955e-11,12171,1025456,1492803732
2539,2240549666,79038333,1.0670174955e-11,12171,1025456,1493829188
2540,2204089208,79260261,1.0700135234999999e-11,12171,1025456,1494854644
2541,2289231250,79038332,1.0670174819999999e-11,12108,1025456,1495880100
2542,2215470750,79038332,1.0670174819999999e-11,12129,1025456,1496905556
2543,2291088500,79038332,1.0670174819999999e-11,12129,1025456,1497931012
2544,2050079209,79038333,1.0670174955e-11,12150,1025456,1498956468
2545,2062405166,79260261,1.0700135234999999e-11,12150,1025456,1499981924
2546,2114020667,79038333,1.0670174955e-11,12150,1025456,1501007380
2547,2083431750,79038333,1.0670174955e-11,12150,1025456,1502032836
2548,2106145708,79038707,1.0670225444999998e-11,24304,1025904,1503058740
2549,2059480167,79038334,1.067017509e-11,12192,1025456,1504084196
2550,2098997125,79260262,1.0700135369999999e-11,12192,1025456,1505109652
2551,2060752375,79038332,1.0670174819999999e-11,12108,1025456,1506135108
2552,2089264833,79038332,1.0670174819999999e-11,12129,1025456,1507160564
2553,2061625583,79038333,1.0670174955e-11,12150,1025456,1508186020
2554,2097715375,79260261,1.0700135234999999e-11,12150,1025456,1509211476
2555,2058780791,79038333,1.0670174955e-11,12150,1025456,1510236932
2556,2103317583,79038333,1.0670174955e-11,12171,1025456,1511262388
2557,2062492416,79038333,1.0670174955e-11,12171,1025456,1512287844
2558,2090108334,79038333,1.0670174955e-11,12171,1025456,1513313300
2559,2047667458,79260261,1.0700135234999999e-11,12171,1025456,1514338756
2560,2074058250,79038333,1.0670174955e-11,12171,1025456,1515364212
2561,2058025167,79038332,1.0670174819999999e-11,12108,1025456,1516389668
2562,2104982250,79038332,1.0670174819999999e-11,12129,1025456,1517415124
2563,2043125458,79038332,1.0670174819999999e-11,12129,1025456,1518440580
2564,2172064458,79260261,1.0700135234999999e-11,12150,1025456,1519466036
2565,2596638208,79038703,1.0670224904999999e-11,24172,1025904,1520491940
2566,2295337417,79038349,1.0670177114999999e-11,12655,1025456,1521517396
2567,2234978542,79038349,1.0670177114999999e-11,12655,1025456,1522542852
2568,2623083750,79038349,1.0670177114999999e-11,12655,1025456,1523568308
2569,2394430750,79038349,1.0670177114999999e-11,12655,1025456,1524593764
2570,2674891833,79038349,1.0670177114999999e-11,12655,1025456,1525619220
2571,2298535750,79260274,1.070013699e-11,12592,1025456,1526644676
2572,2284050375,79038347,1.0670176845e-11,12613,1025456,1527670132
2573,2323584500,79038348,1.067017698e-11,12634,1025456,1528695588
2574,2188678208,79038348,1.067017698e-11,12634,1025456,1529721044
2575,2336545292,79260276,1.0700137259999999e-11,12634,1025456,1530746500
2576,2534861083,79038348,1.067017698e-11,12634,1025456,1531771956
2577,3402911875,79038349,1.0670177114999999e-11,12655,1025456,1532797412
2578,2131640625,79038349,1.0670177114999999e-11,12655,1025456,1533822868
2579,2089165667,79260277,1.0700137395e-11,12655,1025456,1534848324
2580,2098685709,79038349,1.0670177114999999e-11,12655,1025456,1535873780
2581,2063599084,79038346,1.0670176709999999e-11,12592,1025456,1536899236
2582,2085578750,79039575,1.0670342625e-11,52526,1026708,1537925944
2583,2059477208,79038335,1.0670175224999999e-11,12213,1025456,1538951400
2584,2110744333,79260263,1.0700135505e-11,12213,1025456,1539976856
2585,2048507000,79038336,1.0670175359999998e-11,12234,1025456,1541002312
2586,2407999042,79038336,1.0670175359999998e-11,12234,1025456,1542027768
2587,2241392583,79038336,1.0670175359999998e-11,12234,1025456,1543053224
2588,2725301833,79260264,1.0700135639999999e-11,12234,1025456,1544078680
2589,2395816959,79038336,1.0670175359999998e-11,12234,1025456,1545104136
2590,2416659875,79038336,1.0670175359999998e-11,12234,1025456,1546129592
2591,2340406042,79038333,1.0670174955e-11,12171,1025456,1547155048
2592,2476612583,79260262,1.0700135369999999e-11,12192,1025456,1548180504
2593,2490675375,79038334,1.067017509e-11,12192,1025456,1549205960
2594,2216179875,79038335,1.0670175224999999e-11,12213,1025456,1550231416
2595,2287386625,79038335,1.0670175224999999e-11,12213,1025456,1551256872
2596,2619079125,79260263,1.0700135505e-11,12213,1025456,1552282328
2597,2230597083,79038335,1.0670175224999999e-11,12213,1025456,1553307784
2598,2249656959,79038336,1.0670175359999998e-11,12234,1025456,1554333240
2599,3474341458,79038766,1.0670233409999999e-11,26236,1025904,1555359144
2600,2175694084,79260264,1.0700135639999999e-11,12255,1025456,1556384600
2601,2052146042,79038329,1.0670174414999999e-11,12024,1025456,1557410056
2602,2048513750,79038330,1.067017455e-11,12066,1025456,1558435512
2603,2069004792,79038332,1.0670174819999999e-11,12108,1025456,1559460968
2604,2052715833,79260260,1.07001351e-11,12108,1025456,1560486424
2605,2114091959,79038332,1.0670174819999999e-11,12108,1025456,1561511880
2606,2051829750,79038333,1.0670174955e-11,12150,1025456,1562537336
2607,2107607166,79038333,1.0670174955e-11,12150,1025456,1563562792
2608,2052229750,79038333,1.0670174955e-11,12150,1025456,1564588248
2609,2104275667,79260261,1.0700135234999999e-11,12150,1025456,1565613704
2610,2051532959,79038333,1.0670174955e-11,12150,1025456,1566639160
2611,2116165625,79038331,1.0670174685e-11,12087,1025456,1567664616
2612,2051109125,79038332,1.0670174819999999e-11,12108,1025456,1568690072
2613,2106834917,79038332,1.0670174819999999e-11,12108,1025456,1569715528
2614,2051572500,79260260,1.07001351e-11,12129,1025456,1570740984
2615,2112531625,79038332,1.0670174819999999e-11,12129,1025456,1571766440
2616,2051516208,79038759,1.0670232464999998e-11,25999,1025904,1572792344
2617,2106161209,79038334,1.067017509e-11,12192,1025456,1573817800
2618,2049827459,79038334,1.067017509e-11,12192,1025456,1574843256
2619,2111854250,79260262,1.0700135369999999e-11,12192,1025456,1575868712
2620,2051214959,79038335,1.0670175224999999e-11,12213,1025456,1576894168
2621,2107627958,79038332,1.0670174819999999e-11,12129,1025456,1577919624
2622,2051283583,79038333,1.0670174955e-11,12150,1025456,1578945080
2623,2139770667,79260261,1.0700135234999999e-11,12171,1025456,1579970536
2624,2230246625,79038333,1.0670174955e-11,12171,1025456,1580995992
2625,2330707459,79038333,1.0670174955e-11,12171,1025456,1582021448
2626,2222064000,79038333,1.0670174955e-11,12171,1025456,1583046904
2627,2175773333,79260262,1.0700135369999999e-11,12192,1025456,1584072360
2628,2413599792,79038334,1.067017509e-11,12192,1025456,1585097816
2629,2229832500,79038334,1.067017509e-11,12192,1025456,1586123272
2630,2378391208,79038334,1.067017509e-11,12192,1025456,1587148728
2631,2398650375,79038332,1.0670174819999999e-11,12129,1025456,1588174184
2632,2752022958,79038333,1.0670174955e-11,12150,1025456,1589199640
2633,2432920083,79038756,1.0670232059999998e-11,25888,1025904,1590225544
2634,2482716542,79038334,1.067017509e-11,12192,1025456,1591251000
2635,2253648958,79260263,1.0700135505e-11,12213,1025456,1592276456
2636,2223550416,79038335,1.0670175224999999e-11,12213,1025456,1593301912
2637,2158495875,79038335,1.0670175224999999e-11,12213,1025456,1594327368
2638,2056537084,79038335,1.0670175224999999e-11,12213,1025456,1595352824
2639,2051422459,79038335,1.0670175224999999e-11,12213,1025456,1596378280
2640,2054901959,79260263,1.0700135505e-11,12213,1025456,1597403736
2641,2066335167,79038333,1.0670174955e-11,12150,1025456,1598429192
2642,2053956750,79038333,1.0670174955e-11,12171,1025456,1599454648
2643,2050724791,79038333,1.0670174955e-11,12171,1025456,1600480104
2644,2138222292,79260262,1.0700135369999999e-11,12192,1025456,1601505560
2645,2068166625,79038334,1.067017509e-11,12192,1025456,1602531016
2646,2051412917,79038334,1.067017509e-11,12192,1025456,1603556472
2647,2051813250,79038334,1.067017509e-11,12192,1025456,1604581928
2648,2114919917,79038335,1.0670175224999999e-11,12213,1025456,1605607384
2649,2051756041,79260263,1.0700135505e-11,12213,1025456,1606632840
2650,2214910041,79038753,1.0670231654999998e-11,25819,1025904,1607658744
2651,2160625708,79038333,1.0670174955e-11,12150,1025456,1608684200
2652,2684359333,79038333,1.0670174955e-11,12171,1025456,1609709656
2653,2299316917,79260262,1.0700135369999999e-11,12192,1025456,1610735112
2654,2245199084,79038334,1.067017509e-11,12192,1025456,1611760568
2655,2270620166,79038334,1.067017509e-11,12192,1025456,1612786024
2656,2713512208,79038335,1.0670175224999999e-11,12213,1025456,1613811480
2657,2323283083,79260263,1.0700135505e-11,12213,1025456,1614836936
2658,2323174500,79038335,1.0670175224999999e-11,12213,1025456,1615862392
2659,2322420750,79038335,1.0670175224999999e-11,12213,1025456,1616887848
2660,2256271792,79038335,1.0670175224999999e-11,12213,1025456,1617913304
2661,2498649667,79260261,1.0700135234999999e-11,12150,1025456,1618938760
2662,2163002792,79038333,1.0670174955e-11,12171,1025456,1619964216
2663,2187432208,79038333,1.0670174955e-11,12171,1025456,1620989672
2664,2092147667,79038334,1.067017509e-11,12192,1025456,1622015128
2665,2066685250,79038334,1.067017509e-11,12192,1025456,1623040584
2666,2052259792,79260262,1.0700135369999999e-11,12192,1025456,1624066040
2667,2063202625,79038749,1.0670231115e-11,25666,1025904,1625091944
2668,2075776833,79038335,1.0670175224999999e-11,12213,1025456,1626117400
2669,60487238625,222854571,3.0085367085e-11,12234,-259246676,1366870724
2670,2090943791,79038336,1.0670175359999998e-11,12234,1025456,1367896180
2671,2121834208,79310967,1.0706980545e-11,12150,1025456,1368921636
2672,2194450500,79038333,1.0670174955e-11,12171,1025456,1369947092
2673,2957982875,79038334,1.067017509e-11,12192,1025456,1370972548
2674,2469862875,79038334,1.067017509e-11,12192,1025456,1371998004
2675,2210352250,79310968,1.0706980679999999e-11,12192,1025456,1373023460
2676,2665471291,79038334,1.067017509e-11,12192,1025456,1374048916
2677,2531994625,79038335,1.0670175224999999e-11,12213,1025456,1375074372
2678,2498325333,79038335,1.0670175224999999e-11,12213,1025456,1376099828
2679,2585569042,79310969,1.0706980815e-11,12213,1025456,1377125284
2680,2357837958,79038335,1.0670175224999999e-11,12213,1025456,1378150740
2681,2416634083,79038333,1.0670174955e-11,12150,1025456,1379176196
2682,2397105917,79038333,1.0670174955e-11,12171,1025456,1380201652
2683,2328148667,79310967,1.0706980545e-11,12171,1025456,1381227108
2684,2190204292,79038744,1.067023044e-11,25513,1025904,1382253012
2685,2043992916,79038336,1.0670175359999998e-11,12234,1025456,1383278468
2686,2103570416,79038336,1.0670175359999998e-11,12234,1025456,1384303924
2687,2073231250,79310970,1.070698095e-11,12234,1025456,1385329380
2688,2093059417,79038336,1.0670175359999998e-11,12234,1025456,1386354836
2689,2080213917,79038336,1.0670175359999998e-11,12234,1025456,1387380292
2690,2093676792,79038336,1.0670175359999998e-11,12234,1025456,1388405748
2691,2058847625,79038333,1.0670174955e-11,12171,1025456,1389431204
2692,2120130625,79310968,1.0706980679999999e-11,12192,1025456,1390456660
2693,2057489166,79038334,1.067017509e-11,12192,1025456,1391482116
2694,2204026583,79038335,1.0670175224999999e-11,12213,1025456,1392507572
2695,2351356000,79038335,1.0670175224999999e-11,12213,1025456,1393533028
2696,2492253209,79310969,1.0706980815e-11,12213,1025456,1394558484
2697,2309524125,79038335,1.0670175224999999e-11,12213,1025456,1395583940
2698,2248552000,79038336,1.0670175359999998e-11,12234,1025456,1396609396
2699,2236569375,79038336,1.0670175359999998e-11,12234,1025456,1397634852
2700,2750776458,79038336,1.0670175359999998e-11,12234,1025456,1398660308
2701,3784119250,79038734,1.0670229089999999e-11,25192,1025904,1399686212
2702,2709528542,79038330,1.067017455e-11,12066,1025456,1400711668
2703,2197925208,79038332,1.0670174819999999e-11,12108,1025456,1401737124
2704,2272996875,79310966,1.0706980409999999e-11,12108,1025456,1402762580
2705,2329874250,79038333,1.0670174955e-11,12150,1025456,1403788036
2706,2207614333,79038333,1.0670174955e-11,12150,1025456,1404813492
2707,2136712833,79038333,1.0670174955e-11,12150,1025456,1405838948
2708,2179156917,79310967,1.0706980545e-11,12150,1025456,1406864404
2709,3352627042,79038333,1.0670174955e-11,12150,1025456,1407889860
2710,2066195959,79038333,1.0670174955e-11,12150,1025456,1408915316
2711,2065694125,79038331,1.0670174685e-11,12087,1025456,1409940772
2712,2051409292,79310966,1.0706980409999999e-11,12108,1025456,1410966228
2713,2050830000,79038332,1.0670174819999999e-11,12108,1025456,1411991684
2714,2051784791,79038332,1.0670174819999999e-11,12129,1025456,1413017140
2715,2050322542,79038333,1.0670174955e-11,12150,1025456,1414042596
2716,2051662083,79038333,1.0670174955e-11,12150,1025456,1415068052
2717,2050928833,79310967,1.0706980545e-11,12150,1025456,1416093508
2718,2051223291,79038735,1.0670229225e-11,25228,1025904,1417119412
2719,2050168625,79038335,1.0670175224999999e-11,12213,1025456,1418144868
2720,2052767292,79038335,1.0670175224999999e-11,12213,1025456,1419170324
2721,2052794042,79038332,1.0670174819999999e-11,12129,1025456,1420195780
2722,2052397500,79310967,1.0706980545e-11,12150,1025456,1421221236
2723,2073439416,79038333,1.0670174955e-11,12171,1025456,1422246692
2724,2570110250,79038333,1.0670174955e-11,12171,1025456,1423272148
2725,2253888792,79038333,1.0670174955e-11,12171,1025456,1424297604
2726,2832527625,79310968,1.0706980679999999e-11,12192,1025456,1425323060
2727,2145806625,79038334,1.067017509e-11,12192,1025456,1426348516
2728,2183242917,79038334,1.067017509e-11,12192,1025456,1427373972
2729,2648954125,79038334,1.067017509e-11,12192,1025456,1428399428
2730,2392152625,79310968,1.0706980679999999e-11,12192,1025456,1429424884
2731,2365028000,79038332,1.0670174819999999e-11,12129,1025456,1430450340
2732,2466386792,79038333,1.0670174955e-11,12150,1025456,1431475796
2733,2563517584,79038333,1.0670174955e-11,12150,1025456,1432501252
2734,2274484292,79310967,1.0706980545e-11,12171,1025456,1433526708
2735,2199265416,79038732,1.067022882e-11,25117,1025904,1434552612
2736,2158093917,79038334,1.067017509e-11,12192,1025456,1435578068
2737,3380963792,79310968,1.0706980679999999e-11,12192,1025456,1436603524
2738,2072928125,79038334,1.067017509e-11,12192,1025456,1437628980
2739,2053297834,79038334,1.067017509e-11,12192,1025456,1438654436
2740,60489935292,80537822,1.0872605969999998e-11,12192,1025456,1439679892
2741,2070869292,79310966,1.0706980409999999e-11,12129,1025456,1440705348
2742,2066210417,79038333,1.0670174955e-11,12150,1025456,1441730804
2743,2068417500,79038333,1.0670174955e-11,12171,1025456,1442756260
2744,2207279042,79038333,1.0670174955e-11,12171,1025456,1443781716
2745,2223877208,79038333,1.0670174955e-11,12171,1025456,1444807172
2746,2156718917,79310967,1.0706980545e-11,12171,1025456,1445832628
2747,2201919167,79038334,1.067017509e-11,12192,1025456,1446858084
2748,2156176916,79038334,1.067017509e-11,12192,1025456,1447883540
2749,2553047875,79038334,1.067017509e-11,12192,1025456,1448908996
2750,2279325458,79310968,1.0706980679999999e-11,12192,1025456,1449934452
2751,2254160333,79038332,1.0670174819999999e-11,12129,1025456,1450959908
2752,2348102000,79038727,1.0670228145e-11,24943,1025904,1451985812
2753,2249712166,79038334,1.067017509e-11,12192,1025456,1453011268
2754,2184755042,79310968,1.0706980679999999e-11,12192,1025456,1454036724
2755,2137219791,79038335,1.0670175224999999e-11,12213,1025456,1455062180
2756,2134598417,79038335,1.0670175224999999e-11,12213,1025456,1456087636
2757,2266923833,79038335,1.0670175224999999e-11,12213,1025456,1457113092
2758,2173862417,79038335,1.0670175224999999e-11,12213,1025456,1458138548
2759,2051978292,79338233,1.0710661455e-11,12213,1025456,1459164004
2760,2051823375,79038335,1.0670175224999999e-11,12213,1025456,1460189460
2761,2051181708,79038333,1.0670174955e-11,12150,1025456,1461214916
2762,2069693375,79038333,1.0670174955e-11,12171,1025456,1462240372
2763,2051583417,79038333,1.0670174955e-11,12171,1025456,1463265828
2764,2051978084,79310968,1.0706980679999999e-11,12192,1025456,1464291284
2765,2051481083,79038334,1.067017509e-11,12192,1025456,1465316740
2766,2056166959,79038334,1.067017509e-11,12192,1025456,1466342196
2767,2051942416,79038334,1.067017509e-11,12192,1025456,1467367652
2768,2055191166,79038335,1.0670175224999999e-11,12213,1025456,1468393108
2769,2055027167,79311359,1.0707033464999999e-11,24895,1025904,1469419012
2770,2062900541,79038336,1.0670175359999998e-11,12234,1025456,1470444468
2771,2091196167,79038333,1.0670174955e-11,12150,1025456,1471469924
2772,2049838333,79038333,1.0670174955e-11,12171,1025456,1472495380
2773,2074164834,79038334,1.067017509e-11,12192,1025456,1473520836
2774,2074157959,79310968,1.0706980679999999e-11,12192,1025456,1474546292
2775,2265485167,79038334,1.067017509e-11,12192,1025456,1475571748
2776,2545810625,79038335,1.0670175224999999e-11,12213,1025456,1476597204
2777,2424845792,79310969,1.0706980815e-11,12213,1025456,1477622660
2778,2222060208,79038335,1.0670175224999999e-11,12213,1025456,1478648116
2779,2707019125,79038335,1.0670175224999999e-11,12213,1025456,1479673572
2780,2482502125,79038335,1.0670175224999999e-11,12213,1025456,1480699028
2781,2588532208,79310967,1.0706980545e-11,12150,1025456,1481724484
2782,2512589250,79038333,1.0670174955e-11,12171,1025456,1482749940
2783,2340959333,79038333,1.0670174955e-11,12171,1025456,1483775396
2784,2591678917,79038334,1.067017509e-11,12192,1025456,1484800852
2785,2245909375,79310968,1.0706980679999999e-11,12192,1025456,1485826308
2786,2239319417,79038720,1.0670227199999999e-11,24742,1025904,1486852212
2787,2156951250,79038335,1.0670175224999999e-11,12213,1025456,1487877668
2788,2182717083,79038335,1.0670175224999999e-11,12213,1025456,1488903124
2789,2051647416,79310969,1.0706980815e-11,12213,1025456,1489928580
2790,2052378583,79038336,1.0670175359999998e-11,12234,1025456,1490954036
2791,2081101375,79038333,1.0670174955e-11,12150,1025456,1491979492
2792,2055396417,79038333,1.0670174955e-11,12171,1025456,1493004948
2793,2125485417,79038334,1.067017509e-11,12192,1025456,1494030404
2794,2073587250,79310968,1.0706980679999999e-11,12192,1025456,1495055860
2795,2098512250,79038334,1.067017509e-11,12192,1025456,1496081316
2796,2070683458,79038334,1.067017509e-11,12192,1025456,1497106772
2797,2085013833,79038335,1.0670175224999999e-11,12213,1025456,1498132228
2798,2059804791,79038335,1.0670175224999999e-11,12213,1025456,1499157684
2799,2091163625,79310969,1.0706980815e-11,12213,1025456,1500183140
2800,2056959750,79038335,1.0670175224999999e-11,12213,1025456,1501208596
2801,2091477583,79038329,1.0670174414999999e-11,12024,1025456,1502234052
2802,2195246083,79038330,1.067017455e-11,12066,1025456,1503259508
2803,2784049792,79311347,1.0707031844999999e-11,24484,1025904,1504285412
2804,2378118875,79038332,1.0670174819999999e-11,12108,1025456,1505310868
2805,2467801834,79038333,1.0670174955e-11,12150,1025456,1506336324
2806,2531902417,79038333,1.0670174955e-11,12150,1025456,1507361780
2807,2609361041,79310967,1.0706980545e-11,12150,1025456,1508387236
2808,2514348625,79038333,1.0670174955e-11,12150,1025456,1509412692
2809,2672815167,79038333,1.0670174955e-11,12150,1025456,1510438148
2810,2484095916,79038333,1.0670174955e-11,12150,1025456,1511463604
2811,2532630166,79038331,1.0670174685e-11,12087,1025456,1512489060
2812,2392413167,79038332,1.0670174819999999e-11,12108,1025456,1513514516
2813,2437394792,79038332,1.0670174819999999e-11,12129,1025456,1514539972
2814,2323558542,79310967,1.0706980545e-11,12150,1025456,1515565428
2815,2311988625,79038333,1.0670174955e-11,12150,1025456,1516590884
2816,2258253208,79038333,1.0670174955e-11,12150,1025456,1517616340
2817,2055577833,79038333,1.0670174955e-11,12150,1025456,1518641796
2818,2061185167,79038333,1.0670174955e-11,12171,1025456,1519667252
2819,2096888166,79310967,1.0706980545e-11,12171,1025456,1520692708
2820,2058911083,79038712,1.067022612e-11,24457,1025904,1521718612
2821,2089726708,79038332,1.0670174819999999e-11,12129,1025456,1522744068
2822,2062213625,79038333,1.0670174955e-11,12150,1025456,1523769524
2823,2120883125,79310967,1.0706980545e-11,12171,1025456,1524794980
2824,2090685209,79038333,1.0670174955e-11,12171,1025456,1525820436
2825,2112463625,79038333,1.0670174955e-11,12171,1025456,1526845892
2826,2236716583,79038334,1.067017509e-11,12192,1025456,1527871348
2827,2818774333,79038334,1.067017509e-11,12192,1025456,1528896804
2828,2510286917,79310968,1.0706980679999999e-11,12192,1025456,1529922260
2829,2989856583,79038334,1.067017509e-11,12192,1025456,1530947716
2830,2132625709,79038334,1.067017509e-11,12192,1025456,1531973172
2831,2660119166,79310966,1.0706980409999999e-11,12129,1025456,1532998628
2832,2584513500,79038333,1.0670174955e-11,12150,1025456,1534024084
2833,2304038958,79038333,1.0670174955e-11,12150,1025456,1535049540
2834,2320911042,79038333,1.0670174955e-11,12171,1025456,1536074996
2835,2334687916,79310967,1.0706980545e-11,12171,1025456,1537100452
2836,3716686334,79038333,1.0670174955e-11,12171,1025456,1538125908
2837,2238685750,79038708,1.067022558e-11,24325,1025904,1539151812
2838,2468799500,79310968,1.0706980679999999e-11,12192,1025456,1540177268
2839,2142133000,79038335,1.0670175224999999e-11,12213,1025456,1541202724
2840,2074427750,79038335,1.0670175224999999e-11,12213,1025456,1542228180
2841,2062010458,79038332,1.0670174819999999e-11,12129,1025456,1543253636
2842,2067473750,79038333,1.0670174955e-11,12150,1025456,1544279092
2843,2059597667,79310967,1.0706980545e-11,12171,1025456,1545304548
2844,2051295250,79038333,1.0670174955e-11,12171,1025456,1546330004
2845,2052469958,79038333,1.0670174955e-11,12171,1025456,1547355460
2846,2060593500,79038333,1.0670174955e-11,12171,1025456,1548380916
2847,2052194708,79038334,1.067017509e-11,12192,1025456,1549406372
2848,2052254334,79310968,1.0706980679999999e-11,12192,1025456,1550431828
2849,2053275291,79038334,1.067017509e-11,12192,1025456,1551457284
2850,2070342166,79038334,1.067017509e-11,12192,1025456,1552482740
2851,2051795250,79038332,1.0670174819999999e-11,12129,1025456,1553508196
2852,2109129875,79038333,1.0670174955e-11,12150,1025456,1554533652
2853,2050817666,79310967,1.0706980545e-11,12150,1025456,1555559108
2854,2114071334,79038703,1.0670224904999999e-11,24172,1025904,1556585012
2855,2051739542,79038349,1.0670177114999999e-11,12676,1025456,1557610468
2856,2110969042,79038349,1.0670177114999999e-11,12676,1025456,1558635924
2857,2051798375,79038349,1.0670177114999999e-11,12676,1025456,1559661380
2858,2136149750,79310983,1.0706982704999999e-11,12676,1025456,1560686836
2859,2175383834,79038349,1.0670177114999999e-11,12676,1025456,1561712292
2860,2956556250,79038349,1.0670177114999999e-11,12676,1025456,1562737748
2861,2214130833,79038347,1.0670176845e-11,12613,1025456,1563763204
2862,2301230375,79038348,1.067017698e-11,12634,1025456,1564788660
2863,2193369834,79038348,1.067017698e-11,12634,1025456,1565814116
2864,2194931666,79038349,1.0670177114999999e-11,12655,1025456,1566839572
2865,2410310042,79038349,1.0670177114999999e-11,12655,1025456,1567865028
2866,2258834709,79310983,1.0706982704999999e-11,12655,1025456,1568890484
2867,2457825792,79038349,1.0670177114999999e-11,12655,1025456,1569915940
2868,2401996250,79038349,1.0670177114999999e-11,12676,1025456,1570941396
2869,2306656833,79038349,1.0670177114999999e-11,12676,1025456,1571966852
2870,2255321500,79310983,1.0706982704999999e-11,12676,1025456,1572992308
2871,2242433291,79039571,1.0670342085e-11,52394,1026708,1574019016
2872,2199341542,79038334,1.067017509e-11,12192,1025456,1575044472
2873,2185080166,79038335,1.0670175224999999e-11,12213,1025456,1576069928
2874,2058333084,79310969,1.0706980815e-11,12213,1025456,1577095384
2875,2052029667,79038336,1.0670175359999998e-11,12234,1025456,1578120840
2876,2055736500,79038336,1.0670175359999998e-11,12234,1025456,1579146296
2877,2053404417,79038336,1.0670175359999998e-11,12234,1025456,1580171752
2878,2052274959,79038336,1.0670175359999998e-11,12234,1025456,1581197208
2879,2051766834,79310970,1.070698095e-11,12234,1025456,1582222664
2880,2035777833,79038336,1.0670175359999998e-11,12234,1025456,1583248120
2881,2093145667,79038333,1.0670174955e-11,12171,1025456,1584273576
2882,2063319792,79038334,1.067017509e-11,12192,1025456,1585299032
2883,2200068875,79310968,1.0706980679999999e-11,12192,1025456,1586324488
2884,2516280042,79038335,1.0670175224999999e-11,12213,1025456,1587349944
2885,2344962917,79038335,1.0670175224999999e-11,12213,1025456,1588375400
2886,2195536916,79038335,1.0670175224999999e-11,12213,1025456,1589400856
2887,2167616250,79310969,1.0706980815e-11,12213,1025456,1590426312
2888,2172351708,79038766,1.0670233409999999e-11,26215,1025904,1591452216
2889,2579661542,79038336,1.0670175359999998e-11,12255,1025456,1592477672
2890,2293745833,79038336,1.0670175359999998e-11,12255,1025456,1593503128
2891,2588294875,79310967,1.0706980545e-11,12171,1025456,1594528584
2892,2524634333,79038334,1.067017509e-11,12192,1025456,1595554040
2893,2449639209,79038335,1.0670175224999999e-11,12213,1025456,1596579496
2894,2511616667,79038335,1.0670175224999999e-11,12213,1025456,1597604952
2895,2219196250,79310969,1.0706980815e-11,12213,1025456,1598630408
2896,3536001667,79038336,1.0670175359999998e-11,12234,1025456,1599655864
2897,2198811083,79038336,1.0670175359999998e-11,12234,1025456,1600681320
2898,3275858292,79310970,1.070698095e-11,12234,1025456,1601706776
2899,2097766208,79038336,1.0670175359999998e-11,12234,1025456,1602732232
2900,2057991125,79038336,1.0670175359999998e-11,12234,1025456,1603757688
2901,2097465542,79038329,1.0670174414999999e-11,12024,1025456,1604783144
2902,2070771042,79038330,1.067017455e-11,12066,1025456,1605808600
2903,2075834042,79310964,1.0706980139999998e-11,12066,1025456,1606834056
2904,2057742666,79038332,1.0670174819999999e-11,12108,1025456,1607859512
2905,2090408875,79038758,1.067023233e-11,25978,1025904,1608885416
2906,2059317500,79038333,1.0670174955e-11,12150,1025456,1609910872
2907,2095706084,79038333,1.0670174955e-11,12150,1025456,1610936328
2908,2058061209,79310967,1.0706980545e-11,12150,1025456,1611961784
2909,2095374083,79038333,1.0670174955e-11,12150,1025456,1612987240
2910,2061097333,79038333,1.0670174955e-11,12150,1025456,1614012696
2911,2095335083,79038332,1.0670174819999999e-11,12108,1025456,1615038152
2912,2071313250,79038332,1.0670174819999999e-11,12129,1025456,1616063608
2913,2087729958,79310967,1.0706980545e-11,12150,1025456,1617089064
2914,2048146125,79038333,1.0670174955e-11,12150,1025456,1618114520
2915,2078853625,79038333,1.0670174955e-11,12150,1025456,1619139976
2916,2058372833,79038333,1.0670174955e-11,12150,1025456,1620165432
2917,2152940458,79310967,1.0706980545e-11,12171,1025456,1621190888
2918,2204329250,79038333,1.0670174955e-11,12171,1025456,1622216344
2919,2384167792,79038333,1.0670174955e-11,12171,1025456,1623241800
2920,2390314042,79038333,1.0670174955e-11,12171,1025456,1624267256
2921,2195657167,79310966,1.0706980409999999e-11,12108,1025456,1625292712
2922,2181743125,79038754,1.067023179e-11,25846,1025904,1626318616
2923,2211305875,79038333,1.0670174955e-11,12171,1025456,1627344072
2924,2465203417,79038333,1.0670174955e-11,12171,1025456,1628369528
2925,2211355791,79038334,1.067017509e-11,12192,1025456,1629394984
2926,2305203708,79310968,1.0706980679999999e-11,12192,1025456,1630420440
2927,2469261083,79038334,1.067017509e-11,12192,1025456,1631445896
2928,2315728834,79038334,1.067017509e-11,12192,1025456,1632471352
2929,2190806834,79038334,1.067017509e-11,12192,1025456,1633496808
2930,2341870625,79310968,1.0706980679999999e-11,12192,1025456,1634522264
2931,2378928666,79038332,1.0670174819999999e-11,12129,1025456,1635547720
2932,3427069875,79038333,1.0670174955e-11,12150,1025456,1636573176
2933,2071303833,79310967,1.0706980545e-11,12150,1025456,1637598632
2934,2063966083,79038333,1.0670174955e-11,12171,1025456,1638624088
2935,2051301583,79038333,1.0670174955e-11,12171,1025456,1639649544
2936,2056239875,79038333,1.0670174955e-11,12171,1025456,1640675000
2937,2072860334,79038333,1.0670174955e-11,12171,1025456,1641700456
2938,2083284917,79310968,1.0706980679999999e-11,12192,1025456,1642725912
2939,2072283292,79038753,1.0670231654999998e-11,25798,1025904,1643751816
2940,2058590208,79038336,1.0670175359999998e-11,12234,1025456,1644777272
2941,2077812500,79038333,1.0670174955e-11,12150,1025456,1645802728
2942,2270886250,79038333,1.0670174955e-11,12171,1025456,1646828184
2943,2483001208,79310968,1.0706980679999999e-11,12192,1025456,1647853640
2944,2300294541,79038334,1.067017509e-11,12192,1025456,1648879096
2945,2541375500,79038334,1.067017509e-11,12192,1025456,1649904552
2946,2985169125,79310969,1.0706980815e-11,12213,1025456,1650930008
2947,2356689625,79038335,1.0670175224999999e-11,12213,1025456,1651955464
2948,2249043417,79038335,1.0670175224999999e-11,12213,1025456,1652980920
2949,2227756000,79038335,1.0670175224999999e-11,12213,1025456,1654006376
2950,2166723042,79310969,1.0706980815e-11,12213,1025456,1655031832
2951,2739201792,79038333,1.0670174955e-11,12150,1025456,1656057288
2952,2485381666,79038333,1.0670174955e-11,12171,1025456,1657082744
2953,2260440125,79038333,1.0670174955e-11,12171,1025456,1658108200
2954,2195105750,79310968,1.0706980679999999e-11,12192,1025456,1659133656
2955,2197671250,79038334,1.067017509e-11,12192,1025456,1660159112
2956,3267470167,79038749,1.0670231115e-11,25666,1025904,1661185016
2957,2051113000,79038335,1.0670175224999999e-11,12213,1025456,1662210472
2958,2041114042,79310969,1.0706980815e-11,12213,1025456,1663235928
2959,2093257709,79038335,1.0670175224999999e-11,12213,1025456,1664261384
2960,2057972708,79038336,1.0670175359999998e-11,12234,1025456,1665286840
2961,2095677500,79038333,1.0670174955e-11,12150,1025456,1666312296
2962,2086110791,79038333,1.0670174955e-11,12171,1025456,1667337752
2963,2113452791,79310968,1.0706980679999999e-11,12192,1025456,1668363208
2964,2065389750,79038334,1.067017509e-11,12192,1025456,1669388664
2965,2111025458,79038334,1.067017509e-11,12192,1025456,1670414120
2966,2056956583,79038334,1.067017509e-11,12192,1025456,1671439576
2967,2089010500,79038335,1.0670175224999999e-11,12213,1025456,1672465032
2968,2058342167,79310969,1.0706980815e-11,12213,1025456,1673490488
2969,2091420041,79038335,1.0670175224999999e-11,12213,1025456,1674515944
2970,2070230958,79038335,1.0670175224999999e-11,12213,1025456,1675541400
2971,2096983000,79038333,1.0670174955e-11,12150,1025456,1676566856
2972,2070380584,79310967,1.0706980545e-11,12171,1025456,1677592312
2973,3015491042,79038744,1.067023044e-11,25513,1025904,1678618216
2974,2501544959,79038334,1.067017509e-11,12192,1025456,1679643672
2975,2205720791,79038335,1.0670175224999999e-11,12213,1025456,1680669128
2976,2519060875,79310969,1.0706980815e-11,12213,1025456,1681694584
2977,2461948458,79038335,1.0670175224999999e-11,12213,1025456,1682720040
2978,2271983167,79038335,1.0670175224999999e-11,12213,1025456,1683745496
2979,2507122542,79038335,1.0670175224999999e-11,12213,1025456,1684770952
2980,2262356209,79310969,1.0706980815e-11,12213,1025456,1685796408
2981,2524788875,79038333,1.0670174955e-11,12150,1025456,1686821864
2982,2456576709,79038333,1.0670174955e-11,12171,1025456,1687847320
2983,2235125167,79038333,1.0670174955e-11,12171,1025456,1688872776
2984,2229904625,79310968,1.0706980679999999e-11,12192,1025456,1689898232
2985,2403467542,79038334,1.067017509e-11,12192,1025456,1690923688
2986,2154919000,79038334,1.067017509e-11,12192,1025456,1691949144
2987,2050756833,79038334,1.067017509e-11,12192,1025456,1692974600
2988,2051709125,79310969,1.0706980815e-11,12213,1025456,1694000056
2989,2064820459,79038335,1.0670175224999999e-11,12213,1025456,1695025512
2990,2068306750,79038741,1.0670230035e-11,25423,1025904,1696051416
2991,2094097833,79038333,1.0670174955e-11,12171,1025456,1697076872
2992,2065079667,79038334,1.067017509e-11,12192,1025456,1698102328
2993,2074249958,79310969,1.0706980815e-11,12213,1025456,1699127784
2994,40810050125,79038335,1.0670175224999999e-11,12213,1025456,1700153240
2995,22006246166,80483297,1.0865245094999999e-11,12213,1025456,1701178696
2996,2049789792,79310970,1.070698095e-11,12234,1025456,1702204152
2997,2048951417,79038336,1.0670175359999998e-11,12234,1025456,1703229608
2998,2050300917,79038336,1.0670175359999998e-11,12234,1025456,1704255064
2999,2049821625,79038336,1.0670175359999998e-11,12234,1025456,1705280520
3000,2050384333,79038336,1.0670175359999998e-11,12234,1025456,1706305976
3001,2036348375,79310957,1.0706979194999999e-11,11814,1025456,1707331432
3002,2051436084,79038325,1.0670173874999998e-11,11877,1025456,1708356888
3003,2036883125,79038325,1.0670173874999998e-11,11877,1025456,1709382344
3004,2051357875,79038326,1.067017401e-11,11940,1025456,1710407800
3005,2205571916,79310960,1.0706979599999999e-11,11940,1025456,1711433256
3006,2331749416,79038326,1.067017401e-11,11940,1025456,1712458712
3007,2206833000,79038729,1.0670228415e-11,25018,1025904,1713484616
3008,2745790667,79038329,1.0670174414999999e-11,12003,1025456,1714510072
3009,2163845042,79310964,1.0706980139999998e-11,12066,1025456,1715535528
3010,2251715625,79038330,1.067017455e-11,12066,1025456,1716560984
3011,2399738875,79038328,1.0670174279999998e-11,11982,1025456,1717586440
3012,2389224500,79038329,1.0670174414999999e-11,12003,1025456,1718611896
3013,2476869625,79310963,1.0706980004999999e-11,12024,1025456,1719637352
3014,2399095750,79038329,1.0670174414999999e-11,12024,1025456,1720662808
3015,2357797458,79038329,1.0670174414999999e-11,12024,1025456,1721688264
3016,2148431167,79038329,1.0670174414999999e-11,12024,1025456,1722713720
3017,2267317167,79310964,1.0706980139999998e-11,12045,1025456,1723739176
3018,2269254333,79038330,1.067017455e-11,12045,1025456,1724764632
3019,2223408750,79038330,1.067017455e-11,12045,1025456,1725790088
3020,2058693541,79038330,1.067017455e-11,12045,1025456,1726815544
3021,2069195625,79038328,1.0670174279999998e-11,11982,1025456,1727841000
3022,2060764458,79310963,1.0706980004999999e-11,12003,1025456,1728866456
3023,2054478750,79038329,1.0670174414999999e-11,12003,1025456,1729891912
3024,2052195459,79038727,1.0670228145e-11,24949,1025904,1730917816
3025,2048847834,79038331,1.0670174685e-11,12087,1025456,1731943272
3026,2049289792,79038331,1.0670174685e-11,12087,1025456,1732968728
3027,2048584375,79310965,1.0706980274999999e-11,12087,1025456,1733994184
3028,2049076792,79038331,1.0670174685e-11,12087,1025456,1735019640
3029,2071310084,79038331,1.0670174685e-11,12087,1025456,1736045096
3030,2288024334,79038331,1.0670174685e-11,12087,1025456,1737070552
3031,2539575000,79310963,1.0706980004999999e-11,12024,1025456,1738096008
3032,2599831042,79038330,1.067017455e-11,12045,1025456,1739121464
3033,2373920125,79038330,1.067017455e-11,12045,1025456,1740146920
3034,2902323084,79038330,1.067017455e-11,12066,1025456,1741172376
3035,2414976834,79310964,1.0706980139999998e-11,12066,1025456,1742197832
3036,2301265000,79038330,1.067017455e-11,12066,1025456,1743223288
3037,2407162125,79038330,1.067017455e-11,12066,1025456,1744248744
3038,2383013208,79038331,1.0670174685e-11,12087,1025456,1745274200
3039,2412528583,79310965,1.0706980274999999e-11,12087,1025456,1746299656
3040,2248613834,79038331,1.0670174685e-11,12087,1025456,1747325112
3041,2220191959,79038723,1.0670227604999999e-11,24817,1025904,1748351016
3042,2191170959,79038330,1.067017455e-11,12045,1025456,1749376472
3043,2227135625,79310964,1.0706980139999998e-11,12066,1025456,1750401928
3044,2050043666,79038330,1.067017455e-11,12066,1025456,1751427384
3045,2046855167,79038331,1.0670174685e-11,12087,1025456,1752452840
3046,2075952250,79038331,1.0670174685e-11,12087,1025456,1753478296
3047,2054968125,79038331,1.0670174685e-11,12087,1025456,1754503752
3048,2098728542,79310965,1.0706980274999999e-11,12087,1025456,1755529208
3049,73355709250,243395526,3.285839601e-11,12087,-194049940,1561479268
3050,2085203208,79340444,1.071095994e-11,12087,1025456,1562504724
3051,2062147750,79038329,1.0670174414999999e-11,12024,1025456,1563530180
3052,2064272917,79038330,1.067017455e-11,12045,1025456,1564555636
3053,2060074083,79038330,1.067017455e-11,12045,1025456,1565581092
3054,2087252000,79038330,1.067017455e-11,12066,1025456,1566606548
3055,2063307042,79340443,1.0710959804999999e-11,12066,1025456,1567632004
3056,2259480792,79038330,1.067017455e-11,12066,1025456,1568657460
3057,2342436833,79038330,1.067017455e-11,12066,1025456,1569682916
3058,2545402542,79038721,1.0670227335e-11,24748,1025904,1570708820
3059,2315620667,79340446,1.071096021e-11,12150,1025456,1571734276
3060,2215164375,79038333,1.0670174955e-11,12150,1025456,1572759732
3061,2268129000,79038330,1.067017455e-11,12066,1025456,1573785188
3062,2232385667,79038331,1.0670174685e-11,12087,1025456,1574810644
3063,2362515708,79340445,1.0710960074999999e-11,12108,1025456,1575836100
3064,2398321709,79038332,1.0670174819999999e-11,12108,1025456,1576861556
3065,2469563500,79038332,1.0670174819999999e-11,12108,1025456,1577887012
3066,2421066416,79038332,1.0670174819999999e-11,12129,1025456,1578912468
3067,3620430250,79340445,1.0710960074999999e-11,12129,1025456,1579937924
3068,2448446500,79038332,1.0670174819999999e-11,12129,1025456,1580963380
3069,2266065750,79038332,1.0670174819999999e-11,12129,1025456,1581988836
3070,2171674417,79038332,1.0670174819999999e-11,12129,1025456,1583014292
3071,2071416791,79400866,1.0719116909999998e-11,12066,1025456,1584039748
3072,2059559958,79038331,1.0670174685e-11,12087,1025456,1585065204
3073,2073424333,79038331,1.0670174685e-11,12087,1025456,1586090660
3074,2060040833,79038332,1.0670174819999999e-11,12108,1025456,1587116116
3075,2063556959,79038718,1.0670226929999998e-11,24658,1025904,1588142020
3076,2056579584,79340445,1.0710960074999999e-11,12129,1025456,1589167476
3077,2061028125,79038332,1.0670174819999999e-11,12129,1025456,1590192932
3078,2053672416,79038332,1.0670174819999999e-11,12129,1025456,1591218388
3079,2051198000,79038332,1.0670174819999999e-11,12129,1025456,1592243844
3080,2091989750,79038332,1.0670174819999999e-11,12129,1025456,1593269300
3081,3460333042,79340443,1.0710959804999999e-11,12066,1025456,1594294756
3082,2216374833,79038331,1.0670174685e-11,12087,1025456,1595320212
3083,2394321708,79038332,1.0670174819999999e-11,12108,1025456,1596345668
3084,2400344125,79340445,1.0710960074999999e-11,12108,1025456,1597371124
3085,2392298583,79038332,1.0670174819999999e-11,12108,1025456,1598396580
3086,2587561791,79038332,1.0670174819999999e-11,12108,1025456,1599422036
3087,2313952333,79038332,1.0670174819999999e-11,12129,1025456,1600447492
3088,2424224125,79340445,1.0710960074999999e-11,12129,1025456,1601472948
3089,2592630000,79038332,1.0670174819999999e-11,12129,1025456,1602498404
3090,2310232250,79038332,1.0670174819999999e-11,12129,1025456,1603523860
3091,3744718292,79340443,1.0710959804999999e-11,12066,1025456,1604549316
3092,2352599750,79038713,1.0670226254999998e-11,24484,1025904,1605575220
3093,2300207042,79038332,1.0670174819999999e-11,12108,1025456,1606600676
3094,2372579375,79038332,1.0670174819999999e-11,12108,1025456,1607626132
3095,2051436375,79038332,1.0670174819999999e-11,12129,1025456,1608651588
3096,2051632833,79340445,1.0710960074999999e-11,12129,1025456,1609677044
3097,2052196584,79038332,1.0670174819999999e-11,12129,1025456,1610702500
3098,2051663209,79038332,1.0670174819999999e-11,12129,1025456,1611727956
3099,2051975750,79038332,1.0670174819999999e-11,12129,1025456,1612753412
3100,2052236000,79340445,1.0710960074999999e-11,12129,1025456,1613778868
3101,2051490625,79038326,1.067017401e-11,11940,1025456,1614804324
3102,2049834291,79038328,1.0670174279999998e-11,11982,1025456,1615829780
3103,2052449208,79038328,1.0670174279999998e-11,11982,1025456,1616855236
3104,2051726625,79038329,1.0670174414999999e-11,12024,1025456,1617880692
3105,2052511625,79340442,1.0710959669999999e-11,12024,1025456,1618906148
3106,2052155917,79038329,1.0670174414999999e-11,12024,1025456,1619931604
3107,2051216667,79038329,1.0670174414999999e-11,12024,1025456,1620957060
3108,2050286250,79038330,1.067017455e-11,12066,1025456,1621982516
3109,2051624667,79038708,1.067022558e-11,24352,1025904,1623008420
3110,2051460000,79340445,1.0710960074999999e-11,12108,1025456,1624033876
3111,2051663708,79038329,1.0670174414999999e-11,12024,1025456,1625059332
3112,2045941208,79038330,1.067017455e-11,12045,1025456,1626084788
3113,2058278875,79038330,1.067017455e-11,12066,1025456,1627110244
3114,2085502375,79038330,1.067017455e-11,12066,1025456,1628135700
3115,2573810334,79340443,1.0710959804999999e-11,12066,1025456,1629161156
3116,2542251208,79038331,1.0670174685e-11,12087,1025456,1630186612
3117,2273383750,79038331,1.0670174685e-11,12087,1025456,1631212068
3118,2366912292,79340444,1.071095994e-11,12087,1025456,1632237524
3119,2301547958,79038331,1.0670174685e-11,12087,1025456,1633262980
3120,2368049000,79038331,1.0670174685e-11,12087,1025456,1634288436
3121,2327059458,79038329,1.0670174414999999e-11,12024,1025456,1635313892
3122,2380773917,79340443,1.0710959804999999e-11,12045,1025456,1636339348
3123,2450526125,79038330,1.067017455e-11,12045,1025456,1637364804
3124,2366299833,79038330,1.067017455e-11,12066,1025456,1638390260
3125,2379497334,79038330,1.067017455e-11,12066,1025456,1639415716
3126,2294777917,79340817,1.0711010295e-11,24220,1025904,1640441620
3127,2259388167,79038332,1.0670174819999999e-11,12129,1025456,1641467076
3128,2219851583,79038332,1.0670174819999999e-11,12129,1025456,1642492532
3129,2049317334,79038332,1.0670174819999999e-11,12129,1025456,1643517988
3130,2050643416,79038333,1.0670174955e-11,12150,1025456,1644543444
3131,2049462583,79340443,1.0710959804999999e-11,12066,1025456,1645568900
3132,2050431667,79038331,1.0670174685e-11,12087,1025456,1646594356
3133,2050464084,79038332,1.0670174819999999e-11,12108,1025456,1647619812
3134,2049029083,79038332,1.0670174819999999e-11,12108,1025456,1648645268
3135,2049206333,79038332,1.0670174819999999e-11,12108,1025456,1649670724
3136,2050207417,79340445,1.0710960074999999e-11,12108,1025456,1650696180
3137,2049845750,79038332,1.0670174819999999e-11,12129,1025456,1651721636
3138,2050095500,79038332,1.0670174819999999e-11,12129,1025456,1652747092
3139,2050326459,79038332,1.0670174819999999e-11,12129,1025456,1653772548
3140,2049440166,79038332,1.0670174819999999e-11,12129,1025456,1654798004
3141,2050188209,79340443,1.0710959804999999e-11,12066,1025456,1655823460
3142,2049673541,79038331,1.0670174685e-11,12087,1025456,1656848916
3143,2048667833,79038701,1.0670224635e-11,24109,1025904,1657874820
3144,2048967625,79038346,1.0670176709999999e-11,12592,1025456,1658900276
3145,2050157375,79340460,1.0710962099999999e-11,12613,1025456,1659925732
3146,2049368791,79038347,1.0670176845e-11,12613,1025456,1660951188
3147,2050141084,79038347,1.0670176845e-11,12613,1025456,1661976644
3148,2046940709,79038347,1.0670176845e-11,12613,1025456,1663002100
3149,2077087875,79038347,1.0670176845e-11,12613,1025456,1664027556
3150,2058219708,79340460,1.0710962099999999e-11,12613,1025456,1665053012
3151,2148337083,79038345,1.0670176575e-11,12550,1025456,1666078468
3152,2142673250,79038346,1.0670176709999999e-11,12571,1025456,1667103924
3153,2243871125,79038346,1.0670176709999999e-11,12571,1025456,1668129380
3154,2249735292,79038346,1.0670176709999999e-11,12592,1025456,1669154836
3155,2339377333,79340459,1.0710961964999998e-11,12592,1025456,1670180292
3156,2244755375,79038346,1.0670176709999999e-11,12592,1025456,1671205748
3157,2703153667,79038346,1.0670176709999999e-11,12592,1025456,1672231204
3158,2529739667,79340460,1.0710962099999999e-11,12613,1025456,1673256660
3159,2233485000,79038347,1.0670176845e-11,12613,1025456,1674282116
3160,2432847625,79039568,1.067034168e-11,52283,1026708,1675308824
3161,2381833708,79038332,1.0670174819999999e-11,12108,1025456,1676334280
3162,2618768459,79038332,1.0670174819999999e-11,12129,1025456,1677359736
3163,2185000709,79340446,1.071096021e-11,12150,1025456,1678385192
3164,2333641291,79038333,1.0670174955e-11,12150,1025456,1679410648
3165,2266614833,79038333,1.0670174955e-11,12150,1025456,1680436104
3166,2099110583,79038333,1.0670174955e-11,12171,1025456,1681461560
3167,2055880667,79340446,1.071096021e-11,12171,1025456,1682487016
3168,2057486959,79038333,1.0670174955e-11,12171,1025456,1683512472
3169,2048862292,79038333,1.0670174955e-11,12171,1025456,1684537928
3170,2050547334,79038333,1.0670174955e-11,12171,1025456,1685563384
3171,2059946667,79340445,1.0710960074999999e-11,12108,1025456,1686588840
3172,2061899042,79038332,1.0670174819999999e-11,12129,1025456,1687614296
3173,2058174667,79038332,1.0670174819999999e-11,12129,1025456,1688639752
3174,2061654500,79038333,1.0670174955e-11,12150,1025456,1689665208
3175,2176976916,79038333,1.0670174955e-11,12150,1025456,1690690664
3176,2182993334,79340446,1.071096021e-11,12150,1025456,1691716120
3177,2213398375,79038764,1.0670233139999998e-11,26152,1025904,1692742024
3178,2268695000,79038334,1.067017509e-11,12192,1025456,1693767480
3179,2295795584,79038335,1.0670175224999999e-11,12213,1025456,1694792936
3180,2224248709,79340448,1.0710960479999999e-11,12213,1025456,1695818392
3181,2227603500,79038332,1.0670174819999999e-11,12129,1025456,1696843848
3182,2194641250,79038333,1.0670174955e-11,12150,1025456,1697869304
3183,2172578375,79038333,1.0670174955e-11,12171,1025456,1698894760
3184,2242068791,79340446,1.071096021e-11,12171,1025456,1699920216
3185,2338213458,79038333,1.0670174955e-11,12171,1025456,1700945672
3186,2340196583,79038333,1.0670174955e-11,12171,1025456,1701971128
3187,2433451583,79038334,1.067017509e-11,12192,1025456,1702996584
3188,2485704208,79340447,1.0710960345e-11,12192,1025456,1704022040
3189,2288004209,79038334,1.067017509e-11,12192,1025456,1705047496
3190,2176302667,79038334,1.067017509e-11,12192,1025456,1706072952
3191,2222476209,79038332,1.0670174819999999e-11,12129,1025456,1707098408
3192,2071931041,79038333,1.0670174955e-11,12150,1025456,1708123864
3193,2065451750,79340446,1.071096021e-11,12150,1025456,1709149320
3194,2067029875,79038760,1.0670232599999999e-11,26020,1025904,1710175224
3195,2051951917,79038334,1.067017509e-11,12192,1025456,1711200680
3196,2066378208,79038334,1.067017509e-11,12192,1025456,1712226136
3197,2060383250,79340447,1.0710960345e-11,12192,1025456,1713251592
3198,2070133750,79038334,1.067017509e-11,12192,1025456,1714277048
3199,2056697042,79038334,1.067017509e-11,12192,1025456,1715302504
3200,2051142083,79038334,1.067017509e-11,12192,1025456,1716327960
3201,2049206125,79038328,1.0670174279999998e-11,11982,1025456,1717353416
3202,2052080875,79340442,1.0710959669999999e-11,12024,1025456,1718378872
3203,2049591708,79038329,1.0670174414999999e-11,12024,1025456,1719404328
3204,2057975750,79038330,1.067017455e-11,12066,1025456,1720429784
3205,2184200375,79038330,1.067017455e-11,12066,1025456,1721455240
3206,2334432458,79038330,1.067017455e-11,12066,1025456,1722480696
3207,2242553791,79340443,1.0710959804999999e-11,12066,1025456,1723506152
3208,2342610292,79038332,1.0670174819999999e-11,12108,1025456,1724531608
3209,74572818333,79038332,1.0670174819999999e-11,12108,1025456,1725557064
3210,14092813708,81757353,1.1037242655e-11,12108,1025456,1726582520
3211,2056615375,79038752,1.067023152e-11,25762,1025904,1727608424
3212,2060823166,79038331,1.0670174685e-11,12087,1025456,1728633880
3213,2056486000,79038332,1.0670174819999999e-11,12108,1025456,1729659336
3214,2064667541,79038332,1.0670174819999999e-11,12108,1025456,1730684792
3215,2055359625,79340445,1.0710960074999999e-11,12129,1025456,1731710248
3216,2058862333,79038332,1.0670174819999999e-11,12129,1025456,1732735704
3217,2061908125,79038332,1.0670174819999999e-11,12129,1025456,1733761160
3218,2062107417,79038332,1.0670174819999999e-11,12129,1025456,1734786616
3219,2049847666,79038332,1.0670174819999999e-11,12129,1025456,1735812072
3220,2056045375,79340445,1.0710960074999999e-11,12129,1025456,1736837528
3221,2055714417,79038330,1.067017455e-11,12066,1025456,1737862984
3222,2069625083,79038331,1.0670174685e-11,12087,1025456,1738888440
3223,2068014041,79038331,1.0670174685e-11,12087,1025456,1739913896
3224,2198711958,79038332,1.0670174819999999e-11,12108,1025456,1740939352
3225,2253118750,79038332,1.0670174819999999e-11,12108,1025456,1741964808
3226,2837933334,79038332,1.0670174819999999e-11,12108,1025456,1742990264
3227,2158599959,79038332,1.0670174819999999e-11,12108,1025456,1744015720
3228,2555639333,79038750,1.0670231249999998e-11,25714,1025904,1745041624
3229,2103794167,79340446,1.071096021e-11,12171,1025456,1746067080
3230,2326529208,79038333,1.0670174955e-11,12171,1025456,1747092536
3231,3663433666,79038331,1.0670174685e-11,12087,1025456,1748117992
3232,2219114875,79340445,1.0710960074999999e-11,12108,1025456,1749143448
3233,2302904500,79038332,1.0670174819999999e-11,12129,1025456,1750168904
3234,2270184000,79038332,1.0670174819999999e-11,12129,1025456,1751194360
3235,2256103667,79038332,1.0670174819999999e-11,12129,1025456,1752219816
3236,2174673417,79340446,1.071096021e-11,12150,1025456,1753245272
3237,2387930583,79038333,1.0670174955e-11,12150,1025456,1754270728
3238,2301348542,79038333,1.0670174955e-11,12150,1025456,1755296184
3239,2090985166,79038333,1.0670174955e-11,12150,1025456,1756321640
3240,2073074209,79038333,1.0670174955e-11,12150,1025456,1757347096
3241,2054491000,79340444,1.071095994e-11,12087,1025456,1758372552
3242,2051759209,79038332,1.0670174819999999e-11,12108,1025456,1759398008
3243,2066924250,79038332,1.0670174819999999e-11,12108,1025456,1760423464
3244,2055548333,79038332,1.0670174819999999e-11,12129,1025456,1761448920
3245,2051062375,79038747,1.0670230845e-11,25603,1025904,1762474824
3246,2060230583,79038333,1.0670174955e-11,12171,1025456,1763500280
3247,2073645250,79038333,1.0670174955e-11,12171,1025456,1764525736
3248,2053519125,79038333,1.0670174955e-11,12171,1025456,1765551192
3249,2065754833,79038333,1.0670174955e-11,12171,1025456,1766576648
3250,2053190500,79340446,1.071096021e-11,12171,1025456,1767602104
3251,2056259416,79038332,1.0670174819999999e-11,12108,1025456,1768627560
3252,2051377958,79038332,1.0670174819999999e-11,12129,1025456,1769653016
3253,2134128334,79038333,1.0670174955e-11,12150,1025456,1770678472
3254,2284234583,79038333,1.0670174955e-11,12150,1025456,1771703928
3255,2676211666,79340446,1.071096021e-11,12150,1025456,1772729384
3256,2323557250,79038333,1.0670174955e-11,12150,1025456,1773754840
3257,2443462625,79038333,1.0670174955e-11,12171,1025456,1774780296
3258,2312523833,79038333,1.0670174955e-11,12171,1025456,1775805752
3259,2259263042,79340446,1.071096021e-11,12171,1025456,1776831208
3260,2512300500,79038333,1.0670174955e-11,12171,1025456,1777856664
3261,2842870708,79038332,1.0670174819999999e-11,12108,1025456,1778882120
3262,2386385958,79340855,1.0711015424999998e-11,25450,1025904,1779908024
3263,2675067458,79038333,1.0670174955e-11,12150,1025456,1780933480
3264,2478120542,79038333,1.0670174955e-11,12150,1025456,1781958936
3265,2053343375,79038333,1.0670174955e-11,12171,1025456,1782984392
3266,2322710000,79038333,1.0670174955e-11,12171,1025456,1784009848
3267,2165395917,79038333,1.0670174955e-11,12171,1025456,1785035304
3268,2121602458,79038333,1.0670174955e-11,12171,1025456,1786060760
3269,2052439583,79038333,1.0670174955e-11,12171,1025456,1787086216
3270,2053514583,79038333,1.0670174955e-11,12171,1025456,1788111672
3271,2050797083,79340445,1.0710960074999999e-11,12108,1025456,1789137128
3272,2055781583,79038332,1.0670174819999999e-11,12129,1025456,1790162584
3273,2052138583,79038332,1.0670174819999999e-11,12129,1025456,1791188040
3274,2050188666,79038333,1.0670174955e-11,12150,1025456,1792213496
3275,2063848500,79038333,1.0670174955e-11,12150,1025456,1793238952
3276,2061824708,79340446,1.071096021e-11,12150,1025456,1794264408
3277,2077400250,79038333,1.0670174955e-11,12150,1025456,1795289864
3278,2062089333,79038333,1.0670174955e-11,12171,1025456,1796315320
3279,2090481916,79038740,1.0670229899999999e-11,25381,1025904,1797341224
3280,2056592250,79038334,1.067017509e-11,12192,1025456,1798366680
3281,2094330375,79340445,1.0710960074999999e-11,12108,1025456,1799392136
3282,2056278584,79038332,1.0670174819999999e-11,12129,1025456,1800417592
3283,2090883167,79038333,1.0670174955e-11,12150,1025456,1801443048
3284,2060758125,79038333,1.0670174955e-11,12150,1025456,1802468504
3285,2145895042,79340446,1.071096021e-11,12150,1025456,1803493960
3286,2243277208,79038333,1.0670174955e-11,12171,1025456,1804519416
3287,2350847542,79038333,1.0670174955e-11,12171,1025456,1805544872
3288,2197856875,79038333,1.0670174955e-11,12171,1025456,1806570328
3289,2244437833,79340446,1.071096021e-11,12171,1025456,1807595784
3290,2200457125,79038333,1.0670174955e-11,12171,1025456,1808621240
3291,2350045125,79038332,1.0670174819999999e-11,12108,1025456,1809646696
3292,2565512250,79038332,1.0670174819999999e-11,12129,1025456,1810672152
3293,2742750125,79340445,1.0710960074999999e-11,12129,1025456,1811697608
3294,2511914000,79038333,1.0670174955e-11,12150,1025456,1812723064
3295,2387139583,79038333,1.0670174955e-11,12150,1025456,1813748520
3296,2333929708,79038735,1.0670229225e-11,25228,1025904,1814774424
3297,2300578084,79340446,1.071096021e-11,12171,1025456,1815799880
3298,2309148666,79038333,1.0670174955e-11,12171,1025456,1816825336
3299,2389359542,79038333,1.0670174955e-11,12171,1025456,1817850792
3300,3367959458,79038334,1.067017509e-11,12192,1025456,1818876248
3301,2063059125,79340441,1.0710959535e-11,11982,1025456,1819901704
3302,2071664750,79038329,1.0670174414999999e-11,12024,1025456,1820927160
3303,2060480292,79038330,1.067017455e-11,12066,1025456,1821952616
3304,2061007417,79038330,1.067017455e-11,12066,1025456,1822978072
3305,2063180875,79038330,1.067017455e-11,12066,1025456,1824003528
3306,2061839083,79340443,1.0710959804999999e-11,12066,1025456,1825028984
3307,2074315250,79038332,1.0670174819999999e-11,12108,1025456,1826054440
3308,2064358000,79038332,1.0670174819999999e-11,12108,1025456,1827079896
3309,2124840917,79038332,1.0670174819999999e-11,12108,1025456,1828105352
3310,2242828334,79340445,1.0710960074999999e-11,12108,1025456,1829130808
3311,2178385708,79038330,1.067017455e-11,12045,1025456,1830156264
3312,2273691709,79038330,1.067017455e-11,12066,1025456,1831181720
3313,2293494292,79038729,1.0670228415e-11,25012,1025904,1832207624
3314,2281373041,79038332,1.0670174819999999e-11,12108,1025456,1833233080
3315,2228202916,79340445,1.0710960074999999e-11,12129,1025456,1834258536
3316,2204833875,79038332,1.0670174819999999e-11,12129,1025456,1835283992
3317,2330190291,79038332,1.0670174819999999e-11,12129,1025456,1836309448
3318,2774447166,79038332,1.0670174819999999e-11,12129,1025456,1837334904
3319,2262947875,79340445,1.0710960074999999e-11,12129,1025456,1838360360
3320,2287998250,79038332,1.0670174819999999e-11,12129,1025456,1839385816
3321,2301150250,79038330,1.067017455e-11,12066,1025456,1840411272
3322,2226003458,79038331,1.0670174685e-11,12087,1025456,1841436728
3323,2136175292,79340444,1.071095994e-11,12087,1025456,1842462184
3324,2277104291,79038332,1.0670174819999999e-11,12108,1025456,1843487640
3325,2152144416,79038332,1.0670174819999999e-11,12108,1025456,1844513096
3326,2051852000,79038332,1.0670174819999999e-11,12108,1025456,1845538552
3327,2051731917,79340445,1.0710960074999999e-11,12108,1025456,1846564008
3328,2051200166,79038332,1.0670174819999999e-11,12129,1025456,1847589464
3329,2050670042,79038332,1.0670174819999999e-11,12129,1025456,1848614920
3330,2051513666,79038727,1.0670228145e-11,24943,1025904,1849640824
3331,2051653333,79038331,1.0670174685e-11,12087,1025456,1850666280
3332,2053127833,79340445,1.0710960074999999e-11,12108,1025456,1851691736
3333,2050088083,79038332,1.0670174819999999e-11,12129,1025456,1852717192
3334,88760696666,259400688,3.5019092879999996e-11,12129,-145281340,1707435852
3335,2051474375,79038332,1.0670174819999999e-11,12129,1025456,1708461308
3336,2049201416,79038333,1.0670174955e-11,12150,1025456,1709486764
3337,2051550291,79362568,1.0713946679999999e-11,12150,1025456,1710512220
3338,2051142917,79038333,1.0670174955e-11,12150,1025456,1711537676
3339,2052875500,79038333,1.0670174955e-11,12150,1025456,1712563132
3340,2051720792,79038333,1.0670174955e-11,12150,1025456,1713588588
3341,2051230000,79362566,1.071394641e-11,12087,1025456,1714614044
3342,2052123542,79038332,1.0670174819999999e-11,12108,1025456,1715639500
3343,2060925709,79038332,1.0670174819999999e-11,12108,1025456,1716664956
3344,2081975042,79038332,1.0670174819999999e-11,12129,1025456,1717690412
3345,2484325375,79038332,1.0670174819999999e-11,12129,1025456,1718715868
3346,2263374792,79362567,1.0713946545e-11,12129,1025456,1719741324
3347,2212112458,79038722,1.067022747e-11,24811,1025904,1720767228
3348,2361852292,79038333,1.0670174955e-11,12150,1025456,1721792684
3349,2511833375,79038333,1.0670174955e-11,12171,1025456,1722818140
3350,2660463333,79362568,1.0713946679999999e-11,12171,1025456,1723843596
3351,2236146958,79038331,1.0670174685e-11,12087,1025456,1724869052
3352,2633122459,79038332,1.0670174819999999e-11,12108,1025456,1725894508
3353,2481880750,79038332,1.0670174819999999e-11,12129,1025456,1726919964
3354,2362263166,79362567,1.0713946545e-11,12129,1025456,1727945420
3355,2465560542,79038332,1.0670174819999999e-11,12129,1025456,1728970876
3356,2276627750,79038332,1.0670174819999999e-11,12129,1025456,1729996332
3357,2260756000,79362568,1.0713946679999999e-11,12150,1025456,1731021788
3358,2449882708,79038333,1.0670174955e-11,12150,1025456,1732047244
3359,2061161416,79038333,1.0670174955e-11,12150,1025456,1733072700
3360,2071196750,79038333,1.0670174955e-11,12150,1025456,1734098156
3361,2062479750,79038331,1.0670174685e-11,12087,1025456,1735123612
3362,2052283084,79362567,1.0713946545e-11,12108,1025456,1736149068
3363,2052638125,79038332,1.0670174819999999e-11,12108,1025456,1737174524
3364,2049319875,79038718,1.0670226929999998e-11,24658,1025904,1738200428
3365,2053786250,79038333,1.0670174955e-11,12171,1025456,1739225884
3366,2066250125,79038333,1.0670174955e-11,12171,1025456,1740251340
3367,2072118167,79362568,1.0713946679999999e-11,12171,1025456,1741276796
3368,2082866125,79038333,1.0670174955e-11,12171,1025456,1742302252
3369,2230178625,79038333,1.0670174955e-11,12171,1025456,1743327708
3370,2294553833,79038333,1.0670174955e-11,12171,1025456,1744353164
3371,2495619750,79362567,1.0713946545e-11,12108,1025456,1745378620
3372,2203437000,79038332,1.0670174819999999e-11,12129,1025456,1746404076
3373,2285113708,79038332,1.0670174819999999e-11,12129,1025456,1747429532
3374,2221422417,79038333,1.0670174955e-11,12150,1025456,1748454988
3375,2614408542,79362568,1.0713946679999999e-11,12150,1025456,1749480444
3376,2227502458,79038333,1.0670174955e-11,12150,1025456,1750505900
3377,2246549208,79038333,1.0670174955e-11,12150,1025456,1751531356
3378,2358562125,79038333,1.0670174955e-11,12171,1025456,1752556812
3379,2529022708,79362568,1.0713946679999999e-11,12171,1025456,1753582268
3380,3008432916,79038333,1.0670174955e-11,12171,1025456,1754607724
3381,60836381041,79038713,1.0670226254999998e-11,24505,1025904,1755633628
3382,17690198084,81599791,1.1015971784999998e-11,12129,1025456,1756659084
3383,2052841125,79038333,1.0670174955e-11,12150,1025456,1757684540
3384,2055929291,79038333,1.0670174955e-11,12150,1025456,1758709996
3385,2050471583,79038333,1.0670174955e-11,12171,1025456,1759735452
3386,2057208667,79362568,1.0713946679999999e-11,12171,1025456,1760760908
3387,2048805375,79038333,1.0670174955e-11,12171,1025456,1761786364
3388,2050165666,79038333,1.0670174955e-11,12171,1025456,1762811820
3389,2048730333,79038333,1.0670174955e-11,12171,1025456,1763837276
3390,2048781916,79038333,1.0670174955e-11,12171,1025456,1764862732
3391,2049431208,79362567,1.0713946545e-11,12108,1025456,1765888188
3392,2052606625,79038332,1.0670174819999999e-11,12129,1025456,1766913644
3393,2049581792,79038332,1.0670174819999999e-11,12129,1025456,1767939100
3394,2050110166,79038333,1.0670174955e-11,12150,1025456,1768964556
3395,2049989083,79362568,1.0713946679999999e-11,12150,1025456,1769990012
3396,2067757959,79038333,1.0670174955e-11,12150,1025456,1771015468
3397,2184627209,79038333,1.0670174955e-11,12150,1025456,1772040924
3398,2387743583,79038711,1.0670225984999999e-11,24436,1025904,1773066828
3399,2288523708,79038334,1.067017509e-11,12192,1025456,1774092284
3400,2401996583,79362569,1.0713946815e-11,12192,1025456,1775117740
3401,2555037916,79038328,1.0670174279999998e-11,11982,1025456,1776143196
3402,2378681959,79038329,1.0670174414999999e-11,12024,1025456,1777168652
3403,2477285209,79038330,1.067017455e-11,12066,1025456,1778194108
3404,2346614625,79038330,1.067017455e-11,12066,1025456,1779219564
3405,2388725125,79038330,1.067017455e-11,12066,1025456,1780245020
3406,2336963667,79038332,1.0670174819999999e-11,12108,1025456,1781270476
3407,2600109458,79038332,1.0670174819999999e-11,12108,1025456,1782295932
3408,2295725708,79038332,1.0670174819999999e-11,12108,1025456,1783321388
3409,2270357042,79038332,1.0670174819999999e-11,12108,1025456,1784346844
3410,2220995709,79038332,1.0670174819999999e-11,12108,1025456,1785372300
3411,5008336250,79394988,1.0718323379999998e-11,12045,1025456,1786397756
3412,2065877125,79038330,1.067017455e-11,12066,1025456,1787423212
3413,2051628875,79038330,1.067017455e-11,12066,1025456,1788448668
3414,2117489041,79038331,1.0670174685e-11,12087,1025456,1789474124
3415,2060221292,79038705,1.0670225174999999e-11,24241,1025904,1790500028
3416,2132790459,79362567,1.0713946545e-11,12129,1025456,1791525484
3417,2048436625,79038332,1.0670174819999999e-11,12129,1025456,1792550940
3418,2088139875,79038332,1.0670174819999999e-11,12129,1025456,1793576396
3419,2058162625,79038332,1.0670174819999999e-11,12129,1025456,1794601852
3420,2139173417,79362567,1.0713946545e-11,12129,1025456,1795627308
3421,2236758958,79038330,1.067017455e-11,12066,1025456,1796652764
3422,2271619750,79038331,1.0670174685e-11,12087,1025456,1797678220
3423,2306118334,79038332,1.0670174819999999e-11,12108,1025456,1798703676
3424,2387601375,79038332,1.0670174819999999e-11,12108,1025456,1799729132
3425,2376176625,79038332,1.0670174819999999e-11,12108,1025456,1800754588
3426,2753174334,79038332,1.0670174819999999e-11,12108,1025456,1801780044
3427,3673955166,79038332,1.0670174819999999e-11,12129,1025456,1802805500
3428,2668584041,79362567,1.0713946545e-11,12129,1025456,1803830956
3429,2300864083,79038332,1.0670174819999999e-11,12129,1025456,1804856412
3430,2308271208,79038332,1.0670174819999999e-11,12129,1025456,1805881868
3431,3046289917,79038330,1.067017455e-11,12066,1025456,1806907324
3432,2186531875,79362935,1.0713996224999998e-11,24088,1025904,1807933228
3433,2279730666,79038346,1.0670176709999999e-11,12592,1025456,1808958684
3434,2198798125,79038346,1.0670176709999999e-11,12592,1025456,1809984140
3435,3266393708,79362582,1.0713948569999999e-11,12613,1025456,1811009596
3436,2049956000,79038347,1.0670176845e-11,12613,1025456,1812035052
3437,2049597125,79038347,1.0670176845e-11,12613,1025456,1813060508
3438,2050402333,79038347,1.0670176845e-11,12613,1025456,1814085964
3439,2049458833,79038347,1.0670176845e-11,12613,1025456,1815111420
3440,2050697167,79362582,1.0713948569999999e-11,12613,1025456,1816136876
3441,2049299917,79038345,1.0670176575e-11,12550,1025456,1817162332
3442,2050621708,79038346,1.0670176709999999e-11,12571,1025456,1818187788
3443,2050345541,79038346,1.0670176709999999e-11,12571,1025456,1819213244
3444,2049628416,79038346,1.0670176709999999e-11,12592,1025456,1820238700
3445,2050094375,79362581,1.0713948435e-11,12592,1025456,1821264156
3446,2049116875,79038346,1.0670176709999999e-11,12592,1025456,1822289612
3447,2050036375,79038346,1.0670176709999999e-11,12592,1025456,1823315068
3448,2050402041,79038347,1.0670176845e-11,12613,1025456,1824340524
3449,2038558084,79039564,1.0670341139999999e-11,52151,1026708,1825367232
3450,2049897792,79362570,1.071394695e-11,12213,1025456,1826392688
3451,2050531917,79038332,1.0670174819999999e-11,12129,1025456,1827418144
3452,2049261959,79038333,1.0670174955e-11,12150,1025456,1828443600
3453,2052488791,79038333,1.0670174955e-11,12171,1025456,1829469056
3454,2047567959,79038333,1.0670174955e-11,12171,1025456,1830494512
3455,2076567125,79362568,1.0713946679999999e-11,12171,1025456,1831519968
3456,2218155041,79038334,1.067017509e-11,12192,1025456,1832545424
3457,2826221500,79038334,1.067017509e-11,12192,1025456,1833570880
3458,2389804166,79038334,1.067017509e-11,12192,1025456,1834596336
3459,2558262500,79362569,1.0713946815e-11,12192,1025456,1835621792
3460,2373917875,79038334,1.067017509e-11,12192,1025456,1836647248
3461,2484566083,79038332,1.0670174819999999e-11,12129,1025456,1837672704
3462,2346846125,79362568,1.0713946679999999e-11,12150,1025456,1838698160
3463,2601303917,79038333,1.0670174955e-11,12150,1025456,1839723616
3464,3773230333,79038333,1.0670174955e-11,12171,1025456,1840749072
3465,2456376583,79038333,1.0670174955e-11,12171,1025456,1841774528
3466,2223978750,79363000,1.0714005e-11,26173,1025904,1842800432
3467,2264582958,79038334,1.067017509e-11,12192,1025456,1843825888
3468,2267592417,79038334,1.067017509e-11,12192,1025456,1844851344
3469,2476524792,79038334,1.067017509e-11,12192,1025456,1845876800
3470,2240191875,79362570,1.071394695e-11,12213,1025456,1846902256
3471,2050231292,79038332,1.0670174819999999e-11,12129,1025456,1847927712
3472,2051574458,79038333,1.0670174955e-11,12150,1025456,1848953168
3473,2049653541,79038333,1.0670174955e-11,12171,1025456,1849978624
3474,2055094334,79362568,1.0713946679999999e-11,12171,1025456,1851004080
3475,2091607709,79038333,1.0670174955e-11,12171,1025456,1852029536
3476,2056407458,79038333,1.0670174955e-11,12171,1025456,1853054992
3477,2098386417,79038334,1.067017509e-11,12192,1025456,1854080448
3478,2059082541,79038334,1.067017509e-11,12192,1025456,1855105904
3479,2090996709,79362569,1.0713946815e-11,12192,1025456,1856131360
3480,2057729000,79038334,1.067017509e-11,12192,1025456,1857156816
3481,2093348000,79038332,1.0670174819999999e-11,12129,1025456,1858182272
3482,2068166709,79038333,1.0670174955e-11,12150,1025456,1859207728
3483,2075950958,79038760,1.0670232599999999e-11,26020,1025904,1860233632
3484,2055777125,79362569,1.0713946815e-11,12192,1025456,1861259088
3485,2092938958,79038335,1.0670175224999999e-11,12213,1025456,1862284544
3486,2057432458,79038335,1.0670175224999999e-11,12213,1025456,1863310000
3487,2093203834,79038335,1.0670175224999999e-11,12213,1025456,1864335456
3488,2069579375,79038335,1.0670175224999999e-11,12213,1025456,1865360912
3489,2073295583,79362570,1.071394695e-11,12213,1025456,1866386368
3490,2059511042,79038335,1.0670175224999999e-11,12213,1025456,1867411824
3491,2093215916,79038333,1.0670174955e-11,12150,1025456,1868437280
3492,2067787292,79038333,1.0670174955e-11,12171,1025456,1869462736
3493,2080960542,79038333,1.0670174955e-11,12171,1025456,1870488192
3494,2058065417,79362569,1.0713946815e-11,12192,1025456,1871513648
3495,2093089500,79038334,1.067017509e-11,12192,1025456,1872539104
3496,2055150125,79038334,1.067017509e-11,12192,1025456,1873564560
3497,2274548459,79038334,1.067017509e-11,12192,1025456,1874590016
3498,2145619750,79362570,1.071394695e-11,12213,1025456,1875615472
3499,2773728500,79038335,1.0670175224999999e-11,12213,1025456,1876640928
3500,2222288875,79038757,1.0670232194999999e-11,25951,1025904,1877666832
3501,2833406042,79038329,1.0670174414999999e-11,12003,1025456,1878692288
3502,2154026166,79362565,1.0713946274999999e-11,12045,1025456,1879717744
3503,2459395458,79038331,1.0670174685e-11,12087,1025456,1880743200
3504,2424296250,79038331,1.0670174685e-11,12087,1025456,1881768656
3505,2528212000,79038331,1.0670174685e-11,12087,1025456,1882794112
3506,2549608750,79362567,1.0713946545e-11,12129,1025456,1883819568
3507,2334474625,79038332,1.0670174819999999e-11,12129,1025456,1884845024
3508,2310019167,79038332,1.0670174819999999e-11,12129,1025456,1885870480
3509,2307731583,79038332,1.0670174819999999e-11,12129,1025456,1886895936
3510,2153659916,79362567,1.0713946545e-11,12129,1025456,1887921392
3511,2616266625,79038330,1.067017455e-11,12066,1025456,1888946848
3512,2058087916,79038331,1.0670174685e-11,12087,1025456,1889972304
3513,2082891917,79038331,1.0670174685e-11,12087,1025456,1890997760
3514,2058934166,79362567,1.0713946545e-11,12108,1025456,1892023216
3515,2126559541,79038332,1.0670174819999999e-11,12108,1025456,1893048672
3516,2036161250,79038332,1.0670174819999999e-11,12129,1025456,1894074128
3517,2095035750,79038751,1.0670231384999999e-11,25735,1025904,1895100032
3518,2058683583,79038333,1.0670174955e-11,12171,1025456,1896125488
3519,2127800791,79362569,1.0713946815e-11,12192,1025456,1897150944
3520,2063328959,79038334,1.067017509e-11,12192,1025456,1898176400
3521,2113504917,79038332,1.0670174819999999e-11,12108,1025456,1899201856
3522,2078835917,79038332,1.0670174819999999e-11,12129,1025456,1900227312
3523,2867581541,79362568,1.0713946679999999e-11,12150,1025456,1901252768
3524,2349207042,79038333,1.0670174955e-11,12150,1025456,1902278224
3525,2591591917,79038333,1.0670174955e-11,12150,1025456,1903303680
3526,2299937583,79038333,1.0670174955e-11,12150,1025456,1904329136
3527,2388508834,79362568,1.0713946679999999e-11,12171,1025456,1905354592
3528,2612913875,79038333,1.0670174955e-11,12171,1025456,1906380048
3529,2266920292,79038333,1.0670174955e-11,12171,1025456,1907405504
3530,2493210625,79038333,1.0670174955e-11,12171,1025456,1908430960
3531,2396552333,79362567,1.0713946545e-11,12108,1025456,1909456416
3532,74131596709,79038332,1.0670174819999999e-11,12129,1025456,1910481872
3533,17682179792,81794331,1.1042234684999998e-11,12129,1025456,1911507328
3534,2061744375,79038747,1.0670230845e-11,25603,1025904,1912533232
3535,2064859375,79362569,1.0713946815e-11,12192,1025456,1913558688
3536,2068858542,79038334,1.067017509e-11,12192,1025456,1914584144
3537,2054434208,79038334,1.067017509e-11,12192,1025456,1915609600
3538,2057512625,79038334,1.067017509e-11,12192,1025456,1916635056
3539,2074970459,79038334,1.067017509e-11,12192,1025456,1917660512
3540,2056839500,79362569,1.0713946815e-11,12192,1025456,1918685968
3541,2072649375,79038332,1.0670174819999999e-11,12129,1025456,1919711424
3542,2060091209,79038333,1.0670174955e-11,12150,1025456,1920736880
3543,2203518375,79038333,1.0670174955e-11,12150,1025456,1921762336
3544,2238159542,79362568,1.0713946679999999e-11,12171,1025456,1922787792
3545,2345024417,79038333,1.0670174955e-11,12171,1025456,1923813248
3546,2403236000,79038333,1.0670174955e-11,12171,1025456,1924838704
3547,2800255208,79038333,1.0670174955e-11,12171,1025456,1925864160
3548,108476630459,271726326,3.6683054009999995e-11,12192,-108832900,1817031260
3549,2063442208,79379199,1.0716191865e-11,12192,1025456,1818056716
3550,2050673292,79038334,1.067017509e-11,12192,1025456,1819082172
3551,2056051042,79038742,1.0670230169999999e-11,25450,1025904,1820108076
3552,2051503666,79038333,1.0670174955e-11,12150,1025456,1821133532
3553,2049127000,79038333,1.0670174955e-11,12171,1025456,1822158988
3554,2070931417,79379198,1.0716191729999999e-11,12171,1025456,1823184444
3555,2063177625,79038334,1.067017509e-11,12192,1025456,1824209900
3556,2049907625,79038334,1.067017509e-11,12192,1025456,1825235356
3557,2051515666,79038334,1.067017509e-11,12192,1025456,1826260812
3558,2055685833,79038334,1.067017509e-11,12192,1025456,1827286268
3559,2064159834,79379199,1.0716191865e-11,12192,1025456,1828311724
3560,2053187042,79038334,1.067017509e-11,12192,1025456,1829337180
3561,2577817291,79038332,1.0670174819999999e-11,12129,1025456,1830362636
3562,2394798792,79038333,1.0670174955e-11,12150,1025456,1831388092
3563,2617442917,79379198,1.0716191729999999e-11,12150,1025456,1832413548
3564,2340754666,79038333,1.0670174955e-11,12171,1025456,1833439004
3565,2386118625,79038333,1.0670174955e-11,12171,1025456,1834464460
3566,2498944583,79038333,1.0670174955e-11,12171,1025456,1835489916
3567,2302001125,79379198,1.0716191729999999e-11,12171,1025456,1836515372
3568,2356528833,79038740,1.0670229899999999e-11,25381,1025904,1837541276
3569,2610974500,79038335,1.0670175224999999e-11,12213,1025456,1838566732
3570,2595092709,79038335,1.0670175224999999e-11,12213,1025456,1839592188
3571,2255573750,79379197,1.0716191595e-11,12129,1025456,1840617644
3572,2220868833,79038333,1.0670174955e-11,12150,1025456,1841643100
3573,2338451875,79038333,1.0670174955e-11,12171,1025456,1842668556
3574,3315624583,79038333,1.0670174955e-11,12171,1025456,1843694012
3575,2050789917,79413284,1.0720793339999999e-11,12171,1025456,1844719468
3576,2049191417,79038334,1.067017509e-11,12192,1025456,1845744924
3577,2050120416,79038334,1.067017509e-11,12192,1025456,1846770380
3578,2043568333,79038334,1.067017509e-11,12192,1025456,1847795836
3579,2086932125,79038334,1.067017509e-11,12192,1025456,1848821292
3580,2057908375,79379199,1.0716191865e-11,12192,1025456,1849846748
3581,2093894958,79038332,1.0670174819999999e-11,12129,1025456,1850872204
3582,2069393333,79038333,1.0670174955e-11,12150,1025456,1851897660
3583,2071717125,79038333,1.0670174955e-11,12150,1025456,1852923116
3584,2059185792,79379198,1.0716191729999999e-11,12171,1025456,1853948572
3585,2088200541,79038736,1.0670229359999998e-11,25249,1025904,1854974476
3586,2058893375,79038334,1.067017509e-11,12192,1025456,1855999932
3587,2092560167,79038334,1.067017509e-11,12192,1025456,1857025388
3588,2058029125,79038334,1.067017509e-11,12192,1025456,1858050844
3589,2094460667,79379199,1.0716191865e-11,12192,1025456,1859076300
3590,2067907292,79038334,1.067017509e-11,12192,1025456,1860101756
3591,2087396792,79038332,1.0670174819999999e-11,12129,1025456,1861127212
3592,2066693708,79038333,1.0670174955e-11,12150,1025456,1862152668
3593,2081012083,79038333,1.0670174955e-11,12171,1025456,1863178124
3594,2055046542,79379198,1.0716191729999999e-11,12171,1025456,1864203580
3595,2272077417,79038333,1.0670174955e-11,12171,1025456,1865229036
3596,2792247666,79038333,1.0670174955e-11,12171,1025456,1866254492
3597,2277988292,79038334,1.067017509e-11,12192,1025456,1867279948
3598,2293195875,79379199,1.0716191865e-11,12192,1025456,1868305404
3599,2267657291,79038334,1.067017509e-11,12192,1025456,1869330860
3600,2245882958,79038334,1.067017509e-11,12192,1025456,1870356316
3601,2375740542,79038329,1.0670174414999999e-11,12003,1025456,1871381772
3602,2641199417,79379592,1.071624492e-11,24949,1025904,1872407676
3603,2320983333,79038331,1.0670174685e-11,12087,1025456,1873433132
3604,2411042375,79038331,1.0670174685e-11,12087,1025456,1874458588
3605,2454025416,79038332,1.0670174819999999e-11,12129,1025456,1875484044
3606,2411986584,79379197,1.0716191595e-11,12129,1025456,1876509500
3607,2691508000,79038332,1.0670174819999999e-11,12129,1025456,1877534956
3608,2590588709,79038332,1.0670174819999999e-11,12129,1025456,1878560412
3609,2307847959,79038332,1.0670174819999999e-11,12129,1025456,1879585868
3610,3268153750,79379197,1.0716191595e-11,12129,1025456,1880611324
3611,2105232875,79038330,1.067017455e-11,12066,1025456,1881636780
3612,2057012375,79038331,1.0670174685e-11,12087,1025456,1882662236
3613,2124621541,79038331,1.0670174685e-11,12087,1025456,1883687692
3614,2055632417,79379197,1.0716191595e-11,12129,1025456,1884713148
3615,2098475667,79038332,1.0670174819999999e-11,12129,1025456,1885738604
3616,2075220709,79038332,1.0670174819999999e-11,12129,1025456,1886764060
3617,2102183584,79038332,1.0670174819999999e-11,12129,1025456,1887789516
3618,2056100167,79038333,1.0670174955e-11,12150,1025456,1888814972
3619,2095861209,79379592,1.071624492e-11,24964,1025904,1889840876
3620,2057475292,79038334,1.067017509e-11,12192,1025456,1890866332
3621,2104740292,79038332,1.0670174819999999e-11,12108,1025456,1891891788
3622,2047395042,79038332,1.0670174819999999e-11,12129,1025456,1892917244
3623,2157925042,79379198,1.0716191729999999e-11,12150,1025456,1893942700
3624,2124123416,79038333,1.0670174955e-11,12150,1025456,1894968156
3625,2968300333,79038333,1.0670174955e-11,12150,1025456,1895993612
3626,2160554708,79038333,1.0670174955e-11,12171,1025456,1897019068
3627,2352615917,79379198,1.0716191729999999e-11,12171,1025456,1898044524
3628,2394130250,79038333,1.0670174955e-11,12171,1025456,1899069980
3629,2328734833,79038333,1.0670174955e-11,12171,1025456,1900095436
3630,2371389166,79038333,1.0670174955e-11,12171,1025456,1901120892
3631,2288754417,79379197,1.0716191595e-11,12108,1025456,1902146348
3632,2501862875,79038332,1.0670174819999999e-11,12129,1025456,1903171804
3633,2400136125,79038332,1.0670174819999999e-11,12129,1025456,1904197260
3634,2447327083,79038333,1.0670174955e-11,12150,1025456,1905222716
3635,2205299084,79379198,1.0716191729999999e-11,12150,1025456,1906248172
3636,2209398250,79038723,1.0670227604999999e-11,24832,1025904,1907274076
3637,5188378708,79038333,1.0670174955e-11,12171,1025456,1908299532
3638,2051629666,79379198,1.0716191729999999e-11,12171,1025456,1909324988
3639,2047342792,79038333,1.0670174955e-11,12171,1025456,1910350444
3640,2087592208,79038334,1.067017509e-11,12192,1025456,1911375900
3641,2111523125,79038332,1.0670174819999999e-11,12108,1025456,1912401356
3642,2053787667,79038332,1.0670174819999999e-11,12129,1025456,1913426812
3643,2124286125,79379198,1.0716191729999999e-11,12150,1025456,1914452268
3644,2080711666,79038333,1.0670174955e-11,12150,1025456,1915477724
3645,2112565875,79038333,1.0670174955e-11,12150,1025456,1916503180
3646,2088503458,79038333,1.0670174955e-11,12150,1025456,1917528636
3647,2223180875,79379198,1.0716191729999999e-11,12171,1025456,1918554092
3648,2318786250,79038333,1.0670174955e-11,12171,1025456,1919579548
3649,2865058542,79038333,1.0670174955e-11,12171,1025456,1920605004
3650,2252065208,79038333,1.0670174955e-11,12171,1025456,1921630460
3651,2385731959,79379197,1.0716191595e-11,12108,1025456,1922655916
3652,90196309625,79038332,1.0670174819999999e-11,12129,1025456,1923681372
3653,11083973250,82345107,1.1116589445e-11,24679,1025904,1924707276
3654,2056246625,79038333,1.0670174955e-11,12171,1025456,1925732732
3655,2066718667,79038334,1.067017509e-11,12192,1025456,1926758188
3656,2052637500,79379199,1.0716191865e-11,12192,1025456,1927783644
3657,2058575792,79038334,1.067017509e-11,12192,1025456,1928809100
3658,2072460916,79038334,1.067017509e-11,12192,1025456,1929834556
3659,2057582875,79038334,1.067017509e-11,12192,1025456,1930860012
3660,2074033333,79038334,1.067017509e-11,12192,1025456,1931885468
3661,2063750250,79379197,1.0716191595e-11,12129,1025456,1932910924
3662,2058374708,79038333,1.0670174955e-11,12150,1025456,1933936380
3663,2057354791,79038333,1.0670174955e-11,12150,1025456,1934961836
3664,2054095292,79038333,1.0670174955e-11,12171,1025456,1935987292
3665,2060496459,79038333,1.0670174955e-11,12171,1025456,1937012748
3666,2089244625,79379198,1.0716191729999999e-11,12171,1025456,1938038204
3667,2109620542,79038333,1.0670174955e-11,12171,1025456,1939063660
3668,2476708542,79038334,1.067017509e-11,12192,1025456,1940089116
3669,2141213500,79038334,1.067017509e-11,12192,1025456,1941114572
3670,2622754708,79379581,1.0716243435e-11,24610,1025904,1942140476
3671,2172611417,79038332,1.0670174819999999e-11,12129,1025456,1943165932
3672,2243279625,79038333,1.0670174955e-11,12150,1025456,1944191388
3673,2241640750,79038333,1.0670174955e-11,12171,1025456,1945216844
3674,2316666208,79038333,1.0670174955e-11,12171,1025456,1946242300
3675,2450379875,79379198,1.0716191729999999e-11,12171,1025456,1947267756
3676,2774045583,79038334,1.067017509e-11,12192,1025456,1948293212
3677,3695481959,79038334,1.067017509e-11,12192,1025456,1949318668
3678,2261928000,79379199,1.0716191865e-11,12192,1025456,1950344124
3679,2126830917,79038334,1.067017509e-11,12192,1025456,1951369580
3680,2291697042,79038334,1.067017509e-11,12192,1025456,1952395036
3681,2299245959,79038332,1.0670174819999999e-11,12129,1025456,1953420492
3682,2055802208,79379198,1.0716191729999999e-11,12150,1025456,1954445948
3683,2051997958,79038333,1.0670174955e-11,12150,1025456,1955471404
3684,2050094666,79038333,1.0670174955e-11,12171,1025456,1956496860
3685,2050972125,79038333,1.0670174955e-11,12171,1025456,1957522316
3686,2060441333,79038333,1.0670174955e-11,12171,1025456,1958547772
3687,2066144375,79379577,1.0716242894999999e-11,24457,1025904,1959573676
3688,2104355833,79038334,1.067017509e-11,12192,1025456,1960599132
3689,2050711583,79038335,1.0670175224999999e-11,12213,1025456,1961624588
3690,2055448125,79038335,1.0670175224999999e-11,12213,1025456,1962650044
3691,2050094417,79379197,1.0716191595e-11,12129,1025456,1963675500
3692,2053189250,79038333,1.0670174955e-11,12150,1025456,1964700956
3693,2051738042,79038333,1.0670174955e-11,12171,1025456,1965726412
3694,2061940041,79038333,1.0670174955e-11,12171,1025456,1966751868
3695,2145158208,79038333,1.0670174955e-11,12171,1025456,1967777324
3696,2447409459,79379198,1.0716191729999999e-11,12171,1025456,1968802780
3697,2353944833,79038334,1.067017509e-11,12192,1025456,1969828236
3698,2622310750,79038334,1.067017509e-11,12192,1025456,1970853692
3699,2581759708,79038334,1.067017509e-11,12192,1025456,1971879148
3700,2383764416,79379199,1.0716191865e-11,12192,1025456,1972904604
3701,2145674917,79038329,1.0670174414999999e-11,12003,1025456,1973930060
3702,2574578041,79038330,1.067017455e-11,12045,1025456,1974955516
3703,2346818959,79038330,1.067017455e-11,12045,1025456,1975980972
3704,2786148625,79379569,1.0716241815e-11,24199,1025904,1977006876
3705,2388816625,79038332,1.0670174819999999e-11,12129,1025456,1978032332
3706,2477013208,79038332,1.0670174819999999e-11,12129,1025456,1979057788
3707,2810292541,79038332,1.0670174819999999e-11,12129,1025456,1980083244
3708,2184281958,79038332,1.0670174819999999e-11,12129,1025456,1981108700
3709,88883506500,279660996,3.775423446e-11,12129,-81624884,1899483816
3710,2061727666,79038332,1.0670174819999999e-11,12129,1025456,1900509272
3711,2056829750,79038330,1.067017455e-11,12066,1025456,1901534728
3712,2053175625,79391724,1.0717882739999999e-11,12108,1025456,1902560184
3713,2057780875,79038332,1.0670174819999999e-11,12108,1025456,1903585640
3714,2060835625,79038332,1.0670174819999999e-11,12129,1025456,1904611096
3715,2061311875,79038332,1.0670174819999999e-11,12129,1025456,1905636552
3716,2075420625,79038332,1.0670174819999999e-11,12129,1025456,1906662008
3717,2053802084,79391724,1.0717882739999999e-11,12129,1025456,1907687464
3718,2051762583,79038333,1.0670174955e-11,12150,1025456,1908712920
3719,2051345125,79038333,1.0670174955e-11,12150,1025456,1909738376
3720,2067956250,79038333,1.0670174955e-11,12150,1025456,1910763832
3721,2113607625,79038700,1.0670224499999999e-11,24088,1025904,1911789736
3722,2315383083,79391738,1.0717884629999999e-11,12592,1025456,1912815192
3723,2203500625,79038347,1.0670176845e-11,12613,1025456,1913840648
3724,2272030209,79038347,1.0670176845e-11,12613,1025456,1914866104
3725,2205062041,79038348,1.067017698e-11,12634,1025456,1915891560
3726,2384770583,79391740,1.07178849e-11,12634,1025456,1916917016
3727,2335528500,79038348,1.067017698e-11,12634,1025456,1917942472
3728,2199342084,79038348,1.067017698e-11,12634,1025456,1918967928
3729,2297025459,79038348,1.067017698e-11,12634,1025456,1919993384
3730,2367472583,79391740,1.07178849e-11,12634,1025456,1921018840
3731,2401637958,79038346,1.0670176709999999e-11,12571,1025456,1922044296
3732,2220656166,79038346,1.0670176709999999e-11,12592,1025456,1923069752
3733,2348908292,79038346,1.0670176709999999e-11,12592,1025456,1924095208
3734,2489336125,79391739,1.0717884765e-11,12613,1025456,1925120664
3735,2552748792,79038347,1.0670176845e-11,12613,1025456,1926146120
3736,3251808334,79038347,1.0670176845e-11,12613,1025456,1927171576
3737,2123567917,79038347,1.0670176845e-11,12613,1025456,1928197032
3738,2079248209,79392952,1.071804852e-11,52019,1026708,1929223740
3739,2105855083,79038335,1.0670175224999999e-11,12213,1025456,1930249196
3740,2064037542,79038335,1.0670175224999999e-11,12213,1025456,1931274652
3741,2124824334,79038332,1.0670174819999999e-11,12129,1025456,1932300108
3742,2086271000,79391725,1.0717882875e-11,12150,1025456,1933325564
3743,2118899333,79038333,1.0670174955e-11,12171,1025456,1934351020
3744,2091008917,79038333,1.0670174955e-11,12171,1025456,1935376476
3745,2194548875,79038333,1.0670174955e-11,12171,1025456,1936401932
3746,2487395708,79038334,1.067017509e-11,12192,1025456,1937427388
3747,2288746042,79391726,1.0717883009999999e-11,12192,1025456,1938452844
3748,2375041667,79038334,1.067017509e-11,12192,1025456,1939478300
3749,2645737959,79038334,1.067017509e-11,12192,1025456,1940503756
3750,2254519625,79038334,1.067017509e-11,12192,1025456,1941529212
3751,2378707583,79391724,1.0717882739999999e-11,12129,1025456,1942554668
3752,2501272334,79038333,1.0670174955e-11,12150,1025456,1943580124
3753,2527893500,79038333,1.0670174955e-11,12150,1025456,1944605580
3754,2393009208,79038333,1.0670174955e-11,12171,1025456,1945631036
3755,2284222833,79392157,1.0717941194999999e-11,26173,1025904,1946656940
3756,2446365667,79038334,1.067017509e-11,12192,1025456,1947682396
3757,2432751417,79038334,1.067017509e-11,12192,1025456,1948707852
3758,2420706958,79038334,1.067017509e-11,12192,1025456,1949733308
3759,41142257667,79391726,1.0717883009999999e-11,12192,1025456,1950758764
3760,40844151958,81618100,1.10184435e-11,12192,1025456,1951784220
3761,2065316792,79038332,1.0670174819999999e-11,12129,1025456,1952809676
3762,2056930334,79391725,1.0717882875e-11,12150,1025456,1953835132
3763,2057976542,79038333,1.0670174955e-11,12171,1025456,1954860588
3764,2062085750,79038333,1.0670174955e-11,12171,1025456,1955886044
3765,2052060166,79038333,1.0670174955e-11,12171,1025456,1956911500
3766,2058373458,79391725,1.0717882875e-11,12171,1025456,1957936956
3767,2072012125,79038334,1.067017509e-11,12192,1025456,1958962412
3768,2070497708,79038334,1.067017509e-11,12192,1025456,1959987868
3769,2077864666,79038334,1.067017509e-11,12192,1025456,1961013324
3770,2129570708,79038334,1.067017509e-11,12192,1025456,1962038780
3771,2194929125,79038332,1.0670174819999999e-11,12129,1025456,1963064236
3772,2355877125,79038759,1.0670232464999998e-11,25999,1025904,1964090140
3773,2342558959,79038334,1.067017509e-11,12192,1025456,1965115596
3774,2287018125,79038334,1.067017509e-11,12192,1025456,1966141052
3775,2216901292,79391727,1.0717883144999999e-11,12213,1025456,1967166508
3776,2280690667,79038335,1.0670175224999999e-11,12213,1025456,1968191964
3777,2214995083,79038335,1.0670175224999999e-11,12213,1025456,1969217420
3778,2385045750,79038335,1.0670175224999999e-11,12213,1025456,1970242876
3779,2507332959,79391727,1.0717883144999999e-11,12213,1025456,1971268332
3780,2299827000,79038335,1.0670175224999999e-11,12213,1025456,1972293788
3781,2625242333,79038333,1.0670174955e-11,12150,1025456,1973319244
3782,2309255917,79038333,1.0670174955e-11,12171,1025456,1974344700
3783,2552389500,79391725,1.0717882875e-11,12171,1025456,1975370156
3784,2273388583,79038334,1.067017509e-11,12192,1025456,1976395612
3785,3279181666,79038334,1.067017509e-11,12192,1025456,1977421068
3786,2052917042,79038334,1.067017509e-11,12192,1025456,1978446524
3787,2059457166,79391726,1.0717883009999999e-11,12192,1025456,1979471980
3788,2055508792,79038335,1.0670175224999999e-11,12213,1025456,1980497436
3789,2061773541,79038757,1.0670232194999999e-11,25951,1025904,1981523340
3790,2054339959,79038336,1.0670175359999998e-11,12234,1025456,1982548796
3791,2048452542,79038333,1.0670174955e-11,12150,1025456,1983574252
3792,2051055250,79391725,1.0717882875e-11,12171,1025456,1984599708
3793,2038104875,79038334,1.067017509e-11,12192,1025456,1985625164
3794,2129319958,79038334,1.067017509e-11,12192,1025456,1986650620
3795,2067178833,79038334,1.067017509e-11,12192,1025456,1987676076
3796,2606940125,79391727,1.0717883144999999e-11,12213,1025456,1988701532
3797,2422935500,79038335,1.0670175224999999e-11,12213,1025456,1989726988
3798,2581716792,79038335,1.0670175224999999e-11,12213,1025456,1990752444
3799,2455221125,79038335,1.0670175224999999e-11,12213,1025456,1991777900
3800,2274832500,79391727,1.0717883144999999e-11,12213,1025456,1992803356
3801,2221075709,79038329,1.0670174414999999e-11,12003,1025456,1993828812
3802,2303135042,79038330,1.067017455e-11,12045,1025456,1994854268
3803,2413309916,79038330,1.067017455e-11,12045,1025456,1995879724
3804,2243700000,79391723,1.0717882604999998e-11,12087,1025456,1996905180
3805,2216410958,79038331,1.0670174685e-11,12087,1025456,1997930636
3806,2260383667,79038750,1.0670231249999998e-11,25693,1025904,1998956540
3807,2289833917,79038332,1.0670174819999999e-11,12129,1025456,1999981996
3808,2210634042,79038332,1.0670174819999999e-11,12129,1025456,2001007452
3809,2230514000,79038332,1.0670174819999999e-11,12129,1025456,2002032908
3810,2221372000,79038333,1.0670174955e-11,12171,1025456,2003058364
3811,4868124959,79391723,1.0717882604999998e-11,12087,1025456,2004083820
3812,2071605417,79038332,1.0670174819999999e-11,12108,1025456,2005109276
3813,2052449334,79038332,1.0670174819999999e-11,12129,1025456,2006134732
3814,2051661416,79038332,1.0670174819999999e-11,12129,1025456,2007160188
3815,2069224709,79038332,1.0670174819999999e-11,12129,1025456,2008185644
3816,2068679084,79391724,1.0717882739999999e-11,12129,1025456,2009211100
3817,2053237292,79038333,1.0670174955e-11,12150,1025456,2010236556
3818,2050883417,79038333,1.0670174955e-11,12150,1025456,2011262012
3819,2051493916,79038333,1.0670174955e-11,12150,1025456,2012287468
3820,2051502042,79038333,1.0670174955e-11,12150,1025456,2013312924
3821,2050467250,79391723,1.0717882604999998e-11,12087,1025456,2014338380
3822,2052182209,79038332,1.0670174819999999e-11,12108,1025456,2015363836
3823,2052495417,79038746,1.0670230709999999e-11,25582,1025904,2016389740
3824,2333802000,79038333,1.0670174955e-11,12150,1025456,2017415196
3825,2970284125,79391725,1.0717882875e-11,12171,1025456,2018440652
3826,2630756458,79038333,1.0670174955e-11,12171,1025456,2019466108
3827,2124056500,79038333,1.0670174955e-11,12171,1025456,2020491564
3828,2347251916,79038333,1.0670174955e-11,12171,1025456,2021517020
3829,130949803292,287765435,3.8848333724999994e-11,12171,-60577640,1960939380
3830,2059678334,79400991,1.0719133785e-11,12171,1025456,1961964836
3831,2070941166,79038332,1.0670174819999999e-11,12108,1025456,1962990292
3832,2053295541,79038332,1.0670174819999999e-11,12129,1025456,1964015748
3833,2075504500,79038332,1.0670174819999999e-11,12129,1025456,1965041204
3834,2053300459,79038333,1.0670174955e-11,12150,1025456,1966066660
3835,2117732292,79400991,1.0719133785e-11,12150,1025456,1967092116
3836,2093143917,79038333,1.0670174955e-11,12150,1025456,1968117572
3837,2248877291,79038333,1.0670174955e-11,12150,1025456,1969143028
3838,2297071917,79038333,1.0670174955e-11,12171,1025456,1970168484
3839,2182700500,79400991,1.0719133785e-11,12171,1025456,1971193940
3840,3059875708,79038744,1.067023044e-11,25513,1025904,1972219844
3841,2138503417,79038332,1.0670174819999999e-11,12129,1025456,1973245300
3842,3140777750,79038333,1.0670174955e-11,12150,1025456,1974270756
3843,2298814125,79400991,1.0719133785e-11,12171,1025456,1975296212
3844,2807998916,79038333,1.0670174955e-11,12171,1025456,1976321668
3845,2308753792,79038333,1.0670174955e-11,12171,1025456,1977347124
3846,3080018958,79038334,1.067017509e-11,12192,1025456,1978372580
3847,89409512916,82374791,1.1120596784999999e-11,12192,1025456,1979398036
3848,2051549792,79038334,1.067017509e-11,12192,1025456,1980423492
3849,2050954500,79400992,1.071913392e-11,12192,1025456,1981448948
3850,2046821333,79038334,1.067017509e-11,12192,1025456,1982474404
3851,2104435084,79038332,1.0670174819999999e-11,12129,1025456,1983499860
3852,2058523000,79038333,1.0670174955e-11,12150,1025456,1984525316
3853,2097057292,79038333,1.0670174955e-11,12150,1025456,1985550772
3854,2068992584,79400991,1.0719133785e-11,12171,1025456,1986576228
3855,2517834583,79038333,1.0670174955e-11,12171,1025456,1987601684
3856,2676415667,79038333,1.0670174955e-11,12171,1025456,1988627140
3857,2585276667,79038740,1.0670229899999999e-11,25381,1025904,1989653044
3858,2359462833,79400992,1.071913392e-11,12192,1025456,1990678500
3859,2547054542,79038335,1.0670175224999999e-11,12213,1025456,1991703956
3860,2467654541,79038335,1.0670175224999999e-11,12213,1025456,1992729412
3861,2517184375,79038332,1.0670174819999999e-11,12129,1025456,1993754868
3862,2229417417,79038333,1.0670174955e-11,12150,1025456,1994780324
3863,2962465375,79038333,1.0670174955e-11,12171,1025456,1995805780
3864,2235707584,79038333,1.0670174955e-11,12171,1025456,1996831236
3865,2311683541,79038333,1.0670174955e-11,12171,1025456,1997856692
3866,2261367083,79400991,1.0719133785e-11,12171,1025456,1998882148
3867,2232087667,79038334,1.067017509e-11,12192,1025456,1999907604
3868,2305621459,79038334,1.067017509e-11,12192,1025456,2000933060
3869,2122422834,79038334,1.067017509e-11,12192,1025456,2001958516
3870,3266514833,79473524,1.072892574e-11,12192,1025456,2002983972
3871,2050391250,79038332,1.0670174819999999e-11,12129,1025456,2004009428
3872,2052073167,79038333,1.0670174955e-11,12150,1025456,2005034884
3873,2051860667,79038333,1.0670174955e-11,12150,1025456,2006060340
3874,2052191000,79038735,1.0670229225e-11,25228,1025904,2007086244
3875,2051270417,79400992,1.071913392e-11,12192,1025456,2008111700
3876,2049161209,79038334,1.067017509e-11,12192,1025456,2009137156
3877,2069403333,79038334,1.067017509e-11,12192,1025456,2010162612
3878,2052352875,79038334,1.067017509e-11,12192,1025456,2011188068
3879,2111640958,79038334,1.067017509e-11,12192,1025456,2012213524
3880,2052321875,79400992,1.071913392e-11,12192,1025456,2013238980
3881,2108140000,79038332,1.0670174819999999e-11,12129,1025456,2014264436
3882,2052116542,79038333,1.0670174955e-11,12150,1025456,2015289892
3883,2119094833,79038333,1.0670174955e-11,12150,1025456,2016315348
3884,2049211833,79038333,1.0670174955e-11,12171,1025456,2017340804
3885,2109782625,79400991,1.0719133785e-11,12171,1025456,2018366260
3886,2050703375,79038333,1.0670174955e-11,12171,1025456,2019391716
3887,2113510542,79038333,1.0670174955e-11,12171,1025456,2020417172
3888,2051667500,79038334,1.067017509e-11,12192,1025456,2021442628
3889,2113169125,79038334,1.067017509e-11,12192,1025456,2022468084
3890,2056860333,79400992,1.071913392e-11,12192,1025456,2023493540
3891,2137037666,79038730,1.067022855e-11,25054,1025904,2024519444
3892,2118985459,79038333,1.0670174955e-11,12150,1025456,2025544900
3893,2876557583,79038333,1.0670174955e-11,12171,1025456,2026570356
3894,2121039750,79400991,1.0719133785e-11,12171,1025456,2027595812
3895,2284506792,79038334,1.067017509e-11,12192,1025456,2028621268
3896,2260392792,79038334,1.067017509e-11,12192,1025456,2029646724
3897,2472041500,79038334,1.067017509e-11,12192,1025456,2030672180
3898,2426424500,79400992,1.071913392e-11,12192,1025456,2031697636
3899,2336011209,79038334,1.067017509e-11,12192,1025456,2032723092
3900,3962627542,79038334,1.067017509e-11,12192,1025456,2033748548
3901,2627572209,79400987,1.0719133244999999e-11,12003,1025456,2034774004
3902,3513420709,79038330,1.067017455e-11,12045,1025456,2035799460
3903,2358552750,79038330,1.067017455e-11,12045,1025456,2036824916
3904,2293355250,79038331,1.0670174685e-11,12087,1025456,2037850372
3905,2296179959,79400989,1.0719133515e-11,12087,1025456,2038875828
3906,3279843709,79038331,1.0670174685e-11,12087,1025456,2039901284
3907,2048803667,79038331,1.0670174685e-11,12087,1025456,2040926740
3908,2049108459,79038725,1.0670227874999999e-11,24901,1025904,2041952644
3909,2053598958,79400991,1.0719133785e-11,12171,1025456,2042978100
3910,2050257750,79038333,1.0670174955e-11,12171,1025456,2044003556
3911,2050408500,79038331,1.0670174685e-11,12087,1025456,2045029012
3912,2051101000,79038332,1.0670174819999999e-11,12108,1025456,2046054468
3913,2050411375,79038332,1.0670174819999999e-11,12129,1025456,2047079924
3914,73306260291,79400990,1.0719133649999999e-11,12129,1025456,2048105380
3915,8563100042,81613207,1.1017782945e-11,12129,1025456,2049130836
3916,2049626917,79400991,1.0719133785e-11,12150,1025456,2050156292
3917,2055382333,79038333,1.0670174955e-11,12150,1025456,2051181748
3918,2066884291,79038333,1.0670174955e-11,12150,1025456,2052207204
3919,130245759958,292762322,3.9522913469999996e-11,12150,-45176444,2007030760
3920,2051560875,79038333,1.0670174955e-11,12150,1025456,2008056216
3921,2064051792,79038331,1.0670174685e-11,12087,1025456,2009081672
3922,2076962916,79038332,1.0670174819999999e-11,12108,1025456,2010107128
3923,2049796000,79407979,1.0720077164999998e-11,12108,1025456,2011132584
3924,2090237000,79038332,1.0670174819999999e-11,12129,1025456,2012158040
3925,2065235083,79038722,1.067022747e-11,24811,1025904,2013183944
3926,2088069500,79038333,1.0670174955e-11,12171,1025456,2014209400
3927,2072110958,79038333,1.0670174955e-11,12171,1025456,2015234856
3928,2077955917,79407980,1.0720077299999999e-11,12171,1025456,2016260312
3929,2053691333,79038333,1.0670174955e-11,12171,1025456,2017285768
3930,2070070750,79038333,1.0670174955e-11,12171,1025456,2018311224
3931,2050846375,79038332,1.0670174819999999e-11,12108,1025456,2019336680
3932,2052727209,79038332,1.0670174819999999e-11,12129,1025456,2020362136
3933,2054702458,79407980,1.0720077299999999e-11,12150,1025456,2021387592
3934,2064376875,79038333,1.0670174955e-11,12150,1025456,2022413048
3935,1930324458,79038333,1.0670174955e-11,12150,1025456,2023438504
3936,2597357584,79038333,1.0670174955e-11,12150,1025456,2024463960
3937,2373919667,79407980,1.0720077299999999e-11,12171,1025456,2025489416
3938,2179318833,79038333,1.0670174955e-11,12171,1025456,2026514872
3939,2266059583,79038333,1.0670174955e-11,12171,1025456,2027540328
3940,2253744334,79038333,1.0670174955e-11,12171,1025456,2028565784
3941,2248955375,79038332,1.0670174819999999e-11,12108,1025456,2029591240
3942,2712316000,79408365,1.0720129274999999e-11,24658,1025904,2030617144
3943,2465132042,79038333,1.0670174955e-11,12150,1025456,2031642600
3944,2557578125,79038333,1.0670174955e-11,12150,1025456,2032668056
3945,2446518708,79407980,1.0720077299999999e-11,12171,1025456,2033693512
3946,2563708291,79038333,1.0670174955e-11,12171,1025456,2034718968
3947,2309636000,79038333,1.0670174955e-11,12171,1025456,2035744424
3948,2173476000,79038333,1.0670174955e-11,12171,1025456,2036769880
3949,2395729792,79407980,1.0720077299999999e-11,12171,1025456,2037795336
3950,4866256667,79038333,1.0670174955e-11,12171,1025456,2038820792
3951,2057499333,79038332,1.0670174819999999e-11,12108,1025456,2039846248
3952,2051507625,79407979,1.0720077164999998e-11,12129,1025456,2040871704
3953,2050760000,79038332,1.0670174819999999e-11,12129,1025456,2041897160
3954,2054191209,79038333,1.0670174955e-11,12150,1025456,2042922616
3955,2060592500,79038333,1.0670174955e-11,12150,1025456,2043948072
3956,2083353708,79038333,1.0670174955e-11,12150,1025456,2044973528
3957,2108905833,79407980,1.0720077299999999e-11,12150,1025456,2045998984
3958,2076489500,79038333,1.0670174955e-11,12171,1025456,2047024440
3959,2275027959,79038716,1.067022666e-11,24589,1025904,2048050344
3960,2362548791,79038335,1.0670175224999999e-11,12213,1025456,2049075800
3961,3019463750,79407979,1.0720077164999998e-11,12129,1025456,2050101256
3962,2364685750,79038333,1.0670174955e-11,12150,1025456,2051126712
3963,2692271834,79038333,1.0670174955e-11,12171,1025456,2052152168
3964,2352181542,79038333,1.0670174955e-11,12171,1025456,2053177624
3965,2266381625,79407980,1.0720077299999999e-11,12171,1025456,2054203080
3966,2435901166,79038334,1.067017509e-11,12192,1025456,2055228536
3967,2179645167,79038334,1.067017509e-11,12192,1025456,2056253992
3968,3664058541,79407981,1.0720077435e-11,12192,1025456,2057279448
3969,2473532416,79038334,1.067017509e-11,12192,1025456,2058304904
3970,2520953542,79038334,1.067017509e-11,12192,1025456,2059330360
3971,2239574291,79038332,1.0670174819999999e-11,12129,1025456,2060355816
3972,2148498417,79407980,1.0720077299999999e-11,12150,1025456,2061381272
3973,2212664750,79038333,1.0670174955e-11,12150,1025456,2062406728
3974,2231791667,79038333,1.0670174955e-11,12171,1025456,2063432184
3975,3270008250,79038333,1.0670174955e-11,12171,1025456,2064457640
3976,33379900375,79038712,1.067022612e-11,24457,1025904,2065483544
3977,49771967250,82328190,1.111430565e-11,12192,1025456,2066509000
3978,2058252417,79038334,1.067017509e-11,12192,1025456,2067534456
3979,2057724375,79038334,1.067017509e-11,12192,1025456,2068559912
3980,2050952208,79038335,1.0670175224999999e-11,12213,1025456,2069585368
3981,2051312584,79038332,1.0670174819999999e-11,12129,1025456,2070610824
3982,2051313584,79407980,1.0720077299999999e-11,12150,1025456,2071636280
3983,2051948042,79038333,1.0670174955e-11,12171,1025456,2072661736
3984,2050784208,79038333,1.0670174955e-11,12171,1025456,2073687192
3985,2051971958,79038333,1.0670174955e-11,12171,1025456,2074712648
3986,2051985375,79038333,1.0670174955e-11,12171,1025456,2075738104
3987,107375056000,295588222,3.9904409969999993e-11,12192,-33882704,2041855400
3988,2475111125,79038334,1.067017509e-11,12192,1025456,2042880856
3989,2523110042,79413287,1.0720793744999999e-11,12192,1025456,2043906312
3990,2547068041,79038334,1.067017509e-11,12192,1025456,2044931768
3991,2403406667,79038332,1.0670174819999999e-11,12129,1025456,2045957224
3992,2467696125,79038333,1.0670174955e-11,12150,1025456,2046982680
3993,2342913291,79413660,1.0720844099999999e-11,24304,1025904,2048008584
3994,2387274333,79038333,1.0670174955e-11,12171,1025456,2049034040
3995,2208714875,79038334,1.067017509e-11,12192,1025456,2050059496
3996,2287065500,79038334,1.067017509e-11,12192,1025456,2051084952
3997,3495386792,79038334,1.067017509e-11,12192,1025456,2052110408
3998,4851375792,79488278,1.0730917529999998e-11,12192,1025456,2053135864
3999,2051969500,79038334,1.067017509e-11,12192,1025456,2054161320
4000,2051526792,79038334,1.067017509e-11,12192,1025456,2055186776
4001,2055093666,79413276,1.072079226e-11,11814,1025456,2056212232
4002,2064546375,79038325,1.0670173874999998e-11,11877,1025456,2057237688
4003,2051830625,79038325,1.0670173874999998e-11,11877,1025456,2058263144
4004,2114103750,79038326,1.067017401e-11,11940,1025456,2059288600
4005,2051270000,79038326,1.067017401e-11,11940,1025456,2060314056
4006,2110328000,79413279,1.0720792665e-11,11940,1025456,2061339512
4007,2051821250,79038326,1.067017401e-11,11940,1025456,2062364968
4008,2111053792,79038329,1.0670174414999999e-11,12003,1025456,2063390424
4009,2122218791,79038329,1.0670174414999999e-11,12003,1025456,2064415880
4010,2147771542,79038698,1.067022423e-11,24025,1025904,2065441784
4011,2506957375,79413294,1.072079469e-11,12424,1025456,2066467240
4012,2157403084,79038342,1.067017617e-11,12445,1025456,2067492696
4013,2174768083,79038343,1.0670176304999999e-11,12466,1025456,2068518152
4014,2197682917,79413296,1.072079496e-11,12466,1025456,2069543608
4015,2296317833,79038343,1.0670176304999999e-11,12466,1025456,2070569064
4016,2264446542,79038343,1.0670176304999999e-11,12487,1025456,2071594520
4017,2385619333,79038343,1.0670176304999999e-11,12487,1025456,2072619976
4018,2290123167,79038343,1.0670176304999999e-11,12487,1025456,2073645432
4019,2244646750,79413296,1.072079496e-11,12487,1025456,2074670888
4020,2497980833,79038343,1.0670176304999999e-11,12487,1025456,2075696344
4021,2557817750,79038341,1.0670176034999999e-11,12424,1025456,2076721800
4022,2312789208,79038342,1.067017617e-11,12445,1025456,2077747256
4023,2316004375,79038342,1.067017617e-11,12445,1025456,2078772712
4024,4906518833,79038343,1.0670176304999999e-11,12466,1025456,2079798168
4025,3268644375,79413296,1.072079496e-11,12466,1025456,2080823624
4026,2062633500,79038343,1.0670176304999999e-11,12466,1025456,2081849080
4027,2062613542,79039551,1.0670339385e-11,51740,1026708,2082875788
4028,2060267625,79038331,1.0670174685e-11,12087,1025456,2083901244
4029,2052096292,79038332,1.0670174819999999e-11,12108,1025456,2084926700
4030,88764207625,82337923,1.1115619604999999e-11,12108,1025456,2085952156
4031,2050806375,79038329,1.0670174414999999e-11,12024,1025456,2086977612
4032,2054423250,79413283,1.0720793205e-11,12045,1025456,2088003068
4033,2928390792,79038330,1.067017455e-11,12066,1025456,2089028524
4034,2592921875,79038330,1.067017455e-11,12066,1025456,2090053980
4035,2152141250,79038330,1.067017455e-11,12066,1025456,2091079436
4036,2239808750,79413283,1.0720793205e-11,12066,1025456,2092104892
4037,2326809750,79038331,1.0670174685e-11,12087,1025456,2093130348
4038,130790167959,299036546,4.0369933709999996e-11,12087,-25156140,2067974208
4039,2059583375,79038331,1.0670174685e-11,12087,1025456,2068999664
4040,2056646334,79038331,1.0670174685e-11,12087,1025456,2070025120
4041,2053276250,79417242,1.072132767e-11,12024,1025456,2071050576
4042,2048923541,79038330,1.067017455e-11,12045,1025456,2072076032
4043,2055178167,79038330,1.067017455e-11,12045,1025456,2073101488
4044,2071417250,79038761,1.0670232735e-11,26047,1025904,2074127392
4045,2056113583,79038332,1.0670174819999999e-11,12129,1025456,2075152848
4046,2050272459,79417245,1.0721328075e-11,12129,1025456,2076178304
4047,2052650333,79038332,1.0670174819999999e-11,12129,1025456,2077203760
4048,2050207333,79038332,1.0670174819999999e-11,12129,1025456,2078229216
4049,2050327750,79038332,1.0670174819999999e-11,12129,1025456,2079254672
4050,2050356167,79038332,1.0670174819999999e-11,12129,1025456,2080280128
4051,2051505125,79417243,1.0721327804999998e-11,12066,1025456,2081305584
4052,2101963167,79038331,1.0670174685e-11,12087,1025456,2082331040
4053,2127262042,79038331,1.0670174685e-11,12087,1025456,2083356496
4054,2161871625,79038332,1.0670174819999999e-11,12108,1025456,2084381952
4055,2952904750,79417245,1.0721328075e-11,12108,1025456,2085407408
4056,2122838292,79038332,1.0670174819999999e-11,12108,1025456,2086432864
4057,2381438125,79038332,1.0670174819999999e-11,12108,1025456,2087458320
4058,2351828542,79038332,1.0670174819999999e-11,12129,1025456,2088483776
4059,2423567084,79417245,1.0721328075e-11,12129,1025456,2089509232
4060,2421258583,79038332,1.0670174819999999e-11,12129,1025456,2090534688
4061,2428427750,79038757,1.0670232194999999e-11,25915,1025904,2091560592
4062,4020709250,79417244,1.0721327939999999e-11,12087,1025456,2092586048
4063,2324872458,79038332,1.0670174819999999e-11,12108,1025456,2093611504
4064,2328697708,79038332,1.0670174819999999e-11,12108,1025456,2094636960
4065,2726506583,79038332,1.0670174819999999e-11,12129,1025456,2095662416
4066,2541000459,79417245,1.0721328075e-11,12129,1025456,2096687872
4067,2266651750,79038332,1.0670174819999999e-11,12129,1025456,2097713328
4068,3279921625,79038332,1.0670174819999999e-11,12129,1025456,2098738784
4069,2051156750,79038332,1.0670174819999999e-11,12129,1025456,2099764240
4070,2049111791,79417245,1.0721328075e-11,12129,1025456,2100789696
4071,88752686417,82145415,1.1089631024999998e-11,12066,1025456,2101815152
4072,2052426333,79038331,1.0670174685e-11,12087,1025456,2102840608
4073,2067182916,79417244,1.0721327939999999e-11,12087,1025456,2103866064
4074,2059539125,79038332,1.0670174819999999e-11,12108,1025456,2104891520
4075,2069829792,79038332,1.0670174819999999e-11,12108,1025456,2105916976
4076,107287870833,300296825,4.0540071374999996e-11,12108,-18481984,2087434992
4077,2242010042,79038332,1.0670174819999999e-11,12108,1025456,2088460448
4078,2575477625,79038754,1.067023179e-11,25846,1025904,2089486352
4079,2147297416,79420180,1.07217243e-11,12192,1025456,2090511808
4080,2433502583,79038334,1.067017509e-11,12192,1025456,2091537264
4081,2291169167,79038332,1.0670174819999999e-11,12108,1025456,2092562720
4082,2317732459,79038332,1.0670174819999999e-11,12129,1025456,2093588176
4083,2300530708,79420179,1.0721724164999999e-11,12150,1025456,2094613632
4084,2418267834,79038333,1.0670174955e-11,12150,1025456,2095639088
4085,5326554541,79038333,1.0670174955e-11,12150,1025456,2096664544
4086,6747012958,79420179,1.0721724164999999e-11,12171,1025456,2097690000
4087,4741300250,79420179,1.0721724164999999e-11,12171,1025456,2098715456
4088,2050677041,79038333,1.0670174955e-11,12171,1025456,2099740912
4089,2051498875,79038333,1.0670174955e-11,12171,1025456,2100766368
4090,2059036000,79038333,1.0670174955e-11,12171,1025456,2101791824
4091,2073644833,79038332,1.0670174819999999e-11,12108,1025456,2102817280
4092,2057251875,79420178,1.0721724029999999e-11,12129,1025456,2103842736
4093,2048885167,79038332,1.0670174819999999e-11,12129,1025456,2104868192
4094,2049024750,79038333,1.0670174955e-11,12150,1025456,2105893648
4095,2053051709,79038752,1.067023152e-11,25756,1025904,2106919552
4096,2049918917,79038333,1.0670174955e-11,12171,1025456,2107945008
4097,2321320250,79420179,1.0721724164999999e-11,12171,1025456,2108970464
4098,2584180250,79038333,1.0670174955e-11,12171,1025456,2109995920
4099,2562545625,79038333,1.0670174955e-11,12171,1025456,2111021376
4100,2288854959,79038333,1.0670174955e-11,12171,1025456,2112046832
4101,2436345333,79420173,1.0721723354999999e-11,11961,1025456,2113072288
4102,2523489583,79038329,1.0670174414999999e-11,12003,1025456,2114097744
4103,2203837875,79038330,1.067017455e-11,12045,1025456,2115123200
4104,2146467000,79038330,1.067017455e-11,12045,1025456,2116148656
4105,189074511666,305167635,4.1197630725e-11,12045,-13861924,2102286732
4106,2122459166,79038330,1.067017455e-11,12045,1025456,2103312188
4107,2318937209,79038331,1.0670174685e-11,12087,1025456,2104337644
4108,2209399125,79038331,1.0670174685e-11,12087,1025456,2105363100
4109,2199540000,79038331,1.0670174685e-11,12087,1025456,2106388556
4110,2158865875,79038331,1.0670174685e-11,12087,1025456,2107414012
4111,2604372042,79038329,1.0670174414999999e-11,12024,1025456,2108439468
4112,2528695708,79038744,1.067023044e-11,25498,1025904,2109465372
4113,2551784583,79038331,1.0670174685e-11,12087,1025456,2110490828
4114,2388264958,79038331,1.0670174685e-11,12087,1025456,2111516284
4115,2809990875,79038332,1.0670174819999999e-11,12108,1025456,2112541740
4116,4188169834,79422462,1.072203237e-11,12108,1025456,2113567196
4117,2261435250,79038332,1.0670174819999999e-11,12108,1025456,2114592652
4118,2377241209,79038332,1.0670174819999999e-11,12108,1025456,2115618108
4119,2262683750,79038332,1.0670174819999999e-11,12108,1025456,2116643564
4120,40805580875,79422462,1.072203237e-11,12108,1025456,2117669020
4121,49767750208,81842479,1.1048734665e-11,12045,1025456,2118694476
4122,2072106417,79422460,1.0722032099999998e-11,12066,1025456,2119719932
4123,2052584459,79422460,1.0722032099999998e-11,12066,1025456,2120745388
4124,2053002583,79038331,1.0670174685e-11,12087,1025456,2121770844
4125,2056646917,79038331,1.0670174685e-11,12087,1025456,2122796300
4126,107298972625,302963583,4.090008370499999e-11,12087,-9754944,2113041356
4127,2202291459,79038331,1.0670174685e-11,12087,1025456,2114066812
4128,2317333958,79038332,1.0670174819999999e-11,12108,1025456,2115092268
4129,2181223166,79424452,1.072230102e-11,25450,1025904,2116118172
4130,2527141083,79038333,1.0670174955e-11,12150,1025456,2117143628
4131,2399594709,79038330,1.067017455e-11,12066,1025456,2118169084
4132,2430523083,79038331,1.0670174685e-11,12087,1025456,2119194540
4133,2309289584,79424042,1.072224567e-11,12108,1025456,2120219996
4134,2677398708,79038332,1.0670174819999999e-11,12108,1025456,2121245452
4135,2149983875,79038332,1.0670174819999999e-11,12108,1025456,2122270908
4136,2267378834,79038332,1.0670174819999999e-11,12129,1025456,2123296364
4137,4896479292,79424042,1.072224567e-11,12129,1025456,2124321820
4138,4791005166,79038332,1.0670174819999999e-11,12129,1025456,2125347276
4139,2049228959,79424042,1.072224567e-11,12129,1025456,2126372732
4140,2049219500,79038332,1.0670174819999999e-11,12129,1025456,2127398188
4141,2055467541,79038330,1.067017455e-11,12066,1025456,2128423644
4142,107307923334,299727541,4.0463218034999994e-11,12087,-7188244,2121235400
4143,88761977959,86622909,1.1694092714999999e-11,12087,1025456,2122260856
4144,2052339041,79038332,1.0670174819999999e-11,12108,1025456,2123286312
4145,2051495333,79038332,1.0670174819999999e-11,12108,1025456,2124311768
4146,2051160250,79038738,1.067022963e-11,25318,1025904,2125337672
4147,2049465250,79425301,1.0722415635e-11,12150,1025456,2126363128
4148,2051983459,79038333,1.0670174955e-11,12150,1025456,2127388584
4149,2051667584,79038333,1.0670174955e-11,12150,1025456,2128414040
4150,2055603583,79038333,1.0670174955e-11,12171,1025456,2129439496
4151,2058503875,79038331,1.0670174685e-11,12087,1025456,2130464952
4152,2480153209,79038332,1.0670174819999999e-11,12108,1025456,2131490408
4153,2374716291,79038332,1.0670174819999999e-11,12129,1025456,2132515864
4154,131575168708,305448398,4.1235533729999994e-11,12129,-5134884,2127380980
4155,2067243584,79038332,1.0670174819999999e-11,12129,1025456,2128406436
4156,2061347875,79038332,1.0670174819999999e-11,12129,1025456,2129431892
4157,2047883042,79426231,1.0722541185e-11,12150,1025456,2130457348
4158,2065606375,79038333,1.0670174955e-11,12150,1025456,2131482804
4159,2054148625,79038333,1.0670174955e-11,12150,1025456,2132508260
4160,2049096250,79038333,1.0670174955e-11,12150,1025456,2133533716
4161,2048558708,79038331,1.0670174685e-11,12087,1025456,2134559172
4162,88737857208,82374258,1.112052483e-11,12108,1025456,2135584628
4163,107322774750,305160380,4.1196651299999993e-11,25186,-3594416,2131990212
4164,2217553000,79038332,1.0670174819999999e-11,12129,1025456,2133015668
4165,2090281584,79038333,1.0670174955e-11,12150,1025456,2134041124
4166,2301521834,79426935,1.0722636225e-11,12150,1025456,2135066580
4167,2375955500,79038333,1.0670174955e-11,12150,1025456,2136092036
4168,2230881667,79038333,1.0670174955e-11,12150,1025456,2137117492
4169,2265216334,79038333,1.0670174955e-11,12150,1025456,2138142948
4170,130662433834,306200613,4.1337082755e-11,12150,-2567924,2135575024
4171,2058635375,79427487,1.0722710744999999e-11,12087,1025456,2136600480
4172,2135142500,79038332,1.0670174819999999e-11,12108,1025456,2137625936
4173,2216761250,79038332,1.0670174819999999e-11,12108,1025456,2138651392
4174,2834318458,79038332,1.0670174819999999e-11,12129,1025456,2139676848
4175,130676661208,306627603,4.1394726404999997e-11,12129,-1541244,2138135604
4176,2049366958,79038332,1.0670174819999999e-11,12129,1025456,2139161060
4177,2061991125,79038332,1.0670174819999999e-11,12129,1025456,2140186516
4178,2049782291,79427865,1.0722761775e-11,12150,1025456,2141211972
4179,188059065125,308521424,4.165039224e-11,12150,-1027904,2140184068
4180,2047047583,79428591,1.0722859785e-11,25096,1025904,2141209972
4181,2060055042,79038331,1.0670174685e-11,12087,1025456,2142235428
4182,88749738708,305096567,4.118803654499999e-11,12108,-514824,2141720604
4183,2507874833,79428425,1.0722837375e-11,12129,1025456,2142746060
4184,130752976208,301965345,4.0765321574999997e-11,12129,-1224,2142744836
4185,2054579083,84033276,1.1344492259999998e-11,12129,1025456,2143770292
4186,88752395375,305663710,4.1264600849999993e-11,12150,-1224,2143769068
4187,88767014875,305170773,4.1198054355e-11,12150,512116,2144281184
4188,88771753750,305576294,4.125279969e-11,12150,512116,2144793300
4189,88767690375,305630345,4.1260096574999997e-11,12150,512116,2145305416
4190,88851553291,305645376,4.1262125759999996e-11,12150,512116,2145817532
