Size,Time,Cycles,Price,Instructions,HeapSize,TotalHeapSize
3,2117646375,236877144,3.197841444e-11,14829,1536232,1536860
6,2089023375,237084162,3.200636187e-11,18922,1536360,3073220
9,2089026292,237244086,3.202795161e-11,22158,1536360,4609580
12,2089930834,236764311,3.1963181985e-11,21770,3074228,7683808
15,2093967792,237565635,3.2071360724999995e-11,21778,-1508,7682300
18,2092799625,236764367,3.1963189544999997e-11,23606,3074228,10756528
21,2103588542,237883469,3.2114268314999994e-11,24836,-1508,10755020
24,2089026833,236764403,3.1963194405e-11,24760,3074228,13829248
27,2093086500,236764399,3.1963193864999995e-11,24634,3074228,16903476
30,2085482459,238366352,3.217945752e-11,23496,-1539376,15364100
33,2115759834,236718469,3.1956993314999994e-11,52901,3075092,18439192
36,2086036209,236717927,3.1956920144999997e-11,35297,3074340,21513532
39,2089860417,238796245,3.2237493075e-11,36569,-1539836,19973696
42,2095334208,236717996,3.195692946e-11,37537,3074340,23048036
45,2099586500,236722288,3.195750888e-11,37789,3074340,26122376
48,2109935250,236718444,3.1956989939999995e-11,52096,3074788,29197164
51,9950018500,239441761,3.2324637735e-11,36925,-3077840,26119324
54,12129094208,236723454,3.195766629e-11,34789,3074340,29193664
57,2101996417,236718006,3.195693081e-11,37871,3074340,32268004
60,2089063375,236723549,3.1957679114999996e-11,37897,3074340,35342344
63,2088327458,236718019,3.1956932564999997e-11,38265,3074340,38416684
66,2087542625,240235339,3.2431770765e-11,51378,-4615372,33801312
69,2108113334,236718009,3.1956931215e-11,37973,3074340,36875652
72,2099581500,236718055,3.1956937425e-11,39445,3074340,39949992
75,2088771958,236725124,3.195789173999999e-11,39059,3074340,43024332
78,2085936833,236718053,3.1956937155e-11,39369,3074340,46098672
81,2086781583,236718055,3.1956937425e-11,39447,3074340,49173012
84,2091913083,241194430,3.256124805e-11,52610,-6153352,43019660
87,2167193667,236718060,3.19569381e-11,39597,3074340,46094000
90,2074710250,236726948,3.195813798e-11,39243,3074340,49168340
93,2089188625,236718081,3.1956940934999996e-11,40293,3074340,52242680
96,2110703000,236718010,3.195693135e-11,37987,3074340,55317020
99,2077026541,236718472,3.195699372e-11,52994,3074788,58391808
102,2085725209,236726816,3.1958120159999994e-11,34953,3074340,61466148
105,2092798208,236717978,3.195692703e-11,36941,3074340,64540488
108,3322868167,242472694,3.2733813689999995e-11,38111,-9229760,55310728
111,2111864833,236718021,3.1956932835e-11,38363,3074340,58385068
114,2095520541,236729413,3.1958470755e-11,37575,3074340,61459408
117,2101584542,236718441,3.1956989535e-11,51984,3074788,64534196
120,2088214916,236717954,3.1956923789999994e-11,36173,3074340,67608536
123,2090980750,236718048,3.195693648e-11,39219,3074340,70682876
126,2099198583,236718018,3.195693243e-11,38241,3074340,73757216
129,9579370375,236729519,3.1958485065e-11,41019,3074340,76831556
132,3236548916,236729526,3.195848601e-11,41247,3074340,79905896
135,2692205833,236718098,3.195694323e-11,40843,3074340,82980236
138,7209996084,244085627,3.2951559645e-11,41093,-12305720,70674516
141,2107252667,236718478,3.195699453e-11,53190,3074788,73749304
144,2106817500,236718106,3.1956944309999995e-11,41097,3074340,76823644
147,2097312125,236718195,3.195695632499999e-11,44001,3074340,79897984
150,2111355667,236732674,3.195891099e-11,43775,3074340,82972324
153,2094464458,236718205,3.1956957675e-11,44343,3074340,86046664
156,2106947709,236718149,3.1956950115e-11,42519,3074340,89121004
159,2111043250,236718536,3.195700236e-11,55092,3074788,92195792
162,2104877958,236732547,3.1958893844999995e-11,39637,3074340,95270132
165,2092091459,236718145,3.195694957499999e-11,42367,3074340,98344472
168,2095462542,236718150,3.1956950249999994e-11,42541,3074340,101418812
171,2092013292,236718166,3.195695241e-11,43073,3074340,104493152
174,3320179750,245989301,3.3208555634999996e-11,42771,-15381940,89111212
177,2110135542,236736621,3.1959443834999996e-11,53798,3074788,92186000
180,2092032791,236718085,3.1956941475e-11,40421,3074340,95260340
183,2091965750,236718177,3.1956953895e-11,43433,3074340,98334680
186,2090565875,236718122,3.195694647e-11,41639,3074340,101409020
189,3320533333,236736232,3.195939132e-11,41161,3074340,104483360
192,2100308667,236718517,3.1956999795e-11,54470,3074788,107558148
195,3321520625,236718077,3.1956940395e-11,40165,3074340,110632488
198,2089655375,236718089,3.1956942014999994e-11,40543,3074340,113706828
201,2092825166,236736248,3.195939348e-11,41691,3074340,116781168
204,2091458459,236718121,3.1956946335e-11,41589,3074340,119855508
207,2091477000,236718117,3.1956945795e-11,41463,3074340,122929848
210,2090479667,236718503,3.1956997905e-11,54022,3074788,126004636
213,2091534125,236718060,3.19569381e-11,39605,3074340,129078976
216,2090061875,236736194,3.1959386189999994e-11,39953,3074340,132153316
219,4833056459,248386917,3.3532233794999993e-11,40331,-19996140,112157176
222,2078261292,236718066,3.195693891e-11,39819,3074340,115231516
225,2090865208,236740806,3.196000881e-11,39845,3074340,118305856
228,3309560875,236718430,3.195698805e-11,51640,3074788,121380644
231,2087046958,236718085,3.1956941475e-11,40409,3074340,124454984
234,2088858167,236718069,3.1956939314999996e-11,39903,3074340,127529324
237,2162636333,236740812,3.196000962e-11,40053,3074340,130603664
240,2407826250,236718082,3.1956941069999995e-11,40331,3074340,133678004
243,3065098792,236718514,3.195699939e-11,54362,3074788,136752792
246,3832830250,236742998,3.1960304729999996e-11,37161,3074340,139827132
249,9737357084,236718016,3.195693216e-11,38181,3074340,142901472
252,2091149208,236745334,3.196062009e-11,39201,3074340,145975812
255,2101538292,236718037,3.1956934995e-11,38847,3074340,149050152
258,2089751541,236718040,3.19569354e-11,38973,3074340,152124492
261,2091928375,236718427,3.1956987645e-11,51554,3074788,155199280
264,2088465542,236740720,3.19599972e-11,37061,3074340,158273620
267,2089197125,236718046,3.195693621e-11,39151,3074340,161347960
270,2087712791,236718039,3.1956935264999995e-11,38923,3074340,164422300
273,2089197625,236718052,3.195693702e-11,39335,3074340,167496640
276,6563701833,251452410,3.3946075349999994e-11,36905,-26148060,141348580
279,2076688958,236718460,3.19569921e-11,52622,3074788,144423368
282,2087633875,236718010,3.195693135e-11,37989,3074340,147497708
285,2088559167,236746643,3.1960796804999996e-11,38883,3074340,150572048
288,2088884083,236718004,3.195693054e-11,37779,3074340,153646388
291,2088677583,236718033,3.1956934454999995e-11,38749,3074340,156720728
294,2089926375,236718454,3.195699129e-11,52412,3074788,159795516
297,2086888500,236718050,3.1956936749999996e-11,39287,3074340,162869856
300,2089139417,236746656,3.1960798559999996e-11,39287,3074340,165944196
303,2087705166,236671411,3.1950640485e-11,44733,3074340,169018536
306,2088351083,236671395,3.1950638324999996e-11,44221,3074340,172092876
309,2088457542,236671414,3.195064089e-11,44851,3074340,175167216
312,2089432375,236671387,3.1950637245e-11,43967,3074340,178241556
315,2087248292,236700000,3.19545e-11,44193,3074340,181315896
318,2134810417,236671851,3.1950699885e-11,59032,3074788,184390684
321,3304582459,236671315,3.1950627524999996e-11,41615,3074340,187465024
324,2087440750,236671393,3.1950638055e-11,44161,3074340,190539364
327,3325414416,236700022,3.195450297e-11,44899,3074340,193613704
330,2087130500,236671398,3.195063872999999e-11,44293,3074340,196688044
333,2135321167,236671935,3.1950711224999996e-11,61760,3074788,199762832
336,2062339625,236671389,3.1950637515e-11,44023,3074340,202837172
339,2087897083,236671460,3.19506471e-11,46321,3074340,205911512
342,2087871250,236700048,3.195450648e-11,45745,3074340,208985852
345,2088143458,236671445,3.1950645075e-11,45843,3074340,212060192
348,8646254041,255253119,3.4459171065e-11,45945,-33838220,178221972
351,2103907500,236671937,3.1950711494999994e-11,61826,3074788,181296760
354,3277527000,236671418,3.195064143e-11,44981,3074340,184371100
357,2088742250,236671457,3.1950646694999996e-11,46219,3074340,187445440
360,2087866417,236707461,3.1955507235e-11,45767,3074340,190519780
363,3304445625,236671453,3.1950646155e-11,46091,3074340,193594120
366,2091568041,236671405,3.1950639675e-11,44533,3074340,196668460
369,3304886042,236671934,3.195071109e-11,61748,3074788,199743248
372,2087921166,236707388,3.195549738e-11,43413,3074340,202817588
375,2088097500,236671416,3.1950641159999994e-11,44885,3074340,205891928
378,3312511750,236671406,3.195063981e-11,44583,3074340,208966268
381,3319927042,236671406,3.195063981e-11,44583,3074340,212040608
384,2089500708,236707952,3.195557352e-11,61720,3074788,215115396
387,3305051584,236671401,3.1950639134999996e-11,44403,3074340,218189736
390,3304060708,236671414,3.195064089e-11,44839,3074340,221264076
393,3311162458,236707453,3.1955506155e-11,45507,3074340,224338416
396,3303498375,236671529,3.1950656415e-11,48573,3074340,227412756
399,3293947583,236671585,3.1950663974999997e-11,50391,3074340,230487096
402,3291018750,236671589,3.1950664515e-11,50517,3074340,233561436
405,3302377167,236671572,3.195066222e-11,49979,3074340,236635776
408,2087708208,236671577,3.1950662895e-11,50137,3074340,239710116
411,6520517875,236707856,3.1955560559999996e-11,58620,3074780,242784896
414,3305764500,236671500,3.1950652499999996e-11,47613,3074340,245859236
417,3304919167,236671597,3.1950665595e-11,50769,3074340,248933576
420,3303844125,236711205,3.1956012675e-11,50417,3074340,252007916
423,3302905750,236671599,3.1950665864999995e-11,50859,3074340,255082256
426,3303615708,236671543,3.1950658304999996e-11,49027,3074340,258156596
429,3304598417,236671993,3.1950719054999993e-11,63636,3074788,261231384
432,3303750917,236707504,3.195551304e-11,47187,3074340,264305724
435,3301491708,236671556,3.1950660059999995e-11,49435,3074340,267380064
438,11182002959,260054133,3.5107307955e-11,49449,-43066352,224313712
441,2629917583,236716813,3.1956769754999993e-11,49739,3074340,227388052
444,2857821125,236671538,3.1950657629999994e-11,48849,3074340,230462392
447,4670347500,236671965,3.1950715275e-11,62738,3074788,233537180
450,2430081500,236671462,3.195064737e-11,46379,3074340,236611520
453,4108455917,236671571,3.1950662085e-11,49949,3074340,239685860
456,2089849834,236716764,3.195676314e-11,48155,3074340,242760200
459,2088414834,236671505,3.1950653174999997e-11,47777,3074340,245834540
462,2088448500,236671987,3.1950718244999993e-11,63468,3074788,248909328
465,3308673542,236671498,3.195065223e-11,47571,3074340,251983668
468,2087791208,236716734,3.195675909e-11,47167,3074340,255058008
471,2090831291,236671526,3.1950656009999994e-11,48483,3074340,258132348
474,2088758250,236671519,3.1950655064999995e-11,48255,3074340,261206688
477,2090236583,236671515,3.1950654525e-11,48129,3074340,264281028
480,2088556125,236717210,3.195682335e-11,62628,3074788,267355816
483,2090445375,236671526,3.1950656009999994e-11,48453,3074340,270430156
486,2088452958,236671473,3.1950648855e-11,46735,3074340,273504496
489,2089540333,236671474,3.195064899e-11,46785,3074340,276578836
492,2087639750,236671468,3.195064818e-11,46601,3074340,279653176
495,2088971333,236716717,3.1956756795e-11,46627,3074340,282727516
498,2088299583,236671886,3.1950704609999996e-11,60166,3074788,285802304
501,2086762541,236671466,3.195064791e-11,46509,3074340,288876644
504,2105998500,236671470,3.195064845e-11,46633,3074340,291950984
507,2086067167,236671476,3.1950649259999995e-11,46859,3074340,295025324
510,3302556500,236716727,3.1956758145e-11,46959,3074340,298099664
513,4763123458,236671967,3.1950715544999995e-11,62810,3074788,301174452
516,2092185709,236671366,3.1950634409999994e-11,43279,3074340,304248792
519,2088101125,236716667,3.1956750045e-11,44997,3074340,307323132
522,2088808500,236671449,3.1950645615e-11,45957,3074340,310397472
525,2088816500,236671428,3.1950642779999994e-11,45275,3074340,313471812
528,3309543291,236671435,3.195064372499999e-11,45527,3074340,316546152
531,2075887500,236717136,3.1956813359999996e-11,60236,3074788,319620940
534,2087978167,236671418,3.195064143e-11,44943,3074340,322695280
537,2088404291,236671450,3.1950645749999997e-11,46005,3074340,325769620
540,2089340167,236671442,3.195064467e-11,45753,3074340,328843960
543,2087789833,236671445,3.1950645075e-11,45827,3074340,331918300
546,2084237459,236716596,3.195674046e-11,42681,3074340,334992640
549,11100909042,265923450,3.5899665749999996e-11,59460,-53832292,281160348
552,2090640833,236739278,3.195980253e-11,44139,3074340,284234688
555,4771823167,236671347,3.1950631844999995e-11,42647,3074340,287309028
558,2212359292,236727951,3.1958273384999994e-11,43735,3074340,290383368
561,2535435250,236671384,3.1950636839999995e-11,43861,3074340,293457708
564,3925476166,236671850,3.1950699749999995e-11,58994,3074788,296532496
567,4336553833,236727930,3.195827055e-11,43057,3074340,299606836
570,2575907084,236671322,3.1950628469999996e-11,41843,3074340,302681176
573,2670265833,236728143,3.1958299305e-11,49967,3074340,305755516
576,2085947416,236671546,3.195065871e-11,49105,3074340,308829856
579,2076636167,236671578,3.195066303e-11,50173,3074340,311904196
582,2088767709,236671564,3.195066114e-11,49693,3074340,314978536
585,2090578666,236671576,3.195066276e-11,50097,3074340,318052876
588,2090224958,236729465,3.1958477775e-11,92924,3076040,321128916
591,2090627416,236671629,3.1950669915e-11,51804,3074448,324203364
594,2090885792,236671661,3.1950674235e-11,52858,3074448,327277812
597,2089959416,236671658,3.195067383e-11,52748,3074448,330352260
600,2089911583,236728227,3.1958310644999995e-11,52704,3074448,333426708
603,2090081334,236672170,3.1950742949999994e-11,69403,3074896,336501604
606,2090894542,236671551,3.1950659385e-11,49296,3074448,339576052
609,2095407500,236671487,3.1950650744999996e-11,47202,3074448,342650500
612,2105191958,236671582,3.195066356999999e-11,50284,3074448,345724948
615,2092444250,236728146,3.195829971e-11,50058,3074448,348799396
618,2089624583,236671581,3.1950663434999994e-11,50258,3074448,351873844
621,2089379792,236672052,3.1950727019999996e-11,65561,3074896,354948740
624,2089849875,236671555,3.1950659924999996e-11,49422,3074448,358023188
627,2092577750,236671525,3.1950655874999995e-11,48438,3074448,361097636
630,2089369792,236728149,3.195830011499999e-11,50174,3074448,364172084
633,2093541375,236671593,3.1950665054999995e-11,50658,3074448,367246532
636,2091191042,236671532,3.1950656819999994e-11,48674,3074448,370320980
639,2089670875,236672053,3.1950727154999995e-11,65603,3074896,373395876
642,3294999500,236728207,3.1958307944999996e-11,52058,3074448,376470324
645,6506637666,236671636,3.195067086e-11,52032,3074448,379544772
648,6512158209,236728194,3.195830619e-11,51622,3074448,382619220
651,2093066375,236671633,3.1950670455e-11,51932,3074448,385693668
654,3310212333,236672127,3.1950737144999995e-11,68017,3074896,388768564
657,2130380750,236728053,3.1958287155e-11,47056,3074448,391843012
660,2126125334,236671549,3.1950659114999996e-11,49228,3074448,394917460
663,2077016500,236671554,3.195065979e-11,49370,3074448,397991908
666,3305814709,236671494,3.1950651689999995e-11,47442,3074448,401066356
669,2089507084,236728065,3.1958288775e-11,47442,3074448,404140804
672,2087570375,236672005,3.1950720674999994e-11,64045,3074896,407215700
675,3306743917,236671500,3.1950652499999996e-11,47618,3074448,410290148
678,2091196958,236671599,3.1950665864999995e-11,50852,3074448,413364596
681,2090156833,236728153,3.1958300655e-11,50290,3074448,416439044
684,3306715084,236671587,3.1950664244999994e-11,50466,3074448,419513492
687,2089782083,236671601,3.1950666135e-11,50902,3074448,422587940
690,14125810666,273507677,3.6923536394999996e-11,65017,-69216512,353371428
693,2090275334,236749840,3.19612284e-11,51570,3074448,356445876
696,3336529917,236671700,3.19506795e-11,54128,3074448,359520324
699,2090468416,236671775,3.1950689625e-11,56558,3074448,362594772
702,3306656083,236742891,3.1960290285e-11,56812,3074448,365669220
705,3309036542,236671771,3.1950689084999995e-11,56432,3074448,368743668
708,4764543917,236671764,3.1950688139999995e-11,56196,3074448,371818116
711,3309479709,236743134,3.1960323089999995e-11,64715,3074896,374893012
714,3304391917,236671519,3.1950655064999995e-11,48248,3074448,377967460
717,3306149000,236671484,3.195065034e-11,47102,3074448,381041908
720,3308947583,236671525,3.1950655874999995e-11,48450,3074448,384116356
723,3307580625,236749925,3.1961239875e-11,54302,3074448,387190804
726,3306027625,236671675,3.1950676125e-11,53306,3074448,390265252
729,3317179958,236671746,3.1950685709999995e-11,55604,3074448,393339700
732,3317939917,236749949,3.1961243115e-11,55098,3074448,396414148
735,3310898375,236671738,3.195068463e-11,55378,3074448,399488596
738,3308894084,236672171,3.1950743084999993e-11,69424,3074896,402563492
741,3305858333,236742730,3.1960268549999994e-11,51604,3074448,405637940
744,3308570375,236671701,3.1950679635e-11,54162,3074448,408712388
747,3307154625,236671747,3.1950685844999994e-11,55652,3074448,411786836
750,3309268541,236742831,3.1960282185e-11,54862,3074448,414861284
753,3306038666,236671756,3.195068706e-11,55954,3074448,417935732
756,3307446833,236672090,3.1950732149999995e-11,66791,3074896,421010628
759,2292927209,236742803,3.1960278405e-11,53966,3074448,424085076
762,28435266417,236849465,3.1974677775e-11,53964,3074448,427159524
765,2099843375,236671694,3.195067869e-11,53918,3074448,430233972
768,2088753042,236742798,3.196027773e-11,53816,3074448,433308420
771,2090736958,236672143,3.1950739305e-11,68537,3074896,436383316
774,2088634042,236671634,3.1950670589999997e-11,51994,3074448,439457764
777,2091017875,236671691,3.1950678284999995e-11,53838,3074448,442532212
780,2088908000,236671706,3.195068031e-11,54322,3074448,445606660
783,2090470708,236742805,3.196027867499999e-11,54040,3074448,448681108
786,2097824083,236671646,3.195067221e-11,52388,3074448,451755556
789,2091246833,236672072,3.195072972e-11,66211,3074896,454830452
792,2076492833,236671561,3.1950660734999996e-11,49602,3074448,457904900
795,2092470625,236742768,3.196027368e-11,52836,3074448,460979348
798,2091014708,236671667,3.1950675045e-11,53062,3074448,464053796
801,2089886625,236671660,3.1950674099999995e-11,52834,3074448,467128244
804,2090109458,236671659,3.1950673964999996e-11,52808,3074448,470202692
807,2090411292,236672095,3.1950732824999996e-11,66963,3074896,473277588
810,2091165959,236742698,3.1960264229999995e-11,50560,3074448,476352036
813,2087767667,236671692,3.195067842e-11,53858,3074448,479426484
816,4767800542,236671620,3.19506687e-11,51534,3074448,482500932
819,2091196833,236742719,3.1960267065e-11,51248,3074448,485575380
822,2089560709,236672080,3.19507308e-11,66489,3074896,488650276
825,2125237042,236671565,3.1950661275e-11,49738,3074448,491724724
828,2110843291,236671617,3.1950668295e-11,51424,3074448,494799172
831,2224295375,236671636,3.195067086e-11,52038,3074448,497873620
834,3026845125,236671619,3.195066856499999e-11,51482,3074448,500948068
837,4445368500,236671626,3.195066951e-11,51710,3074448,504022516
840,3128893166,236743154,3.1960325789999993e-11,65381,3074896,507097412
843,2372971209,236671578,3.195066303e-11,50172,3074448,510171860
846,2745756000,236671581,3.1950663434999994e-11,50250,3074448,513246308
849,2090554041,236742685,3.1960262474999996e-11,50140,3074448,516320756
852,2092090709,236671582,3.195066356999999e-11,50300,3074448,519395204
855,2090189250,236671582,3.195066356999999e-11,50300,3074448,522469652
858,2162046375,236672039,3.1950725264999997e-11,65145,3074896,525544548
861,2158209292,236742697,3.1960264094999996e-11,50502,3074448,528618996
864,17711508625,282804665,3.8178629775e-11,50502,-86136996,442482000
867,2090046083,236671582,3.195066356999999e-11,50300,3074448,445556448
870,2090458458,236760447,3.1962660344999995e-11,50300,3074448,448630896
873,2089196000,236671992,3.1950718919999994e-11,63625,3074896,451705792
876,2085113000,236671674,3.195067599e-11,53278,3074448,454780240
879,2098251750,236671753,3.1950686654999994e-11,55846,3074448,457854688
882,2090663625,236671755,3.1950686925e-11,55928,3074448,460929136
885,2092409917,236760615,3.1962683025e-11,55768,3074448,464003584
888,6578347959,236671742,3.195068517e-11,55506,3074448,467078032
891,2092987958,236761577,3.1962812894999994e-11,87003,3075692,470153724
894,2077252500,236671605,3.1950666675e-11,51044,3074448,473228172
897,2090166375,236671654,3.195067329e-11,52620,3074448,476302620
900,2090442417,236671664,3.195067464e-11,52946,3074448,479377068
903,2087203583,236671656,3.195067356e-11,52696,3074448,482451516
906,3308216292,236760450,3.196266075e-11,50382,3074448,485525964
909,3310471209,236672014,3.195072189e-11,64351,3074896,488600860
912,3313616541,236671592,3.195066492e-11,50608,3074448,491675308
915,2119685917,236760427,3.1962657644999997e-11,49652,3074448,494749756
918,2077613458,236671594,3.1950665189999994e-11,50686,3074448,497824204
921,2090313417,236671587,3.1950664244999994e-11,50460,3074448,500898652
924,2090075375,236672066,3.195072891e-11,66007,3074896,503973548
927,2090834542,236671580,3.1950663299999995e-11,50228,3074448,507047996
930,3437279083,236760422,3.1962656969999995e-11,49488,3074448,510122444
933,3511550459,236671602,3.195066627e-11,50936,3074448,513196892
936,3381844333,236760419,3.1962656565e-11,49376,3074448,516271340
939,3220651417,236671550,3.1950659249999995e-11,49252,3074448,519345788
942,2375350875,236672010,3.195072135e-11,64193,3074896,522420684
945,2518333750,236760333,3.1962644955e-11,46572,3074448,525495132
948,2359076292,236671559,3.1950660465e-11,49554,3074448,528569580
951,2097816333,236671552,3.195065952e-11,49326,3074448,531644028
954,2089524167,236671543,3.1950658304999996e-11,49016,3074448,534718476
957,2089269083,236760429,3.1962657914999995e-11,49704,3074448,537792924
960,2092568292,236672038,3.195072513e-11,65131,3074896,540867820
963,2090021625,236671677,3.1950676394999997e-11,53378,3074448,543942268
966,2095863583,236671607,3.195066694499999e-11,51096,3074448,547016716
969,2094710167,236671604,3.195066654e-11,51002,3074448,550091164
972,2092121584,236671608,3.195066708e-11,51128,3074448,553165612
975,2090652167,236672092,3.195073242e-11,66869,3074896,556240508
978,2090745542,236671553,3.1950659655e-11,49358,3074448,559314956
981,2091270375,236671567,3.1950661544999996e-11,49816,3074448,562389404
984,2089596167,236760484,3.196266534e-11,51482,3074448,565463852
987,2090365042,236671618,3.195066843e-11,51456,3074448,568538300
990,2115403833,236671612,3.1950667619999994e-11,51254,3074448,571612748
993,2090455458,236672073,3.1950729855e-11,66243,3074896,574687644
996,2090034917,236671476,3.1950649259999995e-11,46832,3074448,577762092
999,2079321500,236760409,3.1962655214999996e-11,49066,3074448,580836540
1002,2090275208,236671542,3.1950658169999997e-11,48982,3074448,583910988
1005,2090159708,236671514,3.195065439e-11,48096,3074448,586985436
1008,2091492958,236671510,3.195065385e-11,47970,3074448,590059884
1011,6512806959,236760865,3.1962716775e-11,63877,3074896,593134780
1014,2093534042,236671512,3.1950654119999996e-11,48020,3074448,596209228
1017,2090624958,236671512,3.1950654119999996e-11,48020,3074448,599283676
1020,2090105666,236760379,3.1962651164999995e-11,48096,3074448,602358124
1023,2091414458,236671888,3.195070488e-11,60228,3074448,605432572
1026,2117763125,236671824,3.195069624e-11,58162,3074448,608507020
1029,2123906542,236671820,3.19506957e-11,58038,3074448,611581468
1032,2076923042,236672038,3.195072513e-11,65105,3074896,614656364
1035,2089076500,236671629,3.1950669915e-11,51828,3074448,617730812
1038,8596946833,236760487,3.1962665745e-11,51602,3074448,620805260
1041,2094998584,236760494,3.196266669e-11,51804,3074448,623879708
1044,2089875125,236671629,3.1950669915e-11,51830,3074448,626954156
1047,2090223792,236672054,3.195072729e-11,65635,3074896,630029052
1050,2087837500,236671594,3.1950665189999994e-11,50692,3074448,633103500
1053,2091394291,236671654,3.195067329e-11,52644,3074448,636177948
1056,2090638334,236760437,3.1962658995e-11,49968,3074448,639252396
1059,2078801625,236671578,3.195066303e-11,50144,3074448,642326844
1062,2092485166,236671575,3.1950662624999994e-11,50060,3074448,645401292
1065,2131489458,236672055,3.1950727425e-11,65681,3074896,648476188
1068,2089935167,236671563,3.1950661004999994e-11,49668,3074448,651550636
1071,3303090375,236760449,3.1962660615e-11,50352,3074448,654625084
1074,2087690250,236671586,3.1950664109999995e-11,50402,3074448,657699532
1077,2089472708,236671586,3.1950664109999995e-11,50402,3074448,660773980
1080,2091061167,236672060,3.19507281e-11,65815,3074896,663848876
1083,22056874250,294620715,3.9773796524999996e-11,51026,-109209824,554639052
1086,3296839500,236671650,3.195067275e-11,52496,3074448,557713500
1089,3306823834,236783074,3.1965714989999996e-11,54114,3074448,560787948
1092,3307573333,236671744,3.195068544e-11,55552,3074448,563862396
1095,3307182250,236671738,3.195068463e-11,55350,3074448,566936844
1098,3307493042,236783112,3.1965720119999995e-11,55348,3074448,570011292
1101,3343003375,236672134,3.1950738089999994e-11,68230,3074896,573086188
1104,2090128584,236671682,3.195067707e-11,53530,3074448,576160636
1107,3305944333,236783086,3.1965716609999996e-11,54516,3074448,579235084
1110,3308299500,236671745,3.1950685574999996e-11,55576,3074448,582309532
1113,3307124958,236671750,3.195068625e-11,55734,3074448,585383980
1116,2090488166,236783076,3.196571526e-11,54194,3074448,588458428
1119,3305577667,236672062,3.195072837e-11,65873,3074896,591533324
1122,3307317583,236671672,3.1950675719999995e-11,53208,3074448,594607772
1125,3306001000,236671708,3.1950680579999996e-11,54394,3074448,597682220
1128,2089840667,236783092,3.1965717419999996e-11,54724,3074448,600756668
1131,3301593416,236671708,3.1950680579999996e-11,54396,3074448,603831116
1134,3309437959,236672130,3.195073755e-11,68085,3074896,606906012
1137,3293542667,236782992,3.196570392e-11,51464,3074448,609980460
1140,3306649292,236671700,3.19506795e-11,54118,3074448,613054908
1143,3303784334,236671733,3.1950683954999996e-11,55184,3074448,616129356
1146,3323622166,236783041,3.1965710535e-11,53064,3074448,619203804
1149,3301540667,236671666,3.1950674909999995e-11,53012,3074448,622278252
1152,2089663708,236672059,3.1950727964999995e-11,65793,3074896,625353148
1155,4758763375,236782962,3.196569987e-11,50496,3074448,628427596
1158,3303218750,236671605,3.1950666675e-11,51042,3074448,631502044
1161,3440555917,236783045,3.1965711075e-11,53198,3074448,634576492
1164,3168049833,236671656,3.195067356e-11,52702,3074448,637650940
1167,3382913125,236671677,3.1950676394999997e-11,53390,3074448,640725388
1170,3955196125,236783435,3.1965763725e-11,65857,3074896,643800284
1173,2564612292,236671587,3.1950664244999994e-11,50470,3074448,646874732
1176,2521472375,236782995,3.1965704325e-11,51554,3074448,649949180
1179,2211431375,236671617,3.1950668295e-11,51430,3074448,653023628
1182,2090944083,236671613,3.195066775499999e-11,51288,3074448,656098076
1185,2092077500,236672857,3.1950835694999995e-11,91729,3075700,659173776
1188,2102263583,236782934,3.1965696089999995e-11,49576,3074448,662248224
1191,2100705834,236671628,3.1950669779999996e-11,51790,3074448,665322672
1194,2100704500,236671611,3.1950667485e-11,51236,3074448,668397120
1197,2087244375,236671617,3.1950668295e-11,51430,3074448,671471568
1200,2088937208,236671619,3.195066856499999e-11,51506,3074448,674546016
1203,2089121542,236672099,3.1950733365e-11,67105,3074896,677620912
1206,2104034875,236671774,3.195068949e-11,56534,3074448,680695360
1209,2093889458,236671870,3.195070245e-11,59640,3074448,683769808
1212,2085991708,236671865,3.1950701775e-11,59490,3074448,686844256
1215,2083524833,236671867,3.1950702045e-11,59564,3074448,689918704
1218,8599556083,236783640,3.1965791399999994e-11,72521,3074896,692993600
1221,2092385708,236783008,3.196570608e-11,51968,3074448,696068048
1224,2091952167,236671676,3.195067626e-11,53356,3074448,699142496
1227,2088543625,236671662,3.195067437e-11,52878,3074448,702216944
1230,2156774667,236671667,3.1950675045e-11,53054,3074448,705291392
1233,2087945459,236671641,3.1950671534999996e-11,52220,3074448,708365840
1236,2088060042,236783109,3.1965719715e-11,55274,3074448,711440288
1239,2085861125,236671799,3.1950692865e-11,57346,3074448,714514736
1242,2089350583,236671826,3.195069651e-11,58204,3074448,717589184
1245,2088844833,236671827,3.1950696645e-11,58254,3074448,720663632
1248,2097746500,236671815,3.1950695024999993e-11,57868,3074448,723738080
1251,2088161375,236783620,3.1965788699999996e-11,71880,3074896,726812976
1254,2087961541,236671769,3.1950688814999997e-11,56360,3074448,729887424
1257,2087438042,236671799,3.1950692865e-11,57346,3074448,732961872
1260,2087784250,236671829,3.1950696915e-11,58330,3074448,736036320
1263,2089251083,236671826,3.195069651e-11,58236,3074448,739110768
1266,8687655958,236783157,3.1965726195e-11,56822,3074448,742185216
1269,2738978875,236672184,3.195074484e-11,69849,3074896,745260112
1272,2998429916,236671757,3.1950687194999996e-11,55986,3074448,748334560
1275,4218220000,236671784,3.1950690839999994e-11,56844,3074448,751409008
1278,3470822834,236671788,3.195069138e-11,56998,3074448,754483456
1281,2940177709,236671786,3.195069111e-11,56922,3074448,757557904
1284,3787860541,236783605,3.1965786675e-11,71395,3074896,760632800
1287,2086845458,236671704,3.195068004e-11,54242,3074448,763707248
1290,2088705708,236671805,3.1950693675e-11,57526,3074448,766781696
1293,2087754834,236671806,3.1950693809999996e-11,57576,3074448,769856144
1296,2085139500,236783123,3.1965721604999996e-11,55716,3074448,772930592
1299,2088056458,236671759,3.1950687464999994e-11,56042,3074448,776005040
1302,2087863084,236672175,3.1950743625e-11,69579,3074896,779079936
1305,2087364208,236671684,3.1950677339999996e-11,53616,3074448,782154384
1308,2087126042,236783069,3.1965714314999995e-11,53952,3074448,785228832
1311,2087006208,236671773,3.1950689355e-11,56502,3074448,788303280
1314,2099956792,236671750,3.195068625e-11,55738,3074448,791377728
1317,2119974584,236671767,3.1950688545e-11,56300,3074448,794452176
1320,2074423458,236672176,3.1950743759999995e-11,69587,3074896,797527072
1323,2089117750,236783056,3.1965712559999995e-11,53530,3074448,800601520
1326,2088523542,236671725,3.1950682875e-11,54942,3074448,803675968
1329,2088565334,236671706,3.195068031e-11,54332,3074448,806750416
1332,2090014084,236671718,3.195068193e-11,54716,3074448,809824864
1335,2089484291,236783551,3.1965779385e-11,69625,3074896,812899760
1338,2090034208,236671644,3.195067193999999e-11,52314,3074448,815974208
1341,2087373542,236671725,3.1950682875e-11,54940,3074448,819048656
1344,2085620375,236671709,3.1950680714999995e-11,54428,3074448,822123104
1347,2087111833,236671723,3.1950682605e-11,54864,3074448,825197552
1350,2087370084,236671715,3.1950681524999995e-11,54614,3074448,828272000
1353,2088047958,236672158,3.1950741329999994e-11,69023,3074896,831346896
1356,27201205084,309088685,4.1726972475e-11,50348,-136895936,694450960
1359,2123304916,236671675,3.1950676125e-11,53330,3074448,697525408
1362,2087138083,236671662,3.195067437e-11,52894,3074448,700599856
1365,2086275584,236671667,3.1950675045e-11,53070,3074448,703674304
1368,2087482833,236811007,3.1969485945e-11,53280,3074448,706748752
1371,2091010958,236672073,3.1950729855e-11,66239,3074896,709823648
1374,2088078709,236671630,3.195067005e-11,51862,3074448,712898096
1377,2086717750,236671694,3.195067869e-11,53934,3074448,715972544
1380,2086417667,236671669,3.1950675315e-11,53120,3074448,719046992
1383,2088207750,236811043,3.1969490804999994e-11,54436,3074448,722121440
1386,2086650209,236671758,3.1950687329999995e-11,56006,3074448,725195888
1389,2087679333,236671838,3.195069813e-11,58626,3074448,728270336
1392,2086183125,236671849,3.1950699614999996e-11,58962,3074448,731344784
1395,2086903125,236811180,3.19695093e-11,58910,3074448,734419232
1398,2100303584,236671858,3.195070083e-11,59262,3074448,737493680
1401,2087992208,236672022,3.195072297e-11,64581,3074896,740568576
1404,2088117875,236671653,3.1950673154999996e-11,52596,3074448,743643024
1407,2091682583,236671609,3.1950667215e-11,51172,3074448,746717472
1410,2086720792,236810942,3.196947717e-11,51180,3074448,749791920
1413,3301734334,236671793,3.1950692055e-11,57158,3074448,752866368
1416,3302660500,236671755,3.1950686925e-11,55910,3074448,755940816
1419,3302524209,236671819,3.1950695564999996e-11,57982,3074448,759015264
1422,3300417708,236811143,3.1969504305e-11,57702,3074448,762089712
1425,3299747000,236671816,3.195069515999999e-11,57898,3074448,765164160
1428,11105401625,236811537,3.1969557495e-11,70512,3074896,768239056
1431,3314228875,236671720,3.1950682199999997e-11,54788,3074448,771313504
1434,2083581959,236811129,3.1969502415e-11,57246,3074448,774387952
1437,3305170334,236671838,3.195069813e-11,58610,3074448,777462400
1440,3304291084,236671812,3.1950694619999997e-11,57778,3074448,780536848
1443,3307466042,236811180,3.19695093e-11,58898,3074448,783611296
1446,3305056250,236672150,3.1950740249999996e-11,68757,3074896,786686192
1449,3309737917,236671786,3.195069111e-11,56924,3074448,789760640
1452,3317186083,236811123,3.1969501605e-11,57048,3074448,792835088
1455,2280091000,236671789,3.1950691514999995e-11,57002,3074448,795909536
1458,2957723041,236671771,3.1950689084999995e-11,56438,3074448,798983984
1461,3259951375,236672182,3.195074457e-11,69779,3074896,802058880
1464,2800425417,236671721,3.1950682334999995e-11,54802,3074448,805133328
1467,3477899666,236811121,3.1969501334999996e-11,56974,3074448,808207776
1470,2433483250,236671781,3.1950690435e-11,56766,3074448,811282224
1473,2503535875,236671788,3.195069138e-11,56974,3074448,814356672
1476,2087637500,236811066,3.1969493909999996e-11,55196,3074448,817431120
1479,2134941416,236672128,3.195073728e-11,68035,3074896,820506016
1482,2150551708,236671671,3.1950675584999996e-11,53184,3074448,823580464
1485,2093387250,236671734,3.1950684089999995e-11,55224,3074448,826654912
1488,2087602250,236671732,3.195068382e-11,55164,3074448,829729360
1491,2086795583,236811075,3.196949512499999e-11,55474,3074448,832803808
1494,2092293500,236671742,3.195068517e-11,55490,3074448,835878256
1497,2087774750,236672107,3.1950734444999996e-11,67361,3074896,838953152
1500,2089088334,236671657,3.1950673695e-11,52714,3074448,842027600
1503,2090059375,236811082,3.196949607e-11,55724,3074448,845102048
1506,2090957750,236671645,3.1950672075e-11,52346,3074448,848176496
1509,2092050750,236671653,3.1950673154999996e-11,52598,3074448,851250944
1512,2086476500,236672893,3.1950840554999996e-11,92895,3075700,854326644
1515,2088489416,236671514,3.195065439e-11,48098,3074448,857401092
1518,2133486041,236810891,3.196947028499999e-11,49508,3074448,860475540
1521,2090438333,236671577,3.1950662895e-11,50120,3074448,863549988
1524,2092223375,236671569,3.1950661814999994e-11,49868,3074448,866624436
1527,2092889583,236671576,3.195066276e-11,50094,3074448,869698884
1530,2090861625,236672110,3.195073485e-11,67435,3074896,872773780
1533,2087275542,236810960,3.19694796e-11,51756,3074448,875848228
1536,2086115625,236671752,3.1950686519999995e-11,55826,3074448,878922676
1539,2090138625,236671839,3.1950698265e-11,58656,3074448,881997124
1542,2089408542,236671831,3.1950697184999996e-11,58396,3074448,885071572
1545,2090991250,236671832,3.195069732e-11,58420,3074448,888146020
1548,2091032958,236811170,3.1969507949999996e-11,58578,3074448,891220468
1551,2089237667,236672055,3.1950727425e-11,65677,3074888,894295356
1554,2086469416,236671689,3.1950678015e-11,53758,3074448,897369804
1557,2093618167,236671759,3.1950687464999994e-11,56032,3074448,900444252
1560,2073318917,236811091,3.1969497285e-11,56030,3074448,903518700
1563,2088532250,236671756,3.195068706e-11,55940,3074448,906593148
1566,3289808291,236671709,3.1950680714999995e-11,54422,3074448,909667596
1569,2086697375,236672095,3.1950732824999996e-11,66963,3074896,912742492
1572,2092904958,236810953,3.1969478655e-11,51514,3074448,915816940
1575,2090561833,236671732,3.195068382e-11,55152,3074448,918891388
1578,2090928042,236671713,3.1950681255e-11,54544,3074448,921965836
1581,2088596167,236671720,3.1950682199999997e-11,54776,3074448,925040284
1584,2091414583,236672144,3.1950739439999996e-11,68543,3074896,928115180
1587,2088010583,236810958,3.196947933e-11,51690,3074448,931189628
1590,11108186209,236811002,3.196948527e-11,53128,3074448,934264076
1593,2091857708,236671727,3.1950683144999996e-11,55006,3074448,937338524
1596,2089838375,236671677,3.1950676394999997e-11,53390,3074448,940412972
1599,2089018166,236671677,3.1950676394999997e-11,53390,3074448,943487420
1602,2089273375,236811420,3.19695417e-11,66693,3074896,946562316
1605,3305581209,236671677,3.1950676394999997e-11,53388,3074448,949636764
1608,3307617250,236671609,3.1950667215e-11,51168,3074448,952711212
1611,3304792667,236671680,3.19506768e-11,53466,3074448,955785660
1614,2097862417,236811017,3.1969487294999995e-11,53616,3074448,958860108
1617,3295920584,236671685,3.1950677474999995e-11,53642,3074448,961934556
1620,3307891334,236672112,3.195073512e-11,67529,3074896,965009452
1623,3306323000,236811057,3.1969492695e-11,54894,3074448,968083900
1626,3304073416,236671735,3.1950684225e-11,55266,3074448,971158348
1629,3290152792,236671730,3.195068355e-11,55088,3074448,974232796
1632,3308425250,236811063,3.1969493505e-11,55114,3074448,977307244
1635,3308040666,236672169,3.1950742815e-11,69359,3074896,980382140
1638,3303871000,236671646,3.195067221e-11,52360,3074448,983456588
1641,3304850125,236811087,3.1969496745e-11,55872,3074448,986531036
1644,3305766125,236671737,3.1950684495e-11,55316,3074448,989605484
1647,3316013000,236671734,3.1950684089999995e-11,55214,3074448,992679932
1650,3322109458,236811054,3.196949229e-11,54806,3074448,995754380
1653,3309053833,236672162,3.1950741869999996e-11,69155,3074896,998829276
1656,3292875292,236671665,3.1950674774999996e-11,52998,3074448,1001903724
1659,3306176875,236811016,3.1969487159999997e-11,53582,3074448,1004978172
1662,3309040708,236671700,3.19506795e-11,54136,3074448,1008052620
1665,3305362375,236671696,3.1950678959999996e-11,53984,3074448,1011127068
1668,3307272083,236811025,3.1969488374999994e-11,53858,3074448,1014201516
1671,3305847334,236672056,3.195072756e-11,65695,3074896,1017276412
1674,4762724416,236671676,3.195067626e-11,53352,3074448,1020350860
1677,4766223791,236811048,3.196949148e-11,54616,3074448,1023425308
1680,11105869959,236811039,3.1969490265e-11,54312,3074448,1026499756
1683,3308182708,236671708,3.1950680579999996e-11,54386,3074448,1029574204
1686,4761347292,236825308,3.197141658e-11,65225,3074896,1032649100
1689,4762172250,236671574,3.1950662489999995e-11,50042,3074448,1035723548
1692,3308794708,236671649,3.1950672615e-11,52470,3074448,1038797996
1695,4761023750,236810976,3.196948176e-11,52268,3074448,1041872444
1698,33413780875,327544792,4.421854692e-11,51054,-172272732,869599712
1701,4773499834,236846032,3.197421431999999e-11,51180,3074448,872674160
1704,4764297792,236846465,3.1974272774999996e-11,65227,3074896,875749056
1707,2536432375,236671575,3.1950662624999994e-11,50068,3074448,878823504
1710,3495028792,236846039,3.1974215265e-11,51382,3074448,881897952
1713,2891987167,236671792,3.195069192e-11,57104,3074448,884972400
1716,3806022042,236846218,3.197423943e-11,57220,3074448,888046848
1719,2946144750,236671826,3.195069651e-11,58204,3074448,891121296
1722,2141762125,236671814,3.195069489e-11,57850,3074448,894195744
1725,2561204250,236846238,3.197424213e-11,57876,3074448,897270192
1728,2109457125,236672161,3.1950741735e-11,69100,3074896,900345088
1731,2092371791,236671761,3.1950687735e-11,56098,3074448,903419536
1734,2088514417,236671841,3.1950698535e-11,58708,3074448,906493984
1737,2087020541,236671818,3.1950695429999997e-11,57968,3074448,909568432
1740,2089909083,236846255,3.1974244425e-11,58428,3074448,912642880
1743,2092090292,236672234,3.195075159e-11,71485,3074896,915717776
1746,2095182583,236671697,3.1950679094999995e-11,54032,3074448,918792224
1749,2072912125,236671801,3.1950693135e-11,57400,3074448,921866672
1752,2095025875,236846221,3.1974239834999994e-11,57322,3074448,924941120
1755,2087874667,236671785,3.1950690975e-11,56888,3074448,928015568
1758,2089332834,236671788,3.195069138e-11,56972,3074448,931090016
1761,2088834333,236672148,3.195073998e-11,68675,3074896,934164912
1764,2092625334,236671705,3.1950680175e-11,54300,3074448,937239360
1767,2088540833,236846227,3.1974240644999995e-11,57500,3074448,940313808
1770,2088279416,236671793,3.1950692055e-11,57156,3074448,943388256
1773,2088581959,236671802,3.1950693269999994e-11,57460,3074448,946462704
1776,2089116792,236671741,3.1950685034999994e-11,55454,3074448,949537152
1779,2088338375,236672110,3.195073485e-11,67433,3074896,952612048
1782,2089605708,236846068,3.197421918e-11,52348,3074448,955686496
1785,2090039000,236671725,3.1950682875e-11,54932,3074448,958760944
1788,2123444167,236671751,3.1950686384999996e-11,55782,3074448,961835392
1791,2090689166,236671756,3.195068706e-11,55950,3074448,964909840
1794,2089471250,236846560,3.19742856e-11,68317,3074896,967984736
1797,2090006250,236671672,3.1950675719999995e-11,53226,3074448,971059184
1800,2089296166,236671646,3.195067221e-11,52368,3074448,974133632
1803,2086553875,236671779,3.1950690165e-11,56698,3074448,977208080
1806,2088251334,236671658,3.195067383e-11,52776,3074448,980282528
1809,3306034541,236846097,3.1974223094999996e-11,53280,3074448,983356976
1812,3307462625,236672843,3.1950833804999997e-11,91283,3075700,986432676
1815,2087405875,236671531,3.1950656684999995e-11,48628,3074448,989507124
1818,3306529625,236671602,3.195066627e-11,50928,3074448,992581572
1821,2090791208,236846021,3.1974212835e-11,50826,3074448,995656020
1824,2088022334,236671577,3.1950662895e-11,50114,3074448,998730468
1827,3329386458,236671597,3.1950665595e-11,50776,3074448,1001804916
1830,2084805583,236671999,3.1950719864999994e-11,63841,3074896,1004879812
1833,3309976875,236846018,3.1974212429999995e-11,50724,3074448,1007954260
1836,2091496541,236671678,3.1950676529999996e-11,53426,3074448,1011028708
1839,3348576416,236671772,3.1950689219999993e-11,56456,3074448,1014103156
1842,2149048791,236846195,3.1974236324999996e-11,56458,3074448,1017177604
1845,3304381292,236671765,3.1950688274999994e-11,56230,3074448,1020252052
1848,2087364208,236671753,3.1950686654999994e-11,55842,3074448,1023326500
1851,3310822917,236671982,3.195071757e-11,63295,3074896,1026401396
1854,2090459583,236845976,3.197420676e-11,49336,3074448,1029475844
1857,3307404333,236671555,3.1950659924999996e-11,49412,3074448,1032550292
1860,3304991250,236671480,3.19506498e-11,46976,3074448,1035624740
1863,2089310667,236671793,3.1950692055e-11,57158,3074448,1038699188
1866,3308167667,236846183,3.1974234704999996e-11,56086,3074448,1041773636
1869,3321998291,236671812,3.1950694619999997e-11,57780,3074448,1044848084
1872,3306295041,236671814,3.195069489e-11,57828,3074448,1047922532
1875,3305288333,236846249,3.1974243615e-11,58234,3074448,1050996980
1878,3306987375,236672218,3.1950749429999996e-11,70978,3074896,1054071876
1881,3374833084,236671720,3.1950682199999997e-11,54764,3074448,1057146324
1884,3350340250,236846222,3.1974239969999993e-11,57348,3074448,1060220772
1887,3308761792,236671819,3.1950695564999996e-11,57998,3074448,1063295220
1890,3302048250,236671829,3.1950696915e-11,58306,3074448,1066369668
1893,3309482833,236846273,3.1974246855e-11,59014,3074448,1069444116
1896,3309970958,236672146,3.1950739709999994e-11,68639,3074896,1072519012
1899,3314380291,236671782,3.195069057e-11,56786,3074448,1075593460
1902,3303885875,236846193,3.1974236055e-11,56400,3074448,1078667908
1905,3306032959,236671770,3.1950688949999996e-11,56410,3074448,1081742356
1908,3304720792,236671781,3.1950690435e-11,56762,3074448,1084816804
1911,3306009250,236846623,3.1974294105e-11,70381,3074896,1087891700
1914,3305614875,236671717,3.1950681795e-11,54664,3074448,1090966148
1917,3302970459,236671783,3.1950690704999995e-11,56836,3074448,1094040596
1920,3337613250,236846211,3.1974238485e-11,56992,3074448,1097115044
1923,3348691625,236671791,3.195069178499999e-11,57088,3074448,1100189492
1926,3309651500,236671736,3.195068436e-11,55310,3074448,1103263940
1929,4768931291,236846553,3.1974284655e-11,68089,3074896,1106338836
1932,4762107875,236671639,3.1950671265e-11,52146,3074448,1109413284
1935,3289661375,236671738,3.195068463e-11,55380,3074448,1112487732
1938,3305180834,236846181,3.1974234435e-11,56010,3074448,1115562180
1941,4775172083,236671735,3.1950684225e-11,55252,3074448,1118636628
1944,3298156041,236671742,3.195068517e-11,55478,3074448,1121711076
1947,3500820416,236863957,3.1976634195e-11,66855,3074896,1124785972
1950,2177475333,236671672,3.1950675719999995e-11,53224,3074448,1127860420
1953,2325143458,236671774,3.195068949e-11,56520,3074448,1130934868
1956,3245891250,236671703,3.1950679904999995e-11,54222,3074448,1134009316
1959,3192808291,236671700,3.19506795e-11,54122,3074448,1137083764
1962,2630902666,236846539,3.1974282764999996e-11,67659,3074896,1140158660
1965,2390121042,236671642,3.195067167e-11,52224,3074448,1143233108
1968,2236701500,236671712,3.195068112e-11,54522,3074448,1146307556
1971,2357468959,236846126,3.197422701e-11,54222,3074448,1149382004
1974,14125577542,236881023,3.1978938104999997e-11,54624,3074448,1152456452
1977,2093328708,236671705,3.1950680175e-11,54272,3074448,1155530900
1980,2086261625,236672096,3.1950732959999995e-11,66985,3074896,1158605796
1983,2092678208,236671619,3.195066856499999e-11,51504,3074448,1161680244
1986,2091163333,236846075,3.197422012499999e-11,52578,3074448,1164754692
1989,2090319125,236671660,3.1950674099999995e-11,52830,3074448,1167829140
1992,2085655666,236671660,3.1950674099999995e-11,52838,3074448,1170903588
1995,2087662792,236671664,3.195067464e-11,52964,3074448,1173978036
1998,11118626333,236846517,3.1974279795e-11,66943,3074896,1177052932
2001,2110193625,236846076,3.197422026e-11,52604,3074448,1180127380
2004,2104423500,236671660,3.1950674099999995e-11,52830,3074448,1183201828
2007,2094179125,236671672,3.1950675719999995e-11,53216,3074448,1186276276
2010,2138243166,236671672,3.1950675719999995e-11,53216,3074448,1189350724
2013,2085984042,236672075,3.1950730125e-11,66317,3074896,1192425620
2016,2091762333,236846201,3.1974237134999996e-11,56654,3074448,1195500068
2019,2089523583,236671852,3.195070002e-11,59052,3074448,1198574516
2022,2091179583,236671828,3.195069677999999e-11,58288,3074448,1201648964
2025,2089380792,236671839,3.1950698265e-11,58648,3074448,1204723412
2028,2090666459,236671838,3.195069813e-11,58596,3074448,1207797860
2031,2090776625,236846393,3.1974263054999994e-11,62909,3074888,1210872748
2034,2090887875,236671739,3.1950684764999996e-11,55382,3074448,1213947196
2037,2088355916,236671849,3.1950699614999996e-11,58958,3074448,1217021644
2040,2087649291,236671863,3.1950701505e-11,59430,3074448,1220096092
2043,2088950833,236846287,3.1974248744999996e-11,59454,3074448,1223170540
2046,2086987834,236671814,3.195069489e-11,57846,3074448,1226244988
2049,2089129583,236672142,3.195073917e-11,68497,3074896,1229319884
2052,2154311125,236671704,3.195068004e-11,54258,3074448,1232394332
2055,2075189625,236671817,3.1950695295e-11,57920,3074448,1235468780
2058,2103265834,236846224,3.197424024e-11,57414,3074448,1238543228
2061,2087887333,236671808,3.195069408e-11,57646,3074448,1241617676
2064,2088175917,236671786,3.195069111e-11,56930,3074448,1244692124
2067,2089749042,236672117,3.1950735795e-11,67683,3074896,1247767020
2070,2087173042,236671716,3.1950681659999994e-11,54652,3074448,1250841468
2073,2091445167,236846241,3.197424253499999e-11,57978,3074448,1253915916
2076,3325438791,236671747,3.1950685844999994e-11,55656,3074448,1256990364
2079,2248173625,236671758,3.1950687329999995e-11,56008,3074448,1260064812
2082,2679691667,236846555,3.1974284925e-11,68169,3074896,1263139708
2085,3152755917,236671746,3.1950685709999995e-11,55610,3074448,1266214156
2088,2781562625,236671729,3.1950683415e-11,55080,3074448,1269288604
2091,3588890834,236671776,3.195068976e-11,56598,3074448,1272363052
2094,2496074167,236671754,3.195068679e-11,55874,3074448,1275437500
2097,3797314458,236846187,3.1974235245e-11,56210,3074448,1278511948
2100,2084920000,236672082,3.1950731069999997e-11,66557,3074896,1281586844
2103,2088256625,236671681,3.1950676935e-11,53504,3074448,1284661292
2106,2090244958,236671682,3.195067707e-11,53544,3074448,1287735740
2109,2092981542,236846102,3.197422377e-11,53442,3074448,1290810188
2112,2090229291,236671677,3.1950676394999997e-11,53366,3074448,1293884636
2115,2086802916,236671677,3.1950676394999997e-11,53366,3074448,1296959084
2118,2125823333,236672780,3.19508253e-11,89213,3075700,1300034784
2121,2134421166,236671538,3.1950657629999994e-11,48868,3074448,1303109232
2124,40867294208,350757372,4.735224522e-11,50940,-215341232,1087768000
2127,2096349875,236671597,3.1950665595e-11,50762,3074448,1090842448
2130,2092837166,236671600,3.1950665999999994e-11,50888,3074448,1093916896
2133,2086364458,236890091,3.198016228499999e-11,65529,3074896,1096991792
2136,2094965250,236671467,3.1950648045e-11,46570,3074448,1100066240
2139,2089837459,236671541,3.1950658035e-11,48946,3074448,1103140688
2142,2089847583,236671547,3.1950658845e-11,49148,3074448,1106215136
2145,2087873375,236671510,3.195065385e-11,47934,3074448,1109289584
2148,2086854875,236889539,3.198008776499999e-11,47598,3074448,1112364032
2151,2085781875,236672062,3.195072837e-11,65905,3074896,1115438928
2154,2087939000,236671607,3.195066694499999e-11,51118,3074448,1118513376
2157,2091205042,236671636,3.195067086e-11,52054,3074448,1121587824
2160,2089192208,236671564,3.195066114e-11,49694,3074448,1124662272
2163,2088568709,236889836,3.1980127859999997e-11,57260,3074448,1127736720
2166,2085974166,236671806,3.1950693809999996e-11,57586,3074448,1130811168
2169,2114456583,236671833,3.1950697455e-11,58444,3074448,1133885616
2172,2580152250,236889862,3.1980131369999995e-11,58090,3074448,1136960064
2175,2479386000,236671832,3.195069732e-11,58416,3074448,1140034512
2178,4115046583,236672180,3.19507443e-11,69714,3074896,1143109408
2181,3027001709,236889849,3.1980129614999996e-11,57660,3074448,1146183856
2184,3815188875,236671844,3.1950698939999995e-11,58798,3074448,1149258304
2187,2893487333,236889861,3.1980131234999996e-11,58058,3074448,1152332752
2190,2105614333,236671831,3.1950697184999996e-11,58392,3074448,1155407200
2193,2087274833,236672258,3.195075483e-11,72260,3074896,1158482096
2196,2093497958,236671704,3.195068004e-11,54260,3074448,1161556544
2199,2106280958,236889831,3.1980127184999995e-11,57090,3074448,1164630992
2202,2086041500,236671783,3.1950690704999995e-11,56830,3074448,1167705440
2205,2089558125,236671802,3.1950693269999994e-11,57446,3074448,1170779888
2208,2087530625,236671800,3.1950692999999996e-11,57368,3074448,1173854336
2211,2103946500,236672158,3.1950741329999994e-11,68997,3074896,1176929232
2214,2123379000,236889776,3.1980119759999995e-11,55296,3074448,1180003680
2217,2090739084,236671790,3.1950691649999994e-11,57064,3074448,1183078128
2220,2086932292,236671783,3.1950690704999995e-11,56832,3074448,1186152576
2223,2091693167,236671811,3.1950694485e-11,57730,3074448,1189227024
2226,2092559333,236889785,3.1980120975e-11,55598,3074448,1192301472
2229,2089339792,236672134,3.1950738089999994e-11,68219,3074896,1195376368
2232,2088371500,236671698,3.195067923e-11,54064,3074448,1198450816
2235,2089010583,236671731,3.1950683685e-11,55126,3074448,1201525264
2238,2087754500,236671763,3.1950688004999997e-11,56162,3074448,1204599712
2241,2092150250,236889810,3.198012435e-11,56388,3074448,1207674160
2244,2076425334,236672160,3.19507416e-11,69065,3074896,1210749056
2247,2087828958,236671730,3.195068355e-11,55098,3074448,1213823504
2250,2134951000,236671662,3.195067437e-11,52878,3074448,1216897952
2253,2087503375,236671773,3.1950689355e-11,56496,3074448,1219972400
2256,2088052875,236889746,3.198011571e-11,54334,3074448,1223046848
2259,2091192292,236671718,3.195068193e-11,54704,3074448,1226121296
2262,2090917292,236672091,3.1950732285e-11,66823,3074896,1229196192
2265,2087868250,236671673,3.1950675855e-11,53236,3074448,1232270640
2268,2085576875,236671719,3.1950682065e-11,54750,3074448,1235345088
2271,2087454417,236671701,3.1950679635e-11,54164,3074448,1238419536
2274,3310867291,236671714,3.1950681389999996e-11,54600,3074448,1241493984
2277,2088299834,236671718,3.195068193e-11,54700,3074448,1244568432
2280,2091784208,236672053,3.1950727154999995e-11,65611,3074896,1247643328
2283,2089803417,236889760,3.19801176e-11,54766,3074448,1250717776
2286,2101215750,236671674,3.195067599e-11,53292,3074448,1253792224
2289,2097757709,236671669,3.1950675315e-11,53124,3074448,1256866672
2292,2074467500,236671670,3.195067545e-11,53166,3074448,1259941120
2295,2087344291,236890119,3.1980166064999996e-11,66457,3074896,1263016016
2298,3308038416,236671580,3.1950663299999995e-11,50234,3074448,1266090464
2301,2088549583,236671648,3.195067248e-11,52432,3074448,1269164912
2304,2101137417,236671664,3.195067464e-11,52956,3074448,1272239360
2307,2089988042,236671661,3.1950674235e-11,52856,3074448,1275313808
2310,2088265709,236889721,3.1980112335e-11,53518,3074448,1278388256
2313,17706825083,236911916,3.198310866e-11,66207,3074896,1281463152
2316,2093065125,236671778,3.1950690029999994e-11,56642,3074448,1284537600
2319,2093287584,236889897,3.1980136095e-11,59240,3074448,1287612048
2322,3305264167,236671846,3.195069921e-11,58872,3074448,1290686496
2325,2152668167,236671849,3.1950699614999996e-11,58972,3074448,1293760944
2328,2091255375,236671859,3.1950700965e-11,59298,3074448,1296835392
2331,2089281000,236890006,3.198015081e-11,62789,3074896,1299910288
2334,2088859042,236671599,3.1950665864999995e-11,50840,3074448,1302984736
2337,2089912750,236671601,3.1950666135e-11,50908,3074448,1306059184
2340,3308872375,236671564,3.195066114e-11,49694,3074448,1309133632
2343,3306070875,236889834,3.198012759e-11,57194,3074448,1312208080
2346,3307604000,236671756,3.195068706e-11,55946,3074448,1315282528
2349,3304897958,236671813,3.1950694755e-11,57790,3074448,1318356976
2352,3308053875,236889851,3.1980129884999994e-11,57738,3074448,1321431424
2355,3303749458,236671817,3.1950695295e-11,57934,3074448,1324505872
2358,3304791792,236672144,3.1950739439999996e-11,68560,3074896,1327580768
2361,3297181291,236889795,3.1980122324999995e-11,55920,3074448,1330655216
2364,4760768208,236671790,3.1950691649999994e-11,57048,3074448,1333729664
2367,3305275084,236671816,3.195069515999999e-11,57908,3074448,1336804112
2370,3305185417,236889862,3.1980131369999995e-11,58090,3074448,1339878560
2373,3303643958,236671847,3.195069934499999e-11,58910,3074448,1342953008
2376,3301582958,236672072,3.195072972e-11,66231,3074896,1346027904
2379,3305790791,236889806,3.1980123809999996e-11,56272,3074448,1349102352
2382,3305943917,236671781,3.1950690435e-11,56766,3074448,1352176800
2385,3305582792,236671761,3.1950687735e-11,56098,3074448,1355251248
2388,3307883375,236889820,3.19801257e-11,56718,3074448,1358325696
2391,3304554250,236672128,3.195073728e-11,68035,3074896,1361400592
2394,3304495875,236671711,3.1950680985e-11,54478,3074448,1364475040
2397,3304609625,236889813,3.1980124754999995e-11,56490,3074448,1367549488
2400,3376896542,236671786,3.195069111e-11,56938,3074448,1370623936
2403,2630317584,236889818,3.1980125429999996e-11,56660,3074448,1373698384
2406,3039949666,236671690,3.1950678149999996e-11,53810,3074448,1376772832
2409,4237929750,236672021,3.1950722834999996e-11,64543,3074896,1379847728
2412,4865855416,236889705,3.1980110175e-11,52984,3074448,1382922176
2415,2266210625,236671701,3.1950679635e-11,54148,3074448,1385996624
2418,2126903416,236671689,3.1950678015e-11,53770,3074448,1389071072
2421,2194050583,236671700,3.19506795e-11,54122,3074448,1392145520
2424,2092804833,236671690,3.1950678149999996e-11,53786,3074448,1395219968
2427,2091452833,236672849,3.1950834615e-11,91465,3075700,1398295668
2430,2087750583,236671702,3.1950679769999996e-11,54196,3074448,1401370116
2433,2087758291,236889753,3.1980116655e-11,54542,3074448,1404444564
2436,2088507625,236671648,3.195067248e-11,52436,3074448,1407519012
2439,2148567250,236671652,3.195067302e-11,52562,3074448,1410593460
2442,2077811375,236672092,3.195073242e-11,66861,3074896,1413668356
2445,2105840584,236889670,3.198010545e-11,51854,3074448,1416742804
2448,2087045167,236671665,3.1950674774999996e-11,52990,3074448,1419817252
2451,2088623250,236671660,3.1950674099999995e-11,52814,3074448,1422891700
2454,2090419833,236671660,3.1950674099999995e-11,52814,3074448,1425966148
2457,2090623375,236671660,3.1950674099999995e-11,52814,3074448,1429040596
2460,2088789500,236890151,3.1980170385e-11,67491,3074896,1432115492
2463,2088847958,236671622,3.1950668969999996e-11,51594,3074448,1435189940
2466,2086147667,236671788,3.195069138e-11,56978,3074448,1438264388
2469,2086902833,236671850,3.1950699749999995e-11,58998,3074448,1441338836
2472,2086968583,236671826,3.195069651e-11,58234,3074448,1444413284
2475,2088960334,236889878,3.198013353e-11,58594,3074448,1447487732
2478,2088450208,236671828,3.195069677999999e-11,58290,3074448,1450562180
2481,2089539583,236672096,3.1950732959999995e-11,67003,3074888,1453637068
2484,2104204500,236671801,3.1950693135e-11,57408,3074448,1456711516
2487,2086492542,236889886,3.198013461e-11,58874,3074448,1459785964
2490,2093680250,236671845,3.1950699075e-11,58846,3074448,1462860412
2493,2090712042,236671842,3.195069867e-11,58742,3074448,1465934860
2496,2088974125,236672177,3.1950743894999994e-11,69627,3074896,1469009756
2499,2090833417,236671793,3.1950692055e-11,57136,3074448,1472084204
2502,2087964542,236889902,3.198013677e-11,59410,3074448,1475158652
2505,2090736666,236671885,3.1950704475e-11,60142,3074448,1478233100
2508,2087973791,236671895,3.1950705825e-11,60468,3074448,1481307548
2511,17717385083,237107970,3.200957595e-11,60288,3074448,1484381996
2514,2091973458,236672245,3.1950753075e-11,71827,3074896,1487456892
2517,2092236375,236671797,3.195069259499999e-11,57288,3074448,1490531340
2520,2090182000,236671896,3.195070596e-11,60496,3074448,1493605788
2523,2089095959,236671902,3.195070677e-11,60704,3074448,1496680236
2526,2077430917,236889897,3.1980136095e-11,59214,3074448,1499754684
2529,2088757625,236671854,3.195070029e-11,59114,3074448,1502829132
2532,2102599375,236672222,3.195074997e-11,71109,3074896,1505904028
2535,2090511709,236671860,3.19507011e-11,59338,3074448,1508978476
2538,3313267875,236889857,3.1980130694999994e-11,57928,3074448,1512052924
2541,3310955833,236671846,3.195069921e-11,58854,3074448,1515127372
2544,3305208417,236671856,3.1950700559999996e-11,59190,3074448,1518201820
2547,3305820792,236890285,3.1980188475e-11,71833,3074896,1521276716
2550,2088403917,236671824,3.195069624e-11,58152,3074448,1524351164
2553,3305160333,236671778,3.1950690029999994e-11,56660,3074448,1527425612
2556,3307519708,236671825,3.1950696374999996e-11,58184,3074448,1530500060
2559,3305851333,236889854,3.198013029e-11,57830,3074448,1533574508
2562,3305869459,236671802,3.1950693269999994e-11,57422,3074448,1536648956
2565,3307784250,236672167,3.1950742545e-11,69317,3074896,1539723852
2568,2093028500,236889796,3.198012246e-11,55938,3074448,1542798300
2571,3305949541,236671824,3.195069624e-11,58160,3074448,1545872748
2574,3305694833,236671812,3.1950694619999997e-11,57756,3074448,1548947196
2577,3304754791,236889859,3.1980130965e-11,57982,3074448,1552021644
2580,3307194083,236671801,3.1950693135e-11,57398,3074448,1555096092
2583,3306010500,236672158,3.1950741329999994e-11,69027,3074896,1558170988
2586,2092858167,236671700,3.19506795e-11,54126,3074448,1561245436
2589,3322598333,236889808,3.198012408e-11,56348,3074448,1564319884
2592,4025864000,236671778,3.1950690029999994e-11,56676,3074448,1567394332
2595,2728751083,236889812,3.1980124619999996e-11,56474,3074448,1570468780
2598,2590335875,236672159,3.195074146499999e-11,69061,3074896,1573543676
2601,5186589542,236671666,3.1950674909999995e-11,53006,3074448,1576618124
2604,5808725250,236671764,3.1950688139999995e-11,56196,3074448,1579692572
2607,2734062083,236671779,3.1950690165e-11,56702,3074448,1582767020
2610,2516136500,236889816,3.198012516e-11,56600,3074448,1585841468
2613,2090464750,236671789,3.1950691514999995e-11,57002,3074448,1588915916
2616,2092220791,236672066,3.195072891e-11,66013,3074896,1591990812
2619,2147530292,236889731,3.1980113685e-11,53848,3074448,1595065260
2622,2075809750,236671691,3.1950678284999995e-11,53848,3074448,1598139708
2625,2103825125,236671716,3.1950681659999994e-11,54658,3074448,1601214156
2628,2087638291,236671689,3.1950678015e-11,53772,3074448,1604288604
2631,2088699000,236671689,3.1950678015e-11,53772,3074448,1607363052
2634,2088809500,236890150,3.1980170249999996e-11,67447,3074896,1610437948
2637,2092618792,236671724,3.195068274e-11,54910,3074448,1613512396
2640,60519296375,378821588,5.114091437999999e-11,55188,-261484696,1352027700
2643,2092925750,236942201,3.1987197134999994e-11,59990,3074448,1355102148
2646,2090100917,236671886,3.1950704609999996e-11,60190,3074448,1358176596
2649,2092161334,236671912,3.1950708119999995e-11,61006,3074448,1361251044
2652,2088844667,236671910,3.195070785e-11,60946,3074448,1364325492
2655,2088409291,236671898,3.1950706229999997e-11,60546,3074448,1367399940
2658,2090354209,236942513,3.1987239254999995e-11,70116,3074896,1370474836
2661,2088932792,236671893,3.1950705554999995e-11,60390,3074448,1373549284
2664,2104008417,236671924,3.1950709739999995e-11,61402,3074448,1376623732
2667,2085998334,236671923,3.1950709604999996e-11,61376,3074448,1379698180
2670,2090551083,236671919,3.1950709065e-11,61248,3074448,1382772628
2673,2156743875,236942586,3.198724911e-11,72493,3074896,1385847524
2676,2441652125,236671779,3.1950690165e-11,56684,3074448,1388921972
2679,2735592167,236671874,3.1950702989999996e-11,59792,3074448,1391996420
2682,3011582834,236942183,3.1987194704999994e-11,59380,3074448,1395070868
2685,2772160583,236671873,3.1950702855e-11,59744,3074448,1398145316
2688,4121353084,236942195,3.1987196324999994e-11,59792,3074448,1401219764
2691,2665367917,236672168,3.1950742679999997e-11,69345,3074896,1404294660
2694,2298609166,236671814,3.195069489e-11,57846,3074448,1407369108
2697,2093877500,236942203,3.1987197405e-11,60026,3074448,1410443556
2700,2107867250,236671889,3.1950705015e-11,60276,3074448,1413518004
2703,2142900791,236671889,3.1950705015e-11,60278,3074448,1416592452
2706,2085468875,236671792,3.195069192e-11,57128,3074448,1419666900
2709,17705040916,237293875,3.2034673125e-11,68321,3074896,1422741796
2712,2107717208,236671888,3.195070488e-11,60236,3074448,1425816244
2715,2092079500,236671895,3.1950705825e-11,60462,3074448,1428890692
2718,2090797584,236671889,3.1950705015e-11,60262,3074448,1431965140
2721,2092137250,236942207,3.1987197944999994e-11,60162,3074448,1435039588
2724,2088358167,236673092,3.195086742e-11,99379,3075700,1438115288
2727,2086236333,236671725,3.1950682875e-11,54930,3074448,1441189736
2730,2089756417,236671806,3.1950693809999996e-11,57556,3074448,1444264184
2733,2089556584,236671806,3.1950693809999996e-11,57590,3074448,1447338632
2736,2091714750,236942075,3.1987180125e-11,55896,3074448,1450413080
2739,2089812500,236671758,3.1950687329999995e-11,55996,3074448,1453487528
2742,2107995333,236672140,3.1950738899999994e-11,68425,3074896,1456562424
2745,2092793250,236671664,3.195067464e-11,52964,3074448,1459636872
2748,2088787125,236671774,3.195068949e-11,56526,3074448,1462711320
2751,2088664167,236942085,3.1987181475e-11,56198,3074448,1465785768
2754,2087380667,236671762,3.195068787e-11,56148,3074448,1468860216
2757,2090442500,236671756,3.195068706e-11,55938,3074448,1471934664
2760,2089601167,236672113,3.1950735254999996e-11,67559,3074896,1475009560
2763,2088846333,236671787,3.1950691245e-11,56952,3074448,1478084008
2766,2087583792,236942226,3.1987200509999994e-11,60782,3074448,1481158456
2769,2087507292,236671922,3.195070947e-11,61342,3074448,1484232904
2772,2092445500,236671920,3.19507092e-11,61290,3074448,1487307352
2775,2090608750,236672146,3.1950739709999994e-11,68635,3074896,1490382248
2778,2090866708,236671798,3.195069273e-11,57304,3074448,1493456696
2781,2089836917,236942126,3.1987187009999995e-11,57530,3074448,1496531144
2784,2116081166,236671794,3.1950692189999996e-11,57196,3074448,1499605592
2787,2132125208,236671804,3.195069354e-11,57506,3074448,1502680040
2790,2079272500,236672204,3.195074754e-11,70509,3074896,1505754936
2793,2088069292,236942074,3.198717998999999e-11,55854,3074448,1508829384
2796,2088180875,236671726,3.1950683009999997e-11,54952,3074448,1511903832
2799,2089454459,236671765,3.1950688274999994e-11,56248,3074448,1514978280
2802,3306300083,236671758,3.1950687329999995e-11,56022,3074448,1518052728
2805,3305552958,236942083,3.1987181204999996e-11,56148,3074448,1521127176
2808,3307767875,236672130,3.195073755e-11,68091,3074896,1524202072
2811,2089113917,236671668,3.195067518e-11,53090,3074448,1527276520
2814,3384295166,236942095,3.1987182824999996e-11,56526,3074448,1530350968
2817,2354646208,236671774,3.195068949e-11,56550,3074448,1533425416
2820,3771805208,236671766,3.1950688409999993e-11,56274,3074448,1536499864
2823,3114989208,236942131,3.1987187684999997e-11,57702,3074448,1539574312
2826,4212696209,236671758,3.1950687329999995e-11,56024,3074448,1542648760
2829,4116363166,236942160,3.19871916e-11,58644,3074448,1545723208
2832,2557594291,236671855,3.1950700424999997e-11,59156,3074448,1548797656
2835,2125789750,236671846,3.195069921e-11,58852,3074448,1551872104
2838,2094215250,236942171,3.1987193085e-11,59002,3074448,1554946552
2841,2088108834,236672084,3.1950731339999995e-11,66603,3074888,1558021440
2844,2107325167,236671766,3.1950688409999993e-11,56276,3074448,1561095888
2847,2107795916,236671839,3.1950698265e-11,58644,3074448,1564170336
2850,2105721292,236671855,3.1950700424999997e-11,59156,3074448,1567244784
2853,2101015542,236942175,3.1987193624999996e-11,59144,3074448,1570319232
2856,2095995542,236671792,3.195069192e-11,57110,3074448,1573393680
2859,2091779834,236672136,3.195073836e-11,68295,3074896,1576468576
2862,2088504125,236671710,3.1950680849999994e-11,54438,3074448,1579543024
2865,2088096084,236671808,3.195069408e-11,57646,3074448,1582617472
2868,2088807209,236942131,3.1987187684999997e-11,57720,3074448,1585691920
2871,2088930958,236671823,3.1950696105e-11,58126,3074448,1588766368
2874,2098552875,236671814,3.195069489e-11,57824,3074448,1591840816
2877,2090638000,236672104,3.195073404e-11,67271,3074896,1594915712
2880,2088573208,236942045,3.1987176074999997e-11,54916,3074448,1597990160
2883,2089694042,236671824,3.195069624e-11,58158,3074448,1601064608
2886,2088825750,236671779,3.1950690165e-11,56692,3074448,1604139056
2889,2087788042,236671772,3.1950689219999993e-11,56466,3074448,1607213504
2892,2087393625,236672117,3.1950735795e-11,67675,3074896,1610288400
2895,2088707292,236942067,3.1987179045e-11,55630,3074448,1613362848
2898,2087277250,236671738,3.195068463e-11,55344,3074448,1616437296
2901,2087093791,236671770,3.1950688949999996e-11,56416,3074448,1619511744
2904,2090167958,236671784,3.1950690839999994e-11,56868,3074448,1622586192
2907,2091715750,236671774,3.195068949e-11,56516,3074448,1625660640
2910,2086521708,236942407,3.1987224945e-11,66683,3074896,1628735536
2913,2147808500,236671718,3.195068193e-11,54700,3074448,1631809984
2916,2135714542,236671739,3.1950684764999996e-11,55410,3074448,1634884432
2919,2092293583,236671742,3.195068517e-11,55510,3074448,1637958880
2922,2088760167,236942060,3.19871781e-11,55408,3074448,1641033328
2925,2088118833,236671738,3.195068463e-11,55360,3074448,1644107776
2928,2092224542,236672039,3.1950725264999997e-11,65139,3074896,1647182672
2931,3305394584,236671705,3.1950680175e-11,54274,3074448,1650257120
2934,3306628125,236942064,3.1987178639999996e-11,55536,3074448,1653331568
2937,3307414000,236671742,3.195068517e-11,55484,3074448,1656406016
2940,3306707750,236671745,3.1950685574999996e-11,55584,3074448,1659480464
2943,2087930416,236672119,3.1950736064999996e-11,67733,3074896,1662555360
2946,3352512042,236941914,3.198715839e-11,50658,3074448,1665629808
2949,3363975167,236671661,3.1950674235e-11,52864,3074448,1668704256
2952,3310035083,236671690,3.1950678149999996e-11,53800,3074448,1671778704
2955,3305613667,236942024,3.198717323999999e-11,54228,3074448,1674853152
2958,2088099583,236671701,3.1950679635e-11,54152,3074448,1677927600
2961,3305086625,236672034,3.1950724589999995e-11,64983,3074896,1681002496
2964,3305579958,236941960,3.1987164599999996e-11,52156,3074448,1684076944
2967,3305247916,236671706,3.195068031e-11,54330,3074448,1687151392
2970,2094469500,236671699,3.1950679365e-11,54102,3074448,1690225840
2973,2458020916,236942037,3.1987174995e-11,54640,3074448,1693300288
2976,2849710333,236671636,3.195067086e-11,52042,3074448,1696374736
2979,2979016083,236672004,3.195072054e-11,64007,3074896,1699449632
2982,2637063500,236941937,3.1987161494999994e-11,51400,3074448,1702524080
2985,3241425208,236671654,3.195067329e-11,52614,3074448,1705598528
2988,2807897084,236671572,3.195066222e-11,49976,3074448,1708672976
2991,2536028334,236671572,3.195066222e-11,49976,3074448,1711747424
2994,2597989667,236671967,3.1950715544999995e-11,62803,3074896,1714822320
2997,2090433333,236671617,3.1950668295e-11,51426,3074448,1717896768
3000,2089690583,236671611,3.1950667485e-11,51248,3074448,1720971216
3003,2086224417,236989901,3.1993636635e-11,58920,3074452,1724045668
3006,2091795875,236719477,3.1957129395e-11,55560,3074452,1727120120
3009,2091632417,236719478,3.195712953e-11,55586,3074452,1730194572
3012,2089560792,236719484,3.195713034e-11,55788,3074452,1733269024
3015,2088030375,236719474,3.195712899e-11,55460,3074452,1736343476
3018,2089939125,236990253,3.1993684154999996e-11,70327,3074900,1739418376
3021,2088811792,236719477,3.1957129395e-11,55558,3074452,1742492828
3024,2088204834,236719459,3.1957126965e-11,54974,3074452,1745567280
3027,2089327250,236719482,3.1957130069999994e-11,55710,3074452,1748641732
3030,73370078750,400537832,5.4072607319999996e-11,55148,-196882956,1551758776
3033,2092717167,236720010,3.1957201349999994e-11,72889,3074900,1554833676
3036,2088954459,236719509,3.1957133715e-11,56606,3074452,1557908128
3039,2087946917,236719518,3.195713493e-11,56874,3074452,1560982580
3042,2088960042,236719522,3.195713547e-11,57008,3074452,1564057032
3045,2088437958,237020315,3.1997742525e-11,57108,3074452,1567131484
3048,2087634291,236719525,3.1957135875e-11,57108,3074452,1570205936
3051,2071611666,236720032,3.1957204319999997e-11,73609,3074900,1573280836
3054,2089246875,236719496,3.195713196e-11,56180,3074452,1576355288
3057,2089032167,236719536,3.1957137359999995e-11,57484,3074452,1579429740
3060,2088512916,237020319,3.1997743064999997e-11,57258,3074452,1582504192
3063,2089263000,236719440,3.19571244e-11,54370,3074452,1585578644
3066,2088608333,236719639,3.1957151265e-11,60808,3074452,1588653096
3069,2117813084,236719717,3.195716179499999e-11,63366,3074452,1591727548
3072,2127895667,236719704,3.195716003999999e-11,62912,3074452,1594802000
3075,2093146791,237020485,3.1997765474999996e-11,62626,3074452,1597876452
3078,2087985875,236719700,3.19571595e-11,62784,3074452,1600950904
3081,2092602791,236719991,3.1957198784999995e-11,72259,3074892,1604025796
3084,2088722458,236719605,3.1957146675e-11,59708,3074452,1607100248
3087,3306474750,237020495,3.1997766825e-11,62966,3074452,1610174700
3090,2088957583,236719709,3.1957160715e-11,63092,3074452,1613249152
3093,2095578959,236719720,3.1957162199999996e-11,63450,3074452,1616323604
3096,2089498000,236719649,3.1957152615e-11,61148,3074452,1619398056
3099,2088322500,236720088,3.1957211879999996e-11,75397,3074900,1622472956
3102,2087210958,237020354,3.199774778999999e-11,58372,3074452,1625547408
3105,2092503250,236719666,3.1957154909999994e-11,61682,3074452,1628621860
3108,2087361083,236719661,3.1957154235e-11,61528,3074452,1631696312
3111,2091606750,236719658,3.195715383e-11,61430,3074452,1634770764
3114,2106039208,237020925,3.1997824875e-11,76950,3074900,1637845664
3117,2090461959,236719572,3.1957142219999996e-11,58624,3074452,1640920116
3120,2089020709,236719610,3.1957147349999995e-11,59878,3074452,1643994568
3123,2090600000,236719667,3.195715504499999e-11,61714,3074452,1647069020
3126,3305539958,236719607,3.1957146945e-11,59788,3074452,1650143472
3129,2091915541,237020410,3.199775535e-11,60198,3074452,1653217924
3132,22026988292,237351743,3.2042485305e-11,75293,3074900,1656292824
3135,3310253417,236719629,3.1957149914999994e-11,60498,3074452,1659367276
3138,2091252667,236719597,3.1957145594999996e-11,59470,3074452,1662441728
3141,3304596750,236719628,3.1957149779999995e-11,60450,3074452,1665516180
3144,2087036875,237020419,3.1997756564999995e-11,60500,3074452,1668590632
3147,3302211792,236719632,3.195715032e-11,60600,3074452,1671665084
3150,2109007250,236720078,3.1957210529999993e-11,75079,3074900,1674739984
3153,2482234083,237020330,3.199774455e-11,57608,3074452,1677814436
3156,2210353958,236719587,3.1957144245e-11,59118,3074452,1680888888
3159,2687403542,236719581,3.1957143435e-11,58940,3074452,1683963340
3162,4097669375,237020382,3.1997751569999995e-11,59292,3074452,1687037792
3165,3207802833,236720070,3.195720945e-11,74815,3074900,1690112692
3168,4248310459,236719494,3.1957131689999994e-11,56110,3074452,1693187144
3171,27470506917,237772361,3.2099268735e-11,59420,3074452,1696261596
3174,2143561584,236719583,3.1957143705e-11,58990,3074452,1699336048
3177,2084626916,236719586,3.1957144109999994e-11,59090,3074452,1702410500
3180,2106807208,236719590,3.1957144649999997e-11,59218,3074452,1705484952
3183,2099386708,237020849,3.1997814614999994e-11,74463,3074900,1708559852
3186,2087423917,236719434,3.195712359e-11,54164,3074452,1711634304
3189,2086263875,236719559,3.1957140465e-11,58212,3074452,1714708756
3192,2083954167,236719551,3.1957139385e-11,57960,3074452,1717783208
3195,2085556125,236719552,3.195713952e-11,58010,3074452,1720857660
3198,2087087083,237020339,3.1997745765e-11,57884,3074452,1723932112
3201,2086894500,236719958,3.195719433e-11,71177,3074900,1727007012
3204,2087106167,236719511,3.1957133984999996e-11,56654,3074452,1730081464
3207,2086633459,236719542,3.1957138169999996e-11,57656,3074452,1733155916
3210,2085482416,236719556,3.195714006e-11,58110,3074452,1736230368
3213,2087861042,237020350,3.1997747249999996e-11,58270,3074452,1739304820
3216,2168784291,236720005,3.1957200675e-11,72727,3074900,1742379720
3219,2107217375,236719458,3.1957126829999994e-11,54946,3074452,1745454172
3222,2084678583,236719420,3.1957121699999995e-11,53690,3074452,1748528624
3225,2086099750,236719452,3.195712602e-11,54744,3074452,1751603076
3228,2087162375,237020203,3.1997727404999996e-11,53480,3074452,1754677528
3231,2085577125,236719446,3.195712521e-11,54534,3074452,1757751980
3234,2086472875,236719935,3.1957191224999995e-11,70433,3074900,1760826880
3237,2085670416,236719467,3.1957128045e-11,55222,3074452,1763901332
3240,2086366458,237020295,3.1997739825e-11,56478,3074452,1766975784
3243,2086296833,236719650,3.195715275e-11,61178,3074452,1770050236
3246,2084689458,236719659,3.1957153964999995e-11,61462,3074452,1773124688
3249,2085996708,236719678,3.1957156529999995e-11,62094,3074452,1776199140
3252,3304112333,236719680,3.19571568e-11,62134,3074452,1779273592
3255,3320679708,237020483,3.1997765205e-11,62586,3074452,1782348044
3258,3303692958,236720055,3.1957207425e-11,74330,3074900,1785422944
3261,2088576667,236719657,3.1957153695e-11,61410,3074452,1788497396
3264,3306015041,237020474,3.1997763989999995e-11,62262,3074452,1791571848
3267,3302593750,236719675,3.1957156125e-11,61976,3074452,1794646300
3270,3302618333,236719685,3.1957157474999994e-11,62310,3074452,1797720752
3273,3301320417,236720078,3.1957210529999993e-11,75075,3074892,1800795644
3276,2087717625,237020356,3.1997748059999996e-11,58454,3074452,1803870096
3279,3303901500,236719664,3.1957154639999996e-11,61626,3074452,1806944548
3282,3301082833,236719653,3.1957153154999995e-11,61270,3074452,1810019000
3285,3302220708,237020422,3.199775697e-11,60586,3074452,1813093452
3288,2110513250,236719645,3.1957152075e-11,61004,3074452,1816167904
3291,3303293333,236720857,3.1957315694999994e-11,100419,3075704,1819243608
3294,3301241458,236719475,3.1957129124999995e-11,55500,3074452,1822318060
3297,3301561833,236719557,3.1957140195e-11,58162,3074452,1825392512
3300,2086868958,236719566,3.1957141409999996e-11,58440,3074452,1828466964
3303,3303620833,236719572,3.1957142219999996e-11,58640,3074452,1831541416
3306,3302419667,237020277,3.1997737394999996e-11,55886,3074452,1834615868
3309,3303639375,236719941,3.1957192034999995e-11,70645,3074900,1837690768
3312,3302382291,236719489,3.195713101499999e-11,55934,3074452,1840765220
3315,3300238209,237020282,3.1997738069999997e-11,56034,3074452,1843839672
3318,3300977833,236719492,3.1957131419999997e-11,56034,3074452,1846914124
3321,88829564166,416608175,5.6242103624999993e-11,55860,-146125092,1700789032
3324,2990908667,236720001,3.1957200135e-11,72573,3074900,1703863932
3327,2562140916,236719423,3.1957122105e-11,53802,3074452,1706938384
3330,3034522584,237042782,3.2000775569999996e-11,55932,3074452,1710012836
3333,2932795375,236719496,3.195713196e-11,56168,3074452,1713087288
3336,3057005958,237042744,3.200077044e-11,54700,3074452,1716161740
3339,2917422250,236719427,3.1957122644999994e-11,53912,3074452,1719236192
3342,2567829791,236719955,3.1957193925e-11,71089,3074900,1722311092
3345,2142780000,237042738,3.2000769629999997e-11,54524,3074452,1725385544
3348,2097381083,236719551,3.1957139385e-11,57960,3074452,1728459996
3351,2096832291,236719556,3.195714006e-11,58110,3074452,1731534448
3354,2142135542,236719537,3.1957137495e-11,57498,3074452,1734608900
3357,2093387083,236719537,3.1957137495e-11,57498,3074452,1737683352
3360,2091291750,237043216,3.200083416e-11,70041,3074900,1740758252
3363,2090304209,236719447,3.1957125345e-11,54582,3074452,1743832704
3366,2088260500,236719532,3.195713682e-11,57326,3074452,1746907156
3369,2088392792,236719629,3.1957149914999994e-11,60482,3074452,1749981608
3372,2087859208,236719619,3.1957148565e-11,60156,3074452,1753056060
3375,2078566542,237042911,3.2000792984999996e-11,60130,3074452,1756130512
3378,2093550334,236719617,3.1957148294999994e-11,60120,3074452,1759204964
3381,2090684916,236719988,3.195719838e-11,72157,3074900,1762279864
3384,2090726125,236719434,3.195712359e-11,54170,3074452,1765354316
3387,2089772417,236719428,3.195712278e-11,53960,3074452,1768428768
3390,2142509042,237042796,3.2000777459999994e-11,56404,3074452,1771503220
3393,2145698708,236719655,3.1957153425e-11,61334,3074452,1774577672
3396,2092781958,236719625,3.1957149375e-11,60380,3074452,1777652124
3399,2086837167,236719674,3.195715599e-11,61956,3074452,1780726576
3402,2089059125,237042972,3.2000801219999996e-11,62130,3074452,1783801028
3405,2094879792,236719683,3.1957157205e-11,62236,3074452,1786875480
3408,2090320459,236720124,3.1957216739999997e-11,76570,3074900,1789950380
3411,2088851959,236719570,3.195714195e-11,58564,3074452,1793024832
3414,2088978500,236719637,3.1957150995e-11,60770,3074452,1796099284
3417,2089108416,237042959,3.2000799464999997e-11,61696,3074452,1799173736
3420,2090432292,236719686,3.195715761e-11,62332,3074452,1802248188
3423,2089650125,236719707,3.1957160444999996e-11,63040,3074452,1805322640
3426,2090720834,236720050,3.195720675e-11,74183,3074900,1808397540
3429,2088598000,236719650,3.195715275e-11,61178,3074452,1811471992
3432,2088702042,237042941,3.2000797034999996e-11,61128,3074452,1814546444
3435,2075787000,236719648,3.1957152479999994e-11,61130,3074452,1817620896
3438,2180790292,236719639,3.1957151265e-11,60818,3074452,1820695348
3441,2278664167,236720110,3.195721485e-11,76127,3074900,1823770248
3444,2284227416,236719548,3.1957138979999996e-11,57866,3074452,1826844700
3447,3692164792,236719645,3.1957152075e-11,61024,3074452,1829919152
3450,4384843333,237042938,3.200079663e-11,61024,3074452,1832993604
3453,2625089208,236719648,3.1957152479999994e-11,61110,3074452,1836068056
3456,4201854500,237042888,3.200078988e-11,59372,3074452,1839142508
3459,2863241542,236720039,3.1957205264999996e-11,73815,3074900,1842217408
3462,2365098500,236719536,3.1957137359999995e-11,57486,3074452,1845291860
3465,2090659042,237042893,3.2000790554999995e-11,59568,3074452,1848366312
3468,2091567917,236719620,3.19571487e-11,60198,3074452,1851440764
3471,2096532958,236719596,3.195714546e-11,59440,3074452,1854515216
3474,2099442167,236719600,3.1957146e-11,59540,3074452,1857589668
3477,2111688834,237043332,3.200084982e-11,73813,3074900,1860664568
3480,2092463542,236719520,3.195713519999999e-11,56962,3074452,1863739020
3483,2108067125,236719636,3.195715086e-11,60734,3074452,1866813472
3486,2088505875,236719556,3.195714006e-11,58106,3074452,1869887924
3489,2087758334,236719548,3.1957138979999996e-11,57872,3074452,1872962376
3492,2089582041,237043318,3.200084793e-11,73377,3074900,1876037276
3495,2109743833,236719501,3.1957132634999993e-11,56328,3074452,1879111728
3498,2090597250,236719574,3.195714249e-11,58710,3074452,1882186180
3501,2090780583,236719580,3.19571433e-11,58914,3074452,1885260632
3504,2112328250,236719577,3.1957142895e-11,58812,3074452,1888335084
3507,2088672333,237042863,3.2000786505e-11,58586,3074452,1891409536
3510,2087577125,236719996,3.1957199459999996e-11,72433,3074900,1894484436
3513,2088234333,236719520,3.195713519999999e-11,56946,3074452,1897558888
3516,2090149375,236719529,3.1957136414999996e-11,57234,3074452,1900633340
3519,2091539583,236719529,3.1957136414999996e-11,57250,3074452,1903707792
3522,2089580167,237042819,3.2000780565e-11,57158,3074452,1906782244
3525,2092101167,236719533,3.195713695499999e-11,57384,3074452,1909856696
3528,2090767583,236720005,3.1957200675e-11,72729,3074900,1912931596
3531,2092259292,236719510,3.195713385e-11,56634,3074452,1916006048
3534,2088306375,236719526,3.195713600999999e-11,57150,3074452,1919080500
3537,2089598041,237042827,3.2000781644999994e-11,57410,3074452,1922154952
3540,88941010041,428261476,5.781529925999999e-11,57410,-109209384,1812945568
3543,2739914791,236720004,3.195720054e-11,72687,3074900,1816020468
3546,4753356542,237059977,3.2003096895e-11,60758,3074452,1819094920
3549,4332357584,236719689,3.1957158015e-11,62460,3074452,1822169372
3552,4051074792,237060040,3.2003105399999995e-11,62786,3074452,1825243824
3555,2542936167,236719701,3.1957159634999996e-11,62836,3074452,1828318276
3558,2682235750,236719700,3.19571595e-11,62784,3074452,1831392728
3561,2102503334,236719977,3.1957196894999996e-11,71817,3074892,1834467620
3564,2089391625,236719656,3.195715356e-11,61356,3074452,1837542072
3567,2090625417,236719688,3.195715788e-11,62410,3074452,1840616524
3570,2107942875,236719702,3.195715977e-11,62852,3074452,1843690976
3573,2091366750,237060053,3.2003107154999995e-11,63236,3074452,1846765428
3576,2089129375,236720072,3.1957209719999993e-11,74903,3074900,1849840328
3579,2087582500,236719567,3.1957141544999995e-11,58462,3074452,1852914780
3582,2118163375,236719626,3.195714951e-11,60400,3074452,1855989232
3585,2134756667,236719661,3.1957154235e-11,61544,3074452,1859063684
3588,2094293583,237060000,3.20031e-11,61494,3074452,1862138136
3591,2088477291,236719640,3.1957151399999996e-11,60866,3074452,1865212588
3594,2084381709,236720877,3.195731839499999e-11,101061,3075704,1868288292
3597,2087540292,236719565,3.1957141275e-11,58404,3074452,1871362744
3600,2075981375,237060001,3.2003100135e-11,61528,3074452,1874437196
3603,2088986959,236719683,3.1957157205e-11,62248,3074452,1877511648
3606,2090009500,236719568,3.195714168e-11,58502,3074452,1880586100
3609,2088049416,236719572,3.1957142219999996e-11,58654,3074452,1883660552
3612,2089704500,236720013,3.1957201755e-11,72983,3074900,1886735452
3615,2090119334,237059865,3.2003081775e-11,57112,3074452,1889809904
3618,2088809709,236719583,3.1957143705e-11,58990,3074452,1892884356
3621,2113616750,236719590,3.1957144649999997e-11,59216,3074452,1895958808
3624,2090078916,236719574,3.195714249e-11,58706,3074452,1899033260
3627,2090561625,236720082,3.195721107e-11,75223,3074900,1902108160
3630,2090605875,237059859,3.2003080965e-11,56902,3074452,1905182612
3633,2089880542,236719620,3.19571487e-11,60208,3074452,1908257064
3636,2089216958,236719539,3.195713776499999e-11,57556,3074452,1911331516
3639,2090153667,236719549,3.1957139115e-11,57908,3074452,1914405968
3642,2086944750,236719549,3.1957139115e-11,57908,3074452,1917480420
3645,2088116000,237060355,3.2003147925e-11,73039,3074900,1920555320
3648,2091540042,236719479,3.1957129665e-11,55618,3074452,1923629772
3651,2088734958,236719559,3.1957140465e-11,58212,3074452,1926704224
3654,2088579625,236719552,3.195713952e-11,57984,3074452,1929778676
3657,2098650583,237059893,3.2003085554999995e-11,58034,3074452,1932853128
3660,2088941792,236719553,3.1957139655e-11,58034,3074452,1935927580
3663,2169906458,236720052,3.1957207019999995e-11,74257,3074900,1939002480
3666,2172456750,236719587,3.1957144245e-11,59134,3074452,1942076932
3669,27176631167,237774574,3.209956749e-11,56942,3074452,1945151384
3672,2088746167,236719587,3.1957144245e-11,59134,3074452,1948225836
3675,2089363125,236719559,3.1957140465e-11,58206,3074452,1951300288
3678,2090092000,236720089,3.1957212015e-11,75435,3074900,1954375188
3681,2094254250,237059863,3.2003081504999994e-11,57052,3074452,1957449640
3684,2088101834,236719595,3.1957145325e-11,59386,3074452,1960524092
3687,2088006125,236719558,3.195714033e-11,58198,3074452,1963598544
3690,2088229958,236719552,3.195713952e-11,57996,3074452,1966672996
3693,3306908666,236719952,3.195719352e-11,70996,3074452,1969747448
3696,3310001584,237060203,3.2003127405e-11,68094,3074452,1972821900
3699,3307209375,236720156,3.1957221059999995e-11,77627,3074900,1975896800
3702,3325902458,236719686,3.195715761e-11,62350,3074452,1978971252
3705,88800945916,437503950,5.906303325e-11,61844,-81523676,1897447576
3708,4112445584,236719675,3.1957156125e-11,61994,3074452,1900522028
3711,2570157791,236719690,3.195715815e-11,62472,3074452,1903596480
3714,2742414209,237073350,3.200490225e-11,77553,3074900,1906671380
3717,2908760875,236719607,3.1957146945e-11,59782,3074452,1909745832
3720,2984400667,236719703,3.1957159905e-11,62904,3074452,1912820284
3723,2764962667,237072882,3.200483907e-11,62356,3074452,1915894736
3726,2626452959,236719640,3.1957151399999996e-11,60864,3074452,1918969188
3729,2436098958,236719634,3.1957150589999996e-11,60662,3074452,1922043640
3732,2114005542,236720076,3.195721026e-11,75013,3074900,1925118540
3735,2088484375,236719572,3.1957142219999996e-11,58648,3074452,1928192992
3738,2087546583,236719657,3.1957153695e-11,61392,3074452,1931267444
3741,2104543417,236719655,3.1957153425e-11,61342,3074452,1934341896
3744,2088244500,237072843,3.2004833805e-11,61064,3074452,1937416348
3747,2088173833,236719647,3.1957152344999995e-11,61064,3074452,1940490800
3750,2089959916,236720041,3.1957205534999994e-11,73881,3074900,1943565700
3753,2087862250,236719603,3.1957146404999996e-11,59632,3074452,1946640152
3756,2092072042,236719556,3.195714006e-11,58102,3074452,1949714604
3759,2091326416,237072781,3.2004825434999995e-11,59080,3074452,1952789056
3762,2148338000,236719551,3.1957139385e-11,57942,3074452,1955863508
3765,2080655625,236720060,3.195720809999999e-11,74507,3074900,1958938408
3768,2103187125,236719528,3.195713628e-11,57230,3074452,1962012860
3771,2088743417,236719567,3.1957141544999995e-11,58486,3074452,1965087312
3774,2088583708,237072796,3.200482746e-11,59540,3074452,1968161764
3777,2088204708,236719555,3.1957139925e-11,58074,3074452,1971236216
3780,2087397375,236719593,3.1957145055e-11,59338,3074452,1974310668
3783,2085269792,236719742,3.195716517e-11,64166,3074452,1977385120
3786,2088589500,237072891,3.2004840284999996e-11,62632,3074452,1980459572
3789,2088173584,236719757,3.1957167194999995e-11,64662,3074452,1983534024
3792,2087683125,236719763,3.1957168004999995e-11,64836,3074452,1986608476
3795,2088535041,236719762,3.1957167869999997e-11,64816,3074452,1989682928
3798,2089464166,236720158,3.195722133e-11,77672,3074900,1992757828
3801,2090425833,237072860,3.2004836099999996e-11,61646,3074452,1995832280
3804,2090365333,236719747,3.1957165845e-11,64314,3074452,1998906732
3807,2112735625,236719772,3.195716922e-11,65140,3074452,2001981184
3810,2084658250,236719773,3.1957169355e-11,65188,3074452,2005055636
3813,2090785458,236719795,3.1957172325e-11,65896,3074452,2008130088
3816,2092687792,237073320,3.2004898199999996e-11,76589,3074900,2011204988
3819,3309052250,236719725,3.1957162874999997e-11,63604,3074452,2014279440
3822,3305953416,236719739,3.1957164765e-11,64056,3074452,2017353892
3825,3306329625,236719737,3.1957164495e-11,64010,3074452,2020428344
3828,107306539292,444197710,5.996669085e-11,63472,-59988880,1960439464
3831,3308258125,237082862,3.200618637e-11,77815,3074900,1963514364
3834,3306137875,236719711,3.1957160985e-11,63158,3074452,1966588816
3837,3308505000,236719734,3.195716409e-11,63906,3074452,1969663268
3840,3305272042,237082440,3.2006129399999996e-11,64108,3074452,1972737720
3843,3307213041,236719736,3.195716436e-11,63982,3074452,1975812172
3846,3306997958,236719693,3.1957158555e-11,62582,3074452,1978886624
3849,2101989084,237082783,3.2006175705e-11,75255,3074900,1981961524
3852,3289281250,236719629,3.1957149914999994e-11,60486,3074452,1985035976
3855,3302930833,236719669,3.1957155315e-11,61800,3074452,1988110428
3858,3307840625,236719701,3.1957159634999996e-11,62828,3074452,1991184880
3861,2679498000,236719692,3.195715841999999e-11,62524,3074452,1994259332
3864,51452886375,238714545,3.222646357499999e-11,62624,3074452,1997333784
3867,2096994833,236720095,3.1957212825e-11,75647,3074900,2000408684
3870,2094063208,236719600,3.1957146e-11,59560,3074452,2003483136
3873,2089499083,236719723,3.195716260499999e-11,63548,3074452,2006557588
3876,2087638750,237082356,3.2006118059999994e-11,61368,3074452,2009632040
3879,2106700875,236719640,3.1957151399999996e-11,60848,3074452,2012706492
3882,2071014667,236720083,3.1957211205e-11,75249,3074900,2015781392
3885,2089868250,236719587,3.1957144245e-11,59112,3074452,2018855844
3888,2092368125,236719652,3.1957153019999996e-11,61252,3074452,2021930296
3891,2091341083,237082346,3.200611671e-11,61034,3074452,2025004748
3894,2091304958,236719667,3.195715504499999e-11,61732,3074452,2028079200
3897,2092903333,236719646,3.1957152209999996e-11,61034,3074452,2031153652
3900,2089738708,236720854,3.195731529e-11,100315,3075704,2034229356
3903,2088276125,236719514,3.195713438999999e-11,56760,3074452,2037303808
3906,2087640625,237082373,3.2006120354999996e-11,61940,3074452,2040378260
3909,2088491167,236719730,3.195716355e-11,63766,3074452,2043452712
3912,2089247042,236719729,3.195716341499999e-11,63742,3074452,2046527164
3915,2088650875,236719721,3.1957162335e-11,63490,3074452,2049601616
3918,2088488584,237082747,3.2006170844999996e-11,74083,3074900,2052676516
3921,88840526916,448261371,6.0515285085e-11,56594,-44608436,2008068080
3924,2097000584,237089495,3.2007081825e-11,57156,3074452,2011142532
3927,2171189500,237089497,3.2007082095e-11,57206,3074452,2014216984
3930,2481049750,236719524,3.195713574e-11,57080,3074452,2017291436
3933,2825499542,236719968,3.195719568e-11,71511,3074900,2020366336
3936,3127559000,236719683,3.1957157205e-11,62258,3074452,2023440788
3939,4060365458,236719780,3.19571703e-11,65414,3074452,2026515240
3942,3031239458,236719781,3.1957170434999996e-11,65440,3074452,2029589692
3945,4006154125,237089744,3.200711544e-11,65238,3074452,2032664144
3948,2707250000,236719767,3.1957168545e-11,64978,3074452,2035738596
3951,3307753834,237127050,3.201215175e-11,75277,3074892,2038813488
3954,2093812750,236719683,3.1957157205e-11,62258,3074452,2041887940
3957,2088296167,236719797,3.1957172595e-11,65970,3074452,2044962392
3960,2089873833,236719776,3.1957169759999995e-11,65256,3074452,2048036844
3963,2105201834,236719790,3.195717165e-11,65714,3074452,2051111296
3966,2090057417,236719739,3.1957164765e-11,64058,3074452,2054185748
3969,2089306834,236720172,3.195722322e-11,78153,3074900,2057260648
3972,2087520667,236719685,3.1957157474999994e-11,62304,3074452,2060335100
3975,2095747833,236719748,3.195716598e-11,64358,3074452,2063409552
3978,2087301625,237089719,3.2007112065e-11,64434,3074452,2066484004
3981,2089548959,236719744,3.1957165439999996e-11,64234,3074452,2069558456
3984,2089302500,236719747,3.1957165845e-11,64334,3074452,2072632908
3987,2089856209,236720138,3.1957218629999995e-11,77045,3074900,2075707808
3990,107423178084,453364208,6.120416807999999e-11,64612,-32302696,2043405112
3993,2272718916,236719759,3.1957167465e-11,64718,3074452,2046479564
3996,2612992125,237094980,3.20078223e-11,62776,3074452,2049554016
3999,2787198625,236719705,3.1957160175e-11,62976,3074452,2052628468
4002,4207180375,237095435,3.2007883725e-11,77547,3074900,2055703368
4005,3622883417,236719684,3.1957157339999995e-11,62280,3074452,2058777820
4008,2473221666,236719613,3.1957147755e-11,59976,3074452,2061852272
4011,2102704291,236719706,3.195716031e-11,63000,3074452,2064926724
4014,2093302583,237094993,3.2007824055e-11,63184,3074452,2068001176
4017,2094351292,236719711,3.1957160985e-11,63158,3074452,2071075628
4020,2095916250,236720128,3.195721728e-11,76731,3074900,2074150528
4023,2100665500,236719639,3.1957151265e-11,60806,3074452,2077224980
4026,2094576667,237094958,3.200781933e-11,62052,3074452,2080299432
4029,2112576334,236719659,3.1957153964999995e-11,61466,3074452,2083373884
4032,2090275791,236719675,3.1957156125e-11,61976,3074452,2086448336
4035,2086812958,236719672,3.1957155719999994e-11,61876,3074452,2089522788
4038,2073684333,236720065,3.1957208774999994e-11,74673,3074900,2092597688
4041,107317341625,456237422,6.159205197e-11,62000,-23073892,2069523796
4044,2445938041,236719668,3.195715518e-11,61772,3074452,2072598248
4047,3231938333,236719678,3.1957156529999995e-11,62100,3074452,2075672700
4050,2461727792,237098862,3.200834637e-11,61800,3074452,2078747152
4053,3653781250,236720134,3.195721809e-11,76919,3074900,2081822052
4056,3852423708,236719524,3.195713574e-11,57080,3074452,2084896504
4059,2405598667,236719604,3.1957146539999995e-11,59690,3074452,2087970956
4062,2213064583,236719633,3.1957150454999997e-11,60616,3074452,2091045408
4065,2089983792,237098823,3.2008341105e-11,60516,3074452,2094119860
4068,2087964041,236719633,3.1957150454999997e-11,60616,3074452,2097194312
4071,2091568416,236720051,3.1957206885e-11,74201,3074900,2100269212
4074,2095486875,236719536,3.1957137359999995e-11,57482,3074452,2103343664
4077,2088144708,236719642,3.1957151669999994e-11,60918,3074452,2106418116
4080,107310038209,458464039,6.189264526499999e-11,60280,-16921264,2089496852
4083,2093238666,236719663,3.1957154505e-11,61590,3074452,2092571304
4086,2093822667,236719726,3.1957163009999996e-11,63632,3074452,2095645756
4089,2088799041,236719811,3.1957174484999997e-11,66398,3074452,2098720208
4092,2088694334,236719821,3.1957175835e-11,66728,3074452,2101794660
4095,2102687667,237102067,3.2008779044999996e-11,66146,3074452,2104869112
4098,2088641458,236719802,3.195717327e-11,66120,3074452,2107943564
4101,2091504833,236720013,3.1957201755e-11,72963,3074900,2111018464
4104,2088594792,236719556,3.195714006e-11,58130,3074452,2114092916
4107,2089218834,237101822,3.2008745969999996e-11,58198,3074452,2117167368
4110,88866131000,458743213,6.1930333755e-11,59386,-12306728,2104860640
4113,3219173458,237104373,3.2009090355e-11,63764,3074452,2107935092
4116,2324274333,236719704,3.195716003999999e-11,62936,3074452,2111009544
4119,2592321208,236719777,3.1957169895e-11,65318,3074452,2114083996
4122,2524068250,237104409,3.2009095215e-11,64938,3074452,2117158448
4125,3270573375,236719767,3.1957168545e-11,64972,3074452,2120232900
4128,2242153166,236720151,3.1957220385e-11,77454,3074900,2123307800
4131,108376621584,461263050,6.227051175e-11,63186,-7692452,2115615348
4134,2092479958,236719747,3.1957165845e-11,64314,3074452,2118689800
4137,2106986250,236719786,3.195717111e-11,65594,3074452,2121764252
4140,2107508000,236719760,3.19571676e-11,64762,3074452,2124838704
4143,2089380625,237105972,3.200930622e-11,65770,3074452,2127913156
4146,88806617750,460644002,6.218694027e-11,75183,-4615820,2123297336
4149,2094669583,237107030,3.200944905e-11,63908,3074452,2126371788
4152,2089308583,236719731,3.1957163685e-11,63816,3074452,2129446240
4155,2088037333,236719747,3.1957165845e-11,64314,3074452,2132520692
4158,89007535208,461523539,6.230567776499999e-11,63884,-3077916,2129442776
4161,4205218375,236720142,3.195721917e-11,77155,3074900,2132517676
4164,2786512541,236719668,3.195715518e-11,61778,3074452,2135592128
4167,130655907084,463797547,6.2612668845e-11,64008,-1540084,2134052044
4170,2104215750,236719726,3.1957163009999996e-11,63660,3074452,2137126496
4173,88803092208,462098542,6.238330317e-11,64210,-1732,2137124764
4176,2092776458,237109084,3.200972634e-11,62432,3074452,2140199216
4179,88802322459,462500973,6.2437631355e-11,74441,-1544,2140197672
4182,88909010667,462895466,6.249088791e-11,58974,1536360,2141734032
4185,130879609125,464892242,6.276045267e-11,61046,1536360,2143270392
4188,88865040417,463532576,6.257689775999999e-11,62770,1536360,2144806752
