Size,Time,Cycles,Price,Instructions,HeapSize,TotalHeapSize
500,2058318125,80814241,1.0909922534999999e-11,6794157,574160,574788
1000,2052564959,80812902,1.090974177e-11,8143584,1221552,1796340
1500,2051235250,81151440,1.0955444399999999e-11,8571904,-67780,1728560
2000,2051831042,80841547,1.0913608844999999e-11,9074560,1230328,2958888
2500,2190751333,81384449,1.0986900615e-11,9092763,-76836,2882052
3000,2253441542,80842889,1.0913790015e-11,9089769,1230244,4112296
3500,2398954916,80856817,1.0915670295e-11,9570826,1229880,5342176
4000,2152900875,81723533,1.1032676954999999e-11,9537438,-730028,4612148
4500,2106594750,80856896,1.0915680959999999e-11,9573404,1229796,5841944
5000,2065643459,80858574,1.091590749e-11,9587329,1230320,7072264
5500,2053356041,82163343,1.1092051305e-11,10470247,-729832,6342432
6000,2067780167,80963328,1.093004928e-11,10249183,1229444,7571876
6500,2066725917,80966862,1.0930526369999999e-11,10364041,1229484,8801360
7000,2072071083,80976431,1.0931818184999998e-11,10624369,1229492,10030852
7500,2066642542,82609650,1.115230275e-11,10892395,-1382612,8648240
8000,2050431208,80980566,1.093237641e-11,10809442,1230796,9879036
8500,2055265125,80978933,1.0932155954999998e-11,10756364,1229484,11108520
9000,2061640792,80977964,1.093202514e-11,10724849,1229468,12337988
9500,2053800500,80984037,1.0932844994999999e-11,10855870,1230728,13568716
10000,2056311041,83148890,1.1225100149999998e-11,10807522,-2037828,11530888
10500,2063723750,80981099,1.0932448364999999e-11,10826762,1230812,12761700
11000,2063663416,80978171,1.0932053084999998e-11,10731577,1229924,13991624
11500,2054054417,80976710,1.0931855849999998e-11,10684114,1229940,15221564
12000,2096914333,80981662,1.0932524369999997e-11,10759675,1231192,16452756
12500,2255967958,80977699,1.0931989365e-11,10716238,1229484,17682240
13000,4949758417,83797222,1.131262497e-11,10740423,-2691864,14990376
13500,2059271792,80991572,1.0933862219999997e-11,11059491,1243484,16233860
14000,2055399542,81006495,1.0935876824999999e-11,11652119,1249640,17483500
14500,2054252792,81007327,1.0935989144999998e-11,11679154,1247940,18731440
15000,2063315541,80996979,1.0934592164999999e-11,11342857,1248372,19979812
15500,2050711125,80995806,1.093443381e-11,11304719,1247460,21227272
16000,2057497375,81010883,1.0936469205e-11,11687088,1247916,22475188
16500,2051714083,84586441,1.1419169535e-11,11717355,-3448016,19027172
17000,2055303375,81008923,1.0936204605e-11,11731045,1248356,20275528
17500,2062097625,81008076,1.0936090259999998e-11,11703506,1247452,21522980
18000,2065169833,81008239,1.0936112264999999e-11,11708809,1248804,22771784
18500,2061935958,81012230,1.093665105e-11,11704701,1248364,24020148
19000,2069663333,81007749,1.0936046115e-11,11692861,1248796,25268944
19500,2050267875,81007169,1.0935967815e-11,11674008,1248364,26517308
20000,2061372500,81007380,1.0935996299999999e-11,11680890,1247916,27765224
20500,2156502083,81013522,1.0936825469999999e-11,11746702,1247904,29013128
21000,9134012250,85560293,1.1550639555e-11,11657800,-4796652,24216476
21500,2058032875,81007290,1.0935984149999998e-11,11509426,1248744,25465220
22000,2066546833,80991473,1.0933848855e-11,11163906,1247476,26712696
22500,2052374959,81003507,1.0935473445e-11,11555014,1247916,27960612
23000,2057792958,81005422,1.0935731969999999e-11,11617261,1248264,29208876
23500,2055653875,81011934,1.0936611089999999e-11,11660360,1248388,30457264
24000,2053651084,81007796,1.0936052459999999e-11,11694406,1247456,31704720
24500,2062874333,81009662,1.093630437e-11,11755037,1250080,32954800
25000,2053451083,81006316,1.093585266e-11,11646305,1247468,34202268
25500,2064374416,81009785,1.0936320975e-11,11759049,1249732,35452000
26000,2051113750,81012278,1.0936657529999998e-11,11671551,1247908,36699908
26500,2050941833,86751167,1.1711407545e-11,11604508,-6140780,30559128
27000,2051551167,81007887,1.0936064744999998e-11,11697349,1249168,31808296
27500,2052601917,81006657,1.0935898694999998e-11,11657369,1247924,33056220
28000,2051101625,81005645,1.0935762074999999e-11,11624492,1247924,34304144
28500,2051882750,81014662,1.0936979369999999e-11,11707551,1249184,35553328
29000,2058553625,81008094,1.0936092689999998e-11,11704100,1248720,36802048
29500,2102097459,81020765,1.0937803274999999e-11,12115892,1247492,38049540
30000,2362030208,81022590,1.0938049649999998e-11,12175201,1248812,39298352
30500,2178276000,81034520,1.0939660199999999e-11,12352955,1247468,40545820
31000,2169320834,81024393,1.0938293055e-11,12233793,1248836,41794656
31500,2050028125,81022067,1.0937979045e-11,12158212,1248364,43043020
32000,2057198708,81020466,1.0937762909999999e-11,12106180,1248836,44291856
32500,2053815375,81020263,1.0937735505e-11,12099570,1248360,45540216
33000,2059595000,81025283,1.0938413204999998e-11,12052737,1247916,46788132
33500,2054578042,88283756,1.1918307059999999e-11,12073029,-8155832,38632300
34000,2067583625,81020591,1.0937779784999998e-11,12110244,1248776,39881076
34500,2048532333,81021254,1.0937869289999998e-11,12131787,1248388,41129464
35000,2051602625,81022689,1.0938063014999999e-11,12178431,1248388,42377852
35500,2052134209,81024341,1.0938286034999998e-11,12232112,1247940,43625792
36000,2060987334,81021108,1.093784958e-11,12127053,1247908,44873700
36500,2080839292,81015774,1.093712949e-11,11953668,1248264,46121964
37000,2077653583,81009003,1.0936215405e-11,11733635,1250048,47372012
37500,2055262417,81013631,1.0936840184999999e-11,11620406,1248356,48620368
38000,2061398834,81017290,1.0937334149999999e-11,12002939,1247484,49867852
38500,2055137250,81021550,1.0937909249999998e-11,12141407,1247924,51115776
39000,2052164708,81023552,1.0938179519999998e-11,12206481,1249192,52364968
39500,2061618917,81020945,1.0937827574999999e-11,12121734,1248388,53613356
40000,2051464625,81030795,1.0939157325e-11,12178223,1248380,54861736
40500,2052656167,81025649,1.0938462614999999e-11,12274632,1248836,56110572
41000,2056257459,81018865,1.0937546774999998e-11,12054131,1248820,57359392
41500,2095678042,81018384,1.093748184e-11,12038509,1248364,58607756
42000,6909474750,90139264,1.216880064e-11,12058672,-10171624,48436132
42500,2066648542,81019925,1.0937689875e-11,12088596,1248380,49684512
43000,2054111417,81028558,1.0938855329999999e-11,12369155,1248380,50932892
43500,2063534709,81022744,1.093807044e-11,12180214,1249496,52182388
44000,2048090375,81029966,1.093904541e-11,12087331,1248352,53430740
44500,2055808208,81022024,1.0937973239999998e-11,12156796,1248372,54679112
45000,2053063000,81020254,1.093773429e-11,12099272,1249616,55928728
45500,2053978375,81021738,1.0937934629999999e-11,12147529,1247916,57176644
46000,2058432792,81006390,1.093586265e-11,11648695,1248380,58425024
46500,2064732208,81013852,1.0936870019999999e-11,11563611,1248828,59673852
47000,2051978000,81004748,1.093564098e-11,11595354,1248736,60922588
47500,2061881542,81006859,1.0935925965e-11,11663951,1247940,62170528
48000,2059179792,81003008,1.093540608e-11,11538778,1247484,63418012
48500,2059307416,81007090,1.0935957149999999e-11,11671464,1247940,64665952
49000,2052833209,81016597,1.0937240595e-11,11652823,1249640,65915592
49500,2062329125,81012822,1.0936730969999997e-11,11857727,1248388,67163980
50000,2058899958,81011712,1.0936581119999998e-11,11821658,1249192,68413172
50500,2133991750,81103327,1.0948949145e-11,12590417,1249312,69662484
51000,2365381500,81109371,1.0949765084999997e-11,12459242,1248856,70911340
51500,2153897500,81098584,1.0948308839999998e-11,12436263,1248408,72159748
52000,2261517500,81112244,1.0950152939999998e-11,12880198,1250140,73409888
52500,3277990375,92499227,1.2487395644999998e-11,12899493,-12862144,60547744
53000,2074959417,81126272,1.0952046719999998e-11,12928871,1248432,61796176
53500,2071916709,81114208,1.095041808e-11,12944055,1248888,63045064
54000,2073499292,81115079,1.0950535664999999e-11,12972355,1249236,64294300
54500,2061676708,81115096,1.0950537959999998e-11,12972888,1249312,65543612
55000,2039103125,81116328,1.0950704279999998e-11,13012941,1250232,66793844
55500,2049374333,81129969,1.0952545814999999e-11,13049013,1248440,68042284
56000,2055378167,81110585,1.0949928974999999e-11,12826279,1247976,69290260
56500,2050794458,81113466,1.0950317909999999e-11,12919943,1248432,70538692
57000,2052364208,81105782,1.0949280570000001e-11,12670213,1248772,71787464
57500,2051112333,81112261,1.0950155235e-11,12473516,1250580,73038044
58000,2063773625,81101686,1.094872761e-11,12537088,1248880,74286924
58500,2051007584,81110222,1.0949879969999998e-11,12814487,1249320,75536244
59000,2059968083,81113868,1.095037218e-11,12933005,1249684,76785928
59500,2084646375,81114745,1.0950490574999998e-11,12961491,1249328,78035256
60000,2251785000,81130165,1.0952572275e-11,13055379,1250588,79285844
60500,5268774500,81113813,1.0950364754999999e-11,12931223,1249784,80535628
61000,2056691541,81116980,1.09507923e-11,13034145,1248416,81784044
61500,2061543791,81128680,1.09523718e-11,13007136,1248416,83032460
62000,2055239959,81114364,1.095043914e-11,12949123,1247960,84280420
62500,2050715166,81114079,1.0950400665e-11,12939858,1247520,85527940
63000,2061584167,81114793,1.0950497054999999e-11,12963065,1248400,86776340
63500,2055444000,81113504,1.095032304e-11,12921148,1248864,88025204
64000,2055351209,81130149,1.0952570115e-11,13054861,1248756,89273960
64500,2058036584,81116479,1.0950724664999998e-11,13017837,1249296,90523256
65000,2051788417,81132488,1.095288588e-11,13538143,1249312,91772568
65500,3271636333,95337765,1.2870598274999999e-11,13499705,-16230656,75541912
66000,2050578542,81141480,1.09540998e-11,13324490,1249304,76791216
66500,2048351041,81117089,1.0950807015e-11,13037690,1248864,78040080
67000,2054950959,81119421,1.0951121834999999e-11,13113450,1248852,79288932
67500,2062520042,81129846,1.0952529209999998e-11,13452292,1249304,80538236
68000,2057882041,81144753,1.0954541654999998e-11,13430860,1249776,81788012
68500,2055404791,81130478,1.095261453e-11,13472828,1249312,83037324
69000,2162317916,81128468,1.095234318e-11,13407493,1249304,84286628
69500,2143259125,81126084,1.095202134e-11,13330020,1248864,85535492
70000,2206106500,81126315,1.0952052525e-11,13337526,1248864,86784356
70500,2054665083,81148954,1.095510879e-11,13567389,1247976,88032332
71000,2055232125,81126860,1.0952126099999998e-11,13355237,1248880,89281212
71500,2057474000,81128870,1.0952397449999998e-11,13420571,1248440,90529652
72000,2057020416,81128665,1.0952369774999999e-11,13413879,1248440,91778092
72500,2053557583,81135391,1.0953277784999999e-11,13126580,1250496,93028588
73000,2060662750,81123175,1.0951628624999999e-11,13235472,1248416,94277004
73500,2050750917,81113275,1.0950292124999998e-11,12913723,1249296,95526300
74000,2055762667,81113022,1.095025797e-11,12905503,1248888,96775188
74500,2051143709,81111996,1.0950119459999999e-11,12872141,1247968,98023156
75000,2051129500,81139220,1.09537947e-11,13251038,1248880,99272036
75500,2056463792,81131149,1.0952705114999999e-11,13494623,1249228,100521264
76000,2053778250,81125626,1.095195951e-11,13315137,1247992,101769256
76500,2056132125,81126327,1.0952054144999998e-11,13337900,1247992,103017248
77000,2054253541,81127923,1.0952269605e-11,13389794,1248888,104266136
77500,2051511333,81142566,1.095424641e-11,13359792,1249692,105515828
78000,2052211250,81129611,1.0952497485e-11,13444655,1248432,106764260
78500,2052247542,81127655,1.0952233425e-11,13381064,1247536,108011796
79000,2063641709,81127883,1.0952264204999998e-11,13388494,1250928,109262724
79500,2160745208,81129679,1.0952506664999999e-11,12940941,1248864,110511588
80000,2232380333,81112686,1.095021261e-11,12894585,1248880,111760468
80500,2236973375,81118232,1.095096132e-11,13074820,1247544,113008012
81000,2060381042,81129437,1.0952473994999999e-11,13438981,1248856,114256868
81500,4738109250,98822912,1.3341093119999998e-11,13309329,-20262568,93994300
82000,2055858625,81128945,1.0952407575e-11,13423013,1248860,95243160
82500,2068025459,81129016,1.0952417159999999e-11,13425315,1248864,96492024
83000,2062917209,81126984,1.095214284e-11,13359262,1247952,97739976
83500,2065796958,81129745,1.0952515575e-11,13448987,1248864,98988840
84000,2051336250,81147058,1.095485283e-11,13384672,1248856,100237696
84500,2056096750,81129533,1.0952486955e-11,13442087,1248864,101486560
85000,2073766875,81129504,1.0952483039999999e-11,13441173,1248416,102734976
85500,2061275875,81132943,1.0952947305e-11,13552930,1249312,103984288
86000,2065449708,81127725,1.0952242874999998e-11,13383364,1248408,105232696
86500,2063935167,81146256,1.0954744559999999e-11,13358612,1248852,106481548
87000,2058867500,81125958,1.095200433e-11,13325914,1248440,107729988
87500,2050756208,81122518,1.0951539929999998e-11,13214132,1249656,108979644
88000,2059275041,81112532,1.095019182e-11,12889559,1248408,110228052
88500,2116366667,81137345,1.0953541575e-11,13069019,1248864,111476916
89000,2394022875,81126721,1.0952107334999999e-11,13350728,1247952,112724868
89500,2106380417,81127839,1.0952258265e-11,13387036,1249312,113974180
90000,2060547208,81126980,1.0952142299999999e-11,13359142,1248408,115222588
90500,2056613125,81151828,1.0955496779999999e-11,13539701,1248440,116471028
91000,2048471084,81126347,1.0952056844999998e-11,13338572,1248408,117719436
91500,2066654875,81126511,1.0952078984999999e-11,13343887,1248412,118967848
92000,2056157334,81127794,1.0952252189999998e-11,13385583,1247960,120215808
92500,2072491709,81127840,1.09522584e-11,13387091,1248856,121464664
93000,2055165083,81147764,1.0954948139999999e-11,13407608,1249328,122713992
93500,2071151458,81128939,1.0952406765e-11,13422792,1249692,123963684
94000,2051557250,81129192,1.095244092e-11,13431035,1248440,125212124
94500,2052598500,81127597,1.0952225594999999e-11,13379198,1248856,126460980
95000,2056038167,81126611,1.0952092485e-11,13347135,1248440,127709420
95500,2054132208,81144760,1.09545426e-11,13310002,1249660,128959080
96000,2051994667,81110746,1.0949950709999999e-11,12831537,1248880,130207960
96500,2067400083,81112485,1.0950185475e-11,12888032,1248864,131456824
97000,2064053250,81109451,1.0949775885e-11,12789454,1248432,132705256
97500,2091715334,81144545,1.0954513574999999e-11,13302987,1248772,133954028
98000,2100981125,81122505,1.0951538174999999e-11,13213704,1247968,135201996
98500,2793673709,81126916,1.0952133659999999e-11,13357058,1248888,136450884
99000,2207146042,81128164,1.095230214e-11,13397599,1248888,137699772
99500,2055633792,81143993,1.0954439055e-11,13285081,1247976,138947748
100000,2054948375,81124353,1.0951787654999998e-11,13273773,1249692,140197440
100500,2056966333,81129181,1.0952439435e-11,13430680,1249784,141447224
101000,4731813334,103014584,1.3906968839999999e-11,12818958,-24965616,116481608
101500,2051903875,81135478,1.095328953e-11,12861442,1247992,117729600
102000,2066798500,81111179,1.0950009164999998e-11,12845587,1248432,118978032
102500,2052177334,81127134,1.0952163089999999e-11,13364133,1250936,120228968
103000,2054655417,81113948,1.0950382979999999e-11,12935585,1247992,121476960
103500,2058500208,81115074,1.0950534989999999e-11,12972183,1249776,122726736
104000,2055541500,81140050,1.095390675e-11,13010014,1249692,123976428
104500,2059263167,81114619,1.0950473564999998e-11,12957406,1248888,125225316
105000,2051065292,81114221,1.0950419834999999e-11,12944447,1248880,126474196
105500,2062118792,81118856,1.0951045559999999e-11,13095095,1249212,127723408
106000,2066062125,81140480,1.09539648e-11,13023990,1248432,128971840
106500,2072629041,81127346,1.095219171e-11,13371044,1248424,130220264
107000,2190907042,81127942,1.0952272169999999e-11,13390401,1248856,131469120
107500,2234616208,81129727,1.0952513144999998e-11,13448408,1249312,132718432
108000,2313732625,81132400,1.0952873999999998e-11,13535268,1249336,133967768
108500,2060625125,81150101,1.0955263634999998e-11,13336670,1248416,135216184
109000,2071464083,81129949,1.0952543114999997e-11,13455631,1248864,136465048
109500,2066763666,81128428,1.095233778e-11,13406189,1248856,137713904
110000,2067622375,81130515,1.0952619524999998e-11,13474018,1248888,138962792
110500,2062206459,81158845,1.0956444074999998e-11,13620875,1248880,140211672
111000,2050689750,81125920,1.0951999199999999e-11,13324676,1248440,141460112
111500,2060330583,81128156,1.0952301059999998e-11,13397347,1248440,142708552
112000,2053752125,81128507,1.0952348445e-11,13408754,1248888,143957440
112500,2050591958,81131602,1.095276627e-11,13509339,1248440,145205880
113000,2054416250,81146815,1.0954820025e-11,13229889,1249236,146455116
113500,2066616875,81113678,1.095034653e-11,12926828,1249212,147704328
114000,2052345000,81116248,1.0950693479999999e-11,13010334,1247960,148952288
114500,2072994250,81123966,1.0951735409999998e-11,13261181,1247992,150200280
115000,2056833125,81123180,1.0951629299999999e-11,13235642,1249768,151450048
115500,2075281875,81156831,1.0956172185e-11,13555389,1249328,152699376
116000,2602561000,81126183,1.0952034704999998e-11,13333236,1248432,153947808
116500,2391881875,81128377,1.0952330894999998e-11,13404541,1248888,155196696
117000,2296904750,81126659,1.0952098964999998e-11,13348689,1248440,156445136
117500,2039679917,81153324,1.0955698739999999e-11,13441420,1250108,157695244
118000,2053875166,81127368,1.095219468e-11,13371739,1247096,158942340
118500,2052429958,81127928,1.0952270279999998e-11,13389934,1248440,160190780
119000,2063095959,81130022,1.0952552969999998e-11,13458001,1247992,161438772
119500,2063397792,81154347,1.0955836844999998e-11,13474672,1249244,162688016
120000,2053794541,81124505,1.0951808175e-11,13278705,1249684,163937700
120500,2075564542,81114862,1.095050637e-11,12965314,1249784,165187484
121000,2051265666,81115700,1.09506195e-11,12992518,1248400,166435884
121500,2067495791,81127844,1.0952258939999999e-11,13387224,1249328,167685212
122000,2051587000,81152073,1.0955529855e-11,13400749,1248856,168934068
122500,2052585500,81128481,1.0952344934999999e-11,13407899,1248416,170182484
123000,2073179000,81130153,1.0952570654999999e-11,13462256,1248864,171431348
123500,2052469000,81129973,1.0952546355e-11,13456394,1248864,172680212
124000,2071310833,81130249,1.0952583615e-11,13465366,1248864,173929076
124500,2052168542,81151778,1.095549003e-11,13391172,1247968,175177044
125000,6472034500,108236895,1.4611980824999997e-11,13400509,-31017324,144159720
125500,2072915667,81132090,1.095283215e-11,13525215,1248856,145408576
126000,2075811708,81156315,1.0956102525e-11,13357049,1248864,146657440
126500,2174509333,81125945,1.0952002574999998e-11,13325501,1248408,147905848
127000,2136018583,81126725,1.0952107875e-11,13350854,1249328,149155176
127500,2259718458,81127717,1.0952241794999999e-11,13383095,1248848,150404024
128000,2305864875,81159259,1.0956499964999999e-11,13452721,1248408,151652432
128500,2269697541,81119435,1.0951123724999998e-11,13113917,1250104,152902536
129000,2063198416,81126446,1.095207021e-11,13341773,1249652,154152188
129500,2051356750,81127171,1.0952168085e-11,13365351,1247968,155400156
130000,2053649792,81157908,1.0956317579999998e-11,13408835,1248888,156649044
130500,2056433791,81131777,1.0952789895e-11,13515052,1249752,157898796
131000,2062472958,81117296,1.0950834959999999e-11,13044404,1248856,159147652
131500,2061267083,81127144,1.0952164439999998e-11,13364468,1248440,160396092
132000,2063767959,81129001,1.0952415134999999e-11,13424803,1249244,161645336
132500,2054929792,81155888,1.0956044879999999e-11,13343168,1248408,162893744
133000,2053936042,81129035,1.0952419724999999e-11,13425925,1248440,164142184
133500,2054746792,81128881,1.0952398934999998e-11,13420931,1248880,165391064
134000,2051531333,81126887,1.0952129745e-11,13356112,1249684,166640748
134500,2051506583,81127149,1.0952165115e-11,13364615,1248880,167889628
135000,2050089083,81158561,1.0956405734999999e-11,13430039,1249312,169138940
135500,2074019333,81131735,1.0952784224999999e-11,13513679,1247892,170386832
136000,2196567667,81131467,1.0952748044999998e-11,13504966,1248864,171635696
136500,2328347958,81127905,1.0952267175000001e-11,13389188,1249312,172885008
137000,2248423750,81157013,1.0956196754999998e-11,13379747,1248416,174133424
137500,2056838875,81130008,1.0952551079999998e-11,13457552,1248396,175381820
138000,2068474750,81136943,1.0953487304999998e-11,13682935,1248856,176630676
138500,2076346708,81143666,1.0954394909999999e-11,13901436,1249308,177879984
139000,2066097292,81142791,1.0954276784999999e-11,13872983,1248856,179128840
139500,2076950917,81174434,1.095854859e-11,13945908,1247968,180376808
140000,2071555500,81139892,1.095388542e-11,13778756,1248400,181625208
140500,2074681834,81147172,1.095486822e-11,14015368,1248856,182874064
141000,2074242542,81142205,1.0954197674999999e-11,13853927,1250088,184124152
141500,2073692375,81140870,1.0954017449999999e-11,13810574,1249304,185373456
142000,2074948500,81171450,1.095814575e-11,13848943,1248432,186621888
142500,2075877917,81144246,1.0954473209999999e-11,13920278,1250108,187871996
143000,2089086334,81136183,1.0953384705e-11,13658230,1248764,189120760
143500,2052397333,81126284,1.095204834e-11,13336506,1248432,190369192
144000,2059297584,81154127,1.0955807144999998e-11,13285926,1248416,191617608
144500,2053171375,81126269,1.0952046314999998e-11,13336044,1248440,192866048
145000,2070950375,81135877,1.0953343394999998e-11,13648281,1248432,194114480
145500,2054469125,81150457,1.0955311695e-11,14122127,1250132,195364612
146000,2055248167,81140404,1.0953954539999999e-11,13795425,1248880,196613492
146500,2234169708,81171455,1.0958146424999999e-11,13849111,1249328,197862820
147000,2385645709,81142912,1.0954293119999998e-11,13876932,1248788,199111608
147500,2324566084,81139362,1.095381387e-11,13761548,1247984,200359592
148000,2069074833,81140221,1.0953929835e-11,13789472,1247992,201607584
148500,2056280875,81172795,1.0958327324999998e-11,13892651,1249312,202856896
149000,2053879709,81139770,1.0953868949999999e-11,13774819,1249236,204106132
149500,2068198209,81141037,1.0954039995e-11,13815977,1248432,205354564
150000,2051347500,81138429,1.0953687914999999e-11,13731226,1250140,206604704
150500,2057656000,81126098,1.095202323e-11,13330462,1248880,207853584
151000,2060357875,81161367,1.0956784544999999e-11,13521250,1249320,209102904
151500,2056016917,81129382,1.095246657e-11,13437187,1247960,210350864
152000,2074090042,81132489,1.0952886015e-11,13538168,1248880,211599744
152500,2050393542,81143713,1.0954401255e-11,13902968,1249296,212849040
153000,2050920834,81140481,1.0953964934999998e-11,13797911,1248416,214097456
153500,2050145959,81174165,1.0958512274999998e-11,13937171,1249304,215346760
154000,2069591958,81141720,1.0954132199999999e-11,13838191,1248848,216595608
154500,6475147125,114651435,1.5477943725e-11,13928553,-38412680,178182928
155000,2052557417,81178452,1.095909102e-11,13853470,1248416,179431344
155500,2129554375,81145933,1.0954700955e-11,13975125,1248408,180679752
156000,2075721459,81142234,1.095420159e-11,13854898,1248408,181928160
156500,2164634500,81142912,1.0954293119999998e-11,13876911,1249300,183177460
157000,2198220500,81179084,1.095917634e-11,13874006,1249304,184426764
157500,2198812833,81143221,1.0954334835e-11,13886950,1249328,185676092
158000,2065688792,81141362,1.0954083869999998e-11,13826552,1248432,186924524
158500,2051107791,81133927,1.0953080145e-11,13584921,1249212,188173736
159000,2054563333,81163733,1.0957103954999999e-11,13375104,1247960,189421696
159500,2061367000,81127424,1.0952202239999999e-11,13373573,1248856,190670552
160000,2065285791,81126319,1.0952053064999999e-11,13337655,1247952,191918504
160500,2061123875,81136662,1.0953449369999999e-11,13673803,1249320,193167824
161000,2057210458,81145097,1.0954588094999999e-11,13947937,1249336,194417160
161500,2050142542,81179828,1.0959276779999999e-11,13898182,1248864,195666024
162000,2055468834,81142586,1.0954249109999998e-11,13866322,1247992,196914016
162500,2058133417,81145438,1.095463413e-11,13959033,1249312,198163328
163000,2055030375,81143097,1.0954318094999998e-11,13882954,1248400,199411728
163500,2054914667,81143388,1.0954357379999999e-11,13892380,1247968,200659696
164000,2060308958,81179671,1.0959255584999997e-11,13893082,1248856,201908552
164500,2052789083,81144061,1.0954448234999998e-11,13914278,1248864,203157416
165000,2055891625,81144573,1.0954517355e-11,13930923,1248860,204406276
165500,2222701167,81145555,1.0954649925e-11,13962807,1249760,205656036
166000,2419650209,81169126,1.0957832009999999e-11,13550350,1248412,206904448
166500,2179785834,81139249,1.0953798614999998e-11,13757870,1248864,208153312
167000,2058086250,81142373,1.0954220355e-11,13859389,1248748,209402060
167500,2051322542,81131841,1.0952798534999999e-11,13517120,1247968,210650028
168000,2071328084,81131631,1.0952770184999999e-11,13510289,1248836,211898864
168500,2072926125,81168532,1.0957751819999999e-11,13531048,1248844,213147708
169000,2053414083,81132110,1.0952834849999998e-11,13525873,1247960,214395668
169500,2055530291,81131515,1.0952754525e-11,13506515,1247504,215643172
170000,2051496250,81134357,1.0953138195e-11,13598866,1248856,216892028
170500,2062164375,81174769,1.0958593814999997e-11,13733753,1248880,218140908
171000,2063507958,81128075,1.0952290125e-11,13394723,1248416,219389324
171500,2058156208,81129389,1.0952467514999999e-11,13437408,1248416,220637740
172000,2054311584,81143188,1.0954330379999998e-11,13885880,1248400,221886140
172500,2052155625,81142746,1.095427071e-11,13871531,1248856,223134996
173000,2070860209,81179816,1.0959275159999998e-11,13897780,1248416,224383412
173500,2056538792,81144638,1.0954526129999998e-11,13933035,1248416,225631828
174000,2261272792,81144233,1.0954471455e-11,13919853,1248416,226880244
174500,2318268875,81143274,1.095434199e-11,13888702,1248408,228128652
175000,2181674625,81183963,1.0959835004999998e-11,14032585,1248864,229377516
175500,2102005209,81146584,1.095478884e-11,13996262,1248848,230626364
176000,2059769250,81143239,1.0954337264999999e-11,13887544,1248864,231875228
176500,2052440917,81143207,1.0954332945e-11,13886507,1247968,233123196
177000,2051891625,81180084,1.0959311339999999e-11,13906504,1248416,234371612
177500,2063317833,81143764,1.0954408139999999e-11,13904606,1248848,235620460
178000,2053220625,81144830,1.095455205e-11,13939273,1248840,236869300
178500,2066804541,81138663,1.0953719504999998e-11,13738842,1248740,238118040
179000,2052020875,81127057,1.0952152695e-11,13361627,1248864,239366904
179500,2053026125,81168436,1.095773886e-11,13527946,1248856,240615760
180000,2061718791,81134236,1.0953121859999999e-11,13594943,1247968,241863728
180500,2052195833,81147400,1.0954898999999999e-11,14022774,1248416,243112144
181000,2052723625,81140562,1.0953975869999999e-11,13800563,1249312,244361456
181500,2056645708,81144961,1.0954569735e-11,13943518,1247968,245609424
182000,2050985125,81181059,1.0959442965e-11,13938170,1249312,246858736
182500,2051196208,81143797,1.0954412595e-11,13905668,1248408,248107144
183000,2050926083,81145793,1.0954682054999998e-11,13970537,1249304,249356448
183500,2116928500,81144562,1.095451587e-11,13930554,1247956,250604404
184000,2433547583,81141689,1.0954128015e-11,13837176,1247944,251852348
184500,2336285125,81142594,1.095425019e-11,13866605,1248856,253101204
185000,2131993000,81145444,1.0954634939999999e-11,13959203,1247960,254349164
185500,2066640417,81145494,1.0954641689999998e-11,13960836,1249752,255598916
186000,2077607750,81145616,1.095465816e-11,13964787,1248860,256847776
186500,2074645167,81181547,1.0959508845e-11,13954057,1249312,258097088
187000,2075443458,81138856,1.0953745559999999e-11,13745102,1250100,259347188
187500,2054428167,81127841,1.0952258534999997e-11,13387131,1248864,260596052
188000,2065815208,81127880,1.0952263799999998e-11,13388395,1248864,261844916
188500,2062315334,81133859,1.0953070964999998e-11,13582693,1248416,263093332
189000,2052691709,81128717,1.0952376794999999e-11,13415598,1249312,264342644
189500,2054613125,81133744,1.0953055439999998e-11,13578955,1248852,265591496
190000,2049436083,81145341,1.0954621034999999e-11,13955862,1248864,266840360
190500,2050690958,81147834,1.0954957589999998e-11,14036889,1249304,268089664
191000,8565852916,122606489,1.6551876014999997e-11,13815509,-47815656,220274008
191500,2056387334,81142340,1.09542159e-11,13858344,1249304,221523312
192000,2050476083,81188294,1.0960419689999999e-11,13896581,1247960,222771272
192500,2055650250,81143196,1.095433146e-11,13886139,1248856,224020128
193000,2177244042,81143317,1.0954347795e-11,13890077,1248416,225268544
193500,2116507542,81143856,1.0954420559999999e-11,13907603,1248860,226517404
194000,2405706333,81187411,1.0960300485e-11,13867876,1248844,227766248
194500,2204370625,81142493,1.0954236555e-11,13863315,1248864,229015112
195000,2172378000,81143033,1.0954309455e-11,13880871,1249312,230264424
195500,2070804292,81142293,1.0954209554999998e-11,13856803,1248772,231513196
196000,2057800208,81124969,1.0951870814999999e-11,13293770,1248864,232762060
196500,2071770750,81129137,1.0952433495e-11,13429230,1248860,234010920
197000,2066952250,81138749,1.0953731114999998e-11,13741630,1248864,235259784
197500,2054869750,81142349,1.0954217114999998e-11,13858607,1248840,236508624
198000,2067908709,81141767,1.0954138544999998e-11,13839724,1248856,237757480
198500,2057556375,81187702,1.0960339769999999e-11,13877352,1248416,239005896
199000,2054108083,81144507,1.0954508444999998e-11,13928751,1248888,240254784
199500,2054813709,81142369,1.0954219814999999e-11,13859275,1248416,241503200
200000,2052609208,81142809,1.0954279214999998e-11,13873591,1247968,242751168
200500,2057478042,81147503,1.0954912904999999e-11,14026127,1248856,244000024
201000,2063883125,81185891,1.0960095285e-11,13818482,1248888,245248912
201500,2053511833,81140853,1.0954015155e-11,13809998,1248880,246497792
202000,2056275375,81143794,1.095441219e-11,13905598,1248440,247746232
202500,2114336417,81144025,1.0954443374999999e-11,13913084,1249236,248995468
203000,2147382541,81140050,1.095390675e-11,13783916,1248856,250244324
203500,2244443833,81182560,1.0959645599999999e-11,13710228,1249676,251494000
204000,2253072125,81136318,1.0953402929999999e-11,13662623,1248888,252742888
204500,2068198833,81145843,1.0954688804999999e-11,13972191,1249320,253992208
205000,2055760959,81143423,1.0954362105e-11,13893524,1248764,255240972
205500,2064104750,81174880,1.09586088e-11,13460616,1248408,256489380
206000,2059329834,81133181,1.0952979434999998e-11,13560654,1248416,257737796
206500,2055269333,81146096,1.095472296e-11,13980394,1249320,258987116
207000,2064815916,81144577,1.0954517894999999e-11,13931033,1250100,260237216
207500,2059866917,81145821,1.0954685835e-11,13971477,1249776,261486992
208000,2054277708,81187736,1.096034436e-11,13878446,1248880,262735872
208500,2054074292,81143585,1.0954383974999998e-11,13898814,1247968,263983840
209000,2052865417,81142763,1.0954273005e-11,13872083,1249244,265233084
209500,2048378125,81141914,1.0954158389999998e-11,13844503,1249300,266482384
210000,2066578292,81188127,1.0960397145e-11,13891170,1249320,267731704
210500,2052800375,81133002,1.0952955270000001e-11,13554844,1248796,268980500
211000,2062568917,81127804,1.0952253539999999e-11,13385908,1249336,270229836
211500,2105401125,81128051,1.0952286884999999e-11,13393926,1248880,271478716
212000,2490762958,81174167,1.0958512544999998e-11,13437473,1249684,272728400
212500,2231444458,81143562,1.0954380869999998e-11,13898048,1248880,273977280
213000,2074959250,81143065,1.0954313775e-11,13881914,1249328,275226608
213500,2062751375,81143816,1.0954415159999999e-11,13906296,1250108,276476716
214000,2072198292,81141778,1.095414003e-11,13840070,1248440,277725156
214500,2074294042,81185767,1.0960078544999999e-11,13814464,1248424,278973580
215000,2063136042,81143762,1.095440787e-11,13904541,1250132,280223712
215500,2058477209,81144887,1.0954559744999999e-11,13941113,1247620,281471332
216000,2052439916,81142389,1.0954222514999999e-11,13859909,1248408,282719740
216500,2062088250,81142807,1.0954278944999998e-11,13873498,1247520,283967260
217000,2069817125,81143903,1.0954426905e-11,13909122,1249312,285216572
217500,2065678417,81144712,1.0954536119999999e-11,13935407,1248416,286464988
218000,2071171417,81139304,1.0953806039999999e-11,13759674,1248772,287713760
218500,2054706875,81129396,1.095246846e-11,13437659,1249760,288963520
219000,2055908750,81179717,1.0959261794999999e-11,13617823,1248864,290212384
219500,2051152209,81142658,1.095425883e-11,13868670,1247968,291460352
220000,2409214833,81144757,1.0954542195e-11,13936877,1248416,292708768
220500,2150073000,81147386,1.095489711e-11,14022326,1249756,293958524
221000,2278106208,81142076,1.0954180259999999e-11,13849765,1248424,295206948
221500,2281040042,81143885,1.0954424475e-11,13908537,1248440,296455388
222000,2263256625,81142626,1.0954254509999998e-11,13867631,1248880,297704268
222500,2062036583,81141444,1.0954094939999999e-11,13829210,1248416,298952684
223000,2053845375,81144247,1.0954473344999999e-11,13920323,1248416,300201100
223500,2055167916,81188366,1.0960429409999999e-11,13898927,1248440,301449540
224000,2050888541,81142304,1.095421104e-11,13857165,1248856,302698396
224500,2048323375,81145833,1.0954687455e-11,13971868,1248440,303946836
225000,2049676542,81145239,1.0954607265e-11,13952561,1249660,305196496
225500,2052641167,81192337,1.0960965494999999e-11,14027984,1250664,306447160
226000,2051909375,81133848,1.0953069479999999e-11,13582352,1249660,307696820
226500,2052231292,81125337,1.0951920494999997e-11,13305723,1248432,308945252
227000,2051019708,81126506,1.0952078309999999e-11,13343716,1247544,310192796
227500,2052107875,81129663,1.0952504505e-11,13446322,1250108,311442904
228000,2051207291,81184408,1.095989508e-11,13770294,1247992,312690896
228500,2052186750,81142413,1.0954225754999998e-11,13860689,1248864,313939760
229000,2059289375,81143757,1.0954407194999998e-11,13904386,1249776,315189536
229500,2083630125,81143751,1.0954406385e-11,13904189,1248440,316437976
230000,2398729916,81144780,1.09545453e-11,13937637,1250140,317688116
230500,2219012667,81141747,1.0954135844999998e-11,13839070,1247976,318936092
231000,2169980208,81140151,1.0953920385e-11,13787199,1248888,320184980
231500,2061451375,81142287,1.0954208745e-11,13856611,1248440,321433420
232000,2071281500,81142157,1.0954191194999998e-11,13852388,1249692,322683112
232500,2063385042,81186790,1.096021665e-11,13847704,1248880,323931992
233000,2053502041,81134933,1.0953215954999998e-11,13617624,1248788,325180780
233500,3283062042,81128609,1.0952362215e-11,13412079,1249328,326430108
234000,2053596250,81127688,1.0952237879999998e-11,13382144,1250116,327680224
234500,2061374250,81181165,1.0959457275e-11,13664887,1247992,328928216
235000,2052072125,81143683,1.0954397204999998e-11,13901980,1247992,330176208
235500,2057397875,81145131,1.0954592685e-11,13949033,1250132,331426340
236000,11075273583,132381574,1.787151249e-11,13597350,-59252260,272174080
236500,2055015000,81134421,1.0953146835e-11,13600952,1247960,273422040
237000,2094912500,81134440,1.0953149399999999e-11,13601578,1247968,274670008
237500,2073856709,81190557,1.0960725194999999e-11,13629483,1249304,275919312
238000,2052607167,81132760,1.0952922599999999e-11,13546993,1247960,277167272
238500,2099097166,81134509,1.0953158714999999e-11,13603840,1248864,278416136
239000,2069323333,81135488,1.0953290879999999e-11,13635653,1249752,279665888
239500,2137030041,81132473,1.0952883854999999e-11,13537659,1247968,280913856
240000,2316640875,81191674,1.096087599e-11,13665783,1247968,282161824
240500,2134612375,81146923,1.0954834604999999e-11,14007282,1249236,283411060
241000,2063291750,81125828,1.0951986779999999e-11,13321696,1248880,284659940
241500,2075123208,81134022,1.095309297e-11,13587988,1247964,285907904
242000,2052522916,81200986,1.0962133109999999e-11,13968396,1249768,287157672
242500,2053506375,81144341,1.0954486034999999e-11,13923350,1249212,288406884
243000,2051069458,81143390,1.0954357649999998e-11,13892462,1249320,289656204
243500,2050861292,81144886,1.095455961e-11,13941082,1249328,290905532
244000,2051097000,81144680,1.0954531799999999e-11,13934384,1249668,292155200
244500,2051567500,81195400,1.0961378999999998e-11,13786854,1248408,293403608
245000,2050402542,81141502,1.095410277e-11,13831108,1248848,294652456
245500,2051399625,81144908,1.095456258e-11,13941787,1248432,295900888
246000,2056222583,81139494,1.0953831689999999e-11,13765832,1248440,297149328
246500,2054486542,81198867,1.0961847044999999e-11,13899549,1248872,298398200
247000,2052313500,81138232,1.095366132e-11,13724835,1249564,299647764
247500,2050931375,81121865,1.0951451775e-11,13192910,1248440,300896204
248000,2051495083,81123522,1.0951675469999999e-11,13246757,1248416,302144620
248500,2056276958,81128166,1.0952302409999999e-11,13397693,1248440,303393060
249000,2051684166,81196156,1.0961481059999999e-11,13811429,1248880,304641940
249500,2051328042,81140941,1.0954027034999999e-11,13812856,1248416,305890356
250000,2075028458,81142549,1.0954244115e-11,13865106,1248880,307139236
250500,2192889125,81144977,1.0954571895e-11,13944034,1250580,308389816
251000,2317109250,81140965,1.0954030275e-11,13813636,1247968,309637784
251500,2272354917,81192636,1.096100586e-11,13697051,1247992,310885776
252000,2134936791,81138651,1.0953717885e-11,13738451,1247976,312133752
252500,2060577125,81141708,1.0954130579999999e-11,13837802,1249676,313383428
253000,2065226791,81141211,1.0954063484999997e-11,13821639,1248440,314631868
253500,2068828750,81196708,1.0961555579999999e-11,13829359,1248440,315880308
254000,2066144250,81140713,1.0953996254999998e-11,13805471,1247984,317128292
254500,2056433208,81143054,1.095431229e-11,13881544,1269452,318397744
255000,2061582375,81140199,1.0953926864999998e-11,13788739,1267336,319665080
255500,2063249375,81142186,1.095419511e-11,13853319,1266416,320931496
256000,2048128958,81209782,1.0963320569999999e-11,14254281,1266872,322198368
256500,2052088917,81153907,1.0955777444999999e-11,14234252,1265960,323464328
257000,2055646959,81155847,1.0956039345e-11,14297296,1268224,324732552
257500,2053051959,81152983,1.0955652705e-11,14204244,1266856,325999408
258000,2069073917,81153481,1.0955719934999999e-11,14220408,1266880,327266288
258500,2061230292,81208603,1.0963161404999998e-11,14215969,1266408,328532696
259000,2154316709,81155708,1.0956020579999998e-11,14292798,1266864,329799560
259500,2220221542,81155949,1.0956053115e-11,14300644,1266440,331066000
260000,2154687208,81152968,1.0955650679999999e-11,14203749,1265984,332331984
260500,2332671208,81214072,1.0963899719999999e-11,14393720,1265968,333597952
261000,2077140292,81152114,1.0955535389999998e-11,14175993,1266408,334864360
261500,2064320292,81153702,1.095574977e-11,14227593,1266864,336131224
262000,2069405917,81154465,1.0955852774999998e-11,14252414,1266432,337397656
262500,2060146833,81201557,1.0962210194999998e-11,13986976,1268048,338665704
263000,2064478625,81155322,1.095596847e-11,14280246,1267312,339933016
263500,2057892750,81156424,1.095611724e-11,14316047,1267336,341200352
264000,2057866708,81155873,1.0956042854999998e-11,14298136,1266888,342467240
264500,2051157084,81157392,1.0956247919999998e-11,14347525,1266432,343733672
265000,2054058292,81210260,1.09633851e-11,14269829,1267644,345001316
265500,2061180500,81158219,1.0956359565e-11,14374404,1266432,346267748
266000,2061690083,81155321,1.0955968334999998e-11,14280218,1266888,347534636
266500,2048618542,81155347,1.0955971845e-11,14281065,1267336,348801972
267000,2050584500,81156610,1.095614235e-11,14322097,1268588,350070560
267500,2050092500,81209652,1.0963303019999998e-11,14250071,1265992,351336552
268000,2063039958,81154981,1.0955922434999999e-11,14269184,1266888,352603440
268500,2320361375,81154957,1.0955919195e-11,14268385,1268140,353871580
269000,2311359041,81149068,1.095512418e-11,14077003,1267236,355138816
269500,2292068250,81204643,1.0962626805000001e-11,14087247,1266888,356405704
270000,2106614000,81152749,1.0955621115e-11,14196644,1267220,357672924
270500,2052107375,81147612,1.0954927619999999e-11,14029669,1266880,358939804
271000,2053128958,81151700,1.09554795e-11,14162520,1266416,360206220
271500,2057721917,81210314,1.0963392389999999e-11,14271579,1266416,361472636
272000,2055960541,81155915,1.0956048525e-11,14299525,1267312,362739948
272500,2071651625,81155805,1.0956033675e-11,14295949,1267312,364007260
273000,2062133666,81156321,1.0956103335e-11,14312734,1266400,365273660
273500,2062242875,81153993,1.0955789054999997e-11,14237048,1266408,366540068
274000,2055996625,81210346,1.096339671e-11,14272604,1267308,367807376
274500,2090785584,81153259,1.0955689965e-11,14213188,1265952,369073328
275000,2055282292,81154297,1.0955830094999999e-11,14246928,1267312,370340640
275500,2058151542,81158663,1.0956419505e-11,14388823,1267304,371607944
276000,2050338917,81157270,1.095623145e-11,14343571,1266864,372874808
276500,2050747875,81210178,1.0963374029999998e-11,14267145,1266432,374141240
277000,2257970459,81148540,1.0955052899999999e-11,14059833,1266764,375408004
277500,2202500750,81138954,1.0953758789999999e-11,13748298,1266864,376674868
278000,2301596167,81143525,1.0954375875e-11,13896845,1266864,377941732
278500,2243884458,81151495,1.0955451824999999e-11,14155881,1265512,379207244
279000,2062801750,81153381,1.0955706434999999e-11,14217150,1265984,380473228
279500,2067021250,81156217,1.0956089295e-11,14309331,1265080,381738308
280000,2053668250,81156246,1.0956093209999998e-11,14310284,1266880,383005188
280500,2067178250,81211149,1.0963505114999999e-11,14298722,1266788,384271976
281000,2064651708,81153165,1.0955677274999998e-11,14210151,1266880,385538856
281500,2060382917,81154729,1.0955888414999998e-11,14260993,1267328,386806184
282000,2052429375,81154043,1.0955795804999998e-11,14238685,1265976,388072160
282500,2055400542,81156305,1.0956101175e-11,14312205,1268140,389340300
283000,2051192500,81211646,1.0963572209999999e-11,14314873,1266432,390606732
283500,2053629500,81156645,1.0956147074999998e-11,14323255,1266888,391873620
284000,2053990959,81156441,1.0956119534999998e-11,14316607,1268920,393142540
284500,2051892458,81154729,1.0955888414999998e-11,14260993,1266888,394409428
285000,2052061542,81163149,1.0957025115e-11,14534609,1265976,395675404
285500,2052424125,81227336,1.0965690359999999e-11,14824782,1266432,396941836
286000,2052907083,81169177,1.0957838895e-11,14730542,1267328,398209164
286500,2051813792,81167707,1.0957640444999999e-11,14682753,1265536,399474700
287000,2051087125,81169076,1.0957825259999998e-11,14727238,1266880,400741580
287500,2119493208,81170309,1.0957991714999999e-11,14767320,1268132,402009712
288000,2213656667,81166991,1.0957543785e-11,14659477,1266432,403276144
288500,2416158000,81169294,1.095785469e-11,14734344,1267328,404543472
289000,6946643583,81169427,1.0957872644999998e-11,14738653,1267220,405810692
289500,2059518250,81238164,1.096715214e-11,14817508,1266888,407077580
290000,2068092541,81170559,1.0958025464999999e-11,14775437,1266440,408344020
290500,14080985000,144254781,1.9474395434999998e-11,14878078,-73317012,335027008
291000,2054598750,81165565,1.0957351274999999e-11,14613145,1268448,336295456
291500,2054700125,81221737,1.0964934494999999e-11,14229468,1266864,337562320
292000,2052827333,81156952,1.0956188519999998e-11,14333207,1266408,338828728
292500,2055023541,81158467,1.0956393044999999e-11,14382450,1267312,340096040
293000,2068533750,81162187,1.0956895245e-11,14503360,1267320,341363360
293500,2071348875,81169965,1.0957945274999999e-11,14756128,1266408,342629768
294000,2057445458,81238562,1.0967205869999999e-11,14776312,1267328,343897096
294500,2059331584,81170916,1.095807366e-11,14787060,1266416,345163512
295000,2074292750,81170825,1.0958061375e-11,14784109,1267312,346430824
295500,2059919000,81173843,1.0958468805e-11,14882185,1266416,347697240
296000,2055816500,81234623,1.0966674105e-11,14648281,1267784,348965024
296500,2063440916,81168501,1.0957747634999998e-11,14708565,1267292,350232316
297000,2163634250,81166665,1.0957499775e-11,14648906,1266432,351498748
297500,2228957292,81165266,1.095731091e-11,14603425,1267692,352766440
298000,2193279917,81167524,1.0957615739999999e-11,14676813,1266872,354033312
298500,2083333333,81236638,1.0966946129999999e-11,14713780,1266888,355300200
299000,2053644750,81158766,1.095643341e-11,14392168,1267236,356567436
299500,2049878416,81151536,1.095545736e-11,14157197,1266772,357834208
300000,2059053292,81155579,1.0956003165e-11,14288601,1267308,359101516
300500,2058192750,81233067,1.0966464045e-11,14597718,1266432,360367948
301000,2070025750,81157629,1.0956279914999998e-11,14355216,1266864,361634812
301500,2057356333,81157330,1.095623955e-11,14345520,1267244,362902056
302000,2067068584,81170537,1.0958022495e-11,14774747,1266872,364168928
302500,2053207917,81170494,1.095801669e-11,14773347,1266432,365435360
303000,2089414583,81240768,1.096750368e-11,14847978,1267684,366703044
303500,2050771166,81168633,1.0957765455e-11,14712866,1266432,367969476
304000,2058320667,81169857,1.0957930695e-11,14752619,1266432,369235908
304500,2050713000,81170182,1.0957974569999998e-11,14763205,1265536,370501444
305000,2062525000,81169893,1.0957935554999999e-11,14753797,1265992,371767436
305500,2083208083,81240508,1.0967468579999999e-11,14839544,1266872,373034308
306000,2259040916,81169033,1.0957819455e-11,14725838,1266880,374301188
306500,2255233084,81167946,1.0957672709999999e-11,14690536,1266416,375567604
307000,2283093125,81169307,1.0957856444999999e-11,14734768,1266880,376834484
307500,2066465875,81235821,1.0966835835e-11,14687201,1268080,378102564
308000,2066434416,81157023,1.0956198105e-11,14335521,1266864,379369428
308500,2061434583,81158853,1.0956445154999998e-11,14395003,1267784,380637212
309000,2064718875,81161125,1.0956751875e-11,14468853,1267336,381904548
309500,2062454583,81236528,1.0966931279999999e-11,14710182,1266416,383170964
310000,2057924917,81171451,1.0958145884999998e-11,14804434,1266856,384437820
310500,2067204541,81176206,1.095878781e-11,14958986,1266440,385704260
311000,2049327083,81172569,1.0958296814999999e-11,14840772,1265960,386970220
311500,2050134333,81170926,1.095807501e-11,14787371,1266396,388236616
312000,2053510250,81237777,1.0967099894999998e-11,14750783,1266856,389503472
312500,2064303083,81171248,1.0958118479999999e-11,14797839,1266848,390770320
313000,2075009625,81170141,1.0957969034999998e-11,14761863,1265968,392036288
313500,2060548417,81171459,1.0958146964999998e-11,14804701,1266416,393302704
314000,2080768792,81172981,1.0958352435e-11,14854175,1266864,394569568
314500,2317496542,81237840,1.09671084e-11,14752818,1265536,395835104
315000,2453371833,81172574,1.095829749e-11,14840929,1266416,397101520
315500,2512414541,81174280,1.09585278e-11,14896381,1266880,398368400
316000,2241795250,81162050,1.0956876749999999e-11,14498898,1267244,399635644
316500,2076363875,81153032,1.095565932e-11,14205828,1265968,400901612
317000,2056209125,81157765,1.0956298275e-11,14359649,1266856,402168468
317500,2066054500,81161225,1.0956765375e-11,14472105,1266888,403435356
318000,2067021834,81155119,1.0955941065e-11,14273640,1266856,404702212
318500,2066692750,81228746,1.0965880709999999e-11,14457291,1266416,405968628
319000,2059309875,81172820,1.0958330699999998e-11,14848925,1268192,407236820
319500,2055866542,81171278,1.0958122529999998e-11,14798808,1267328,408504148
320000,2049031750,81172869,1.0958337315e-11,14850520,1266880,409771028
320500,2053148416,81170502,1.0958017769999999e-11,14773597,1265968,411036996
321000,2057557375,81235832,1.096683732e-11,14687562,1267336,412304332
321500,2059327000,81168097,1.0957693094999998e-11,14695445,1266880,413571212
322000,2061071584,81172148,1.0958239979999998e-11,14827078,1267300,414838512
322500,2055552875,81169019,1.0957817565e-11,14725414,1265960,416104472
323000,2068189917,81169641,1.0957901534999998e-11,14745603,1266856,417371328
323500,2069023875,81238782,1.0967235569999998e-11,14783431,1266888,418638216
324000,2106934083,81171051,1.0958091885e-11,14791430,1266864,419905080
324500,2385339208,81163427,1.0957062645e-11,14543675,1265876,421170956
325000,2375460292,81153710,1.095575085e-11,14227851,1265520,422436476
325500,2221261042,81225543,1.0965448305e-11,14353190,1265968,423702444
326000,2060102750,81162466,1.095693291e-11,14512429,1266408,424968852
326500,2053385792,81173521,1.0958425335e-11,14871702,1266416,426235268
327000,2052621875,81172949,1.0958348115e-11,14853131,1266856,427502124
327500,2050917958,81239002,1.096726527e-11,14790611,1266408,428768532
328000,2049383709,81171369,1.0958134814999999e-11,14801788,1266864,430035396
328500,2050816208,81171270,1.0958121449999998e-11,14798564,1266408,431301804
329000,2052603084,81170329,1.0957994415e-11,14767994,1266416,432568220
329500,2052465000,81172047,1.0958226345e-11,14823822,1266408,433834628
330000,2051182167,81237291,1.0967034285e-11,14734977,1265960,435100588
330500,2052805208,81174435,1.0958548724999998e-11,14901411,1267312,436367900
331000,2052670417,81169180,1.09578393e-11,14730629,1267304,437635204
331500,2052429667,81170147,1.0957969845e-11,14762061,1267336,438902540
332000,2052084750,81172316,1.0958262659999999e-11,14832553,1267760,440170300
332500,2051163791,81236977,1.0966991894999998e-11,14724791,1265968,441436268
333000,2080161167,81168873,1.0957797854999999e-11,14720668,1268116,442704384
333500,2450101333,81157465,1.0956257774999999e-11,14349907,1267312,443971696
334000,2296616958,81170869,1.0958067314999999e-11,14785518,1265960,445237656
334500,2179852333,81239281,1.0967302934999998e-11,14799654,1266440,446504096
335000,2055571042,81169224,1.0957845239999999e-11,14732071,1265968,447770064
335500,2054274792,81172552,1.0958294519999997e-11,14840210,1265960,449036024
336000,2064509334,81165978,1.0957407029999998e-11,14626585,1265956,450301980
336500,2057624042,81241162,1.096755687e-11,14860799,1266416,451568396
337000,2064711750,81171174,1.0958108489999999e-11,14795432,1265960,452834356
337500,2058097208,81171657,1.0958173694999998e-11,14811116,1266864,454101220
338000,2059076917,81171532,1.0958156819999999e-11,14807078,1267312,455368532
338500,2068274750,81170345,1.0957996575e-11,14768485,1266864,456635396
339000,2075381333,81236545,1.0966933574999998e-11,14710736,1265960,457901356
339500,2057778791,81173579,1.0958433164999998e-11,14873604,1266408,459167764
340000,2071896416,81171035,1.0958089725e-11,14790911,1267296,460435060
340500,2072727042,81171688,1.0958177879999997e-11,14812141,1266392,461701452
341000,2061996459,81171143,1.0958104305e-11,14794426,1266864,462968316
341500,2055825875,81233324,1.096649874e-11,14606054,1266300,464234616
342000,2400465583,81160658,1.0956688829999999e-11,14453683,1266864,465501480
342500,2444067708,81171353,1.0958132655e-11,14801259,1266400,466767880
343000,2190439958,81225699,1.0965469364999998e-11,14358250,1265968,468033848
343500,2125924458,81155322,1.095596847e-11,14280254,1266408,469300256
344000,2051409708,81155989,1.0956058515e-11,14301940,1265968,470566224
344500,2051681583,81158446,1.0956390209999999e-11,14381777,1265968,471832192
345000,2050884167,81172685,1.0958312475e-11,14844529,1267748,473099940
345500,2052002042,81239128,1.096728228e-11,14794687,1265048,474364988
346000,2051979959,81173605,1.0958436675e-11,14874460,1267292,475632280
346500,2061756292,81168095,1.0957692824999999e-11,14695380,1266408,476898688
347000,2064503209,81170291,1.0957989284999998e-11,14766737,1267760,478166448
347500,2071743000,81168184,1.0957704839999999e-11,14698249,1266416,479432864
348000,2055178917,81236074,1.0966869989999998e-11,14695433,1266416,480699280
348500,2052387708,81169545,1.0957888574999999e-11,14742509,1266856,481966136
349000,2057015041,81169851,1.0957929884999998e-11,14752436,1266408,483232544
349500,2051604250,81169979,1.0957947164999999e-11,14756586,1266864,484499408
350000,2055675500,81233363,1.0966504005e-11,14607329,1267668,485767076
350500,2056620083,81160047,1.0956606344999998e-11,14433805,1266864,487033940
351000,2063498000,81161077,1.0956745394999999e-11,14467268,1266880,488300820
351500,2052689458,81171599,1.0958165864999999e-11,14809249,1267320,489568140
352000,2051938042,81170793,1.0958057054999998e-11,14783059,1267336,490835476
352500,2064156709,81240650,1.096748775e-11,14844149,1266880,492102356
353000,2069024417,81168571,1.0957757084999998e-11,14710847,1267204,493369560
353500,2296973000,81171093,1.0958097555e-11,14792807,1267296,494636856
354000,2182294125,81170235,1.0957981724999997e-11,14764920,1266440,495903296
354500,2118170458,81240251,1.0967433884999998e-11,14831188,1268132,497171428
355000,2145926250,81167942,1.095767217e-11,14690393,1265976,498437404
355500,2060821125,81172577,1.0958297895e-11,14841032,1267304,499704708
356000,2056426875,81166145,1.0957429574999999e-11,14632011,1267336,500972044
356500,2052161750,81167675,1.0957636125e-11,14681720,1266880,502238924
357000,4739712000,81242754,1.096777179e-11,14691606,1267572,503506496
357500,17679061250,158788278,2.1436417529999998e-11,14185110,-91214200,412292296
358000,2070124708,81160872,1.0956717719999998e-11,14460627,1267328,413559624
358500,2059043542,81253315,1.0969197524999998e-11,14745899,1268132,414827756
359000,2063999042,81170373,1.0958000355e-11,14769418,1268232,416095988
359500,2076690958,81167484,1.0957610339999999e-11,14675507,1266424,417362412
360000,2048985291,81169421,1.0957871834999998e-11,14738456,1267668,418630080
360500,2047632042,81172781,1.0958325434999998e-11,14847652,1267776,419897856
361000,2051589792,81252997,1.0969154594999999e-11,14735572,1266416,421164272
361500,2304357958,81169661,1.0957904234999998e-11,14746264,1266408,422430680
362000,2128032500,81170018,1.0957952429999998e-11,14757879,1266864,423697544
362500,2107238708,81169103,1.0957828904999999e-11,14728116,1265544,424963088
363000,2309314834,81249815,1.0968725024999999e-11,14632150,1265504,426228592
363500,2298108250,81171172,1.0958108219999998e-11,14795371,1266856,427495448
364000,2053586541,81169385,1.0957866974999999e-11,14737282,1266408,428761856
364500,2057352833,81166893,1.0957530555e-11,14656302,1267660,430029516
365000,2056265417,81238792,1.0967236919999998e-11,14273913,1266864,431296380
365500,2052643125,81158561,1.0956405734999999e-11,14385504,1267312,432563692
366000,2072220708,81162971,1.0957001085e-11,14528835,1266432,433830124
366500,2060111334,81167669,1.0957635315e-11,14681538,1265992,435096116
367000,2073087125,81168259,1.0957714964999999e-11,14700696,1266440,436362556
367500,2053949417,81254711,1.0969385984999999e-11,14791292,1267304,437629860
368000,2051590125,81170604,1.0958031539999998e-11,14776905,1268104,438897964
368500,2050649708,81167868,1.0957662179999999e-11,14688005,1266848,440164812
369000,2072160458,81169811,1.0957924485e-11,14751126,1266404,441431216
369500,2059398792,81171192,1.0958110919999998e-11,14796011,1266432,442697648
370000,2063109750,81252315,1.0969062525e-11,14713404,1268140,443965788
370500,2206353417,81172481,1.0958284935e-11,14837925,1266872,445232660
371000,2131091666,81154474,1.095585399e-11,14252676,1265976,446498636
371500,2264840583,81162412,1.0956925619999999e-11,14510685,1266432,447765068
372000,2250490958,81247742,1.096844517e-11,14564780,1267692,449032760
372500,2330779833,81155964,1.095605514e-11,14301102,1267244,450300004
373000,2053439292,81155446,1.0955985209999999e-11,14284294,1265528,451565532
373500,2054136500,81156673,1.0956150854999998e-11,14324171,1266880,452832412
374000,2051395333,81239923,1.0967389604999999e-11,14310659,1266424,454098836
374500,2067993875,81159145,1.0956484574999999e-11,14404484,1267684,455366520
375000,2060407250,81157106,1.0956209309999999e-11,14338241,1265984,456632504
375500,2053611667,81155753,1.0956026654999999e-11,14294248,1267760,457900264
376000,2063657666,81157579,1.0956273164999999e-11,14353606,1266840,459167104
376500,2072671792,81244140,1.0967958899999998e-11,14447734,1266408,460433512
377000,2061133958,81170678,1.095804153e-11,14779329,1266864,461700376
377500,2066216959,81172215,1.0958249024999998e-11,14829283,1266864,462967240
378000,2065314708,81171873,1.0958202855e-11,14818141,1266400,464233640
378500,2049843417,81172055,1.0958227425e-11,14824061,1266384,465500024
379000,2060640292,81253809,1.0969264215e-11,14761971,1265944,466765968
379500,2058644708,81169729,1.0957913414999999e-11,14748464,1265960,468031928
380000,2451805375,81172198,1.0958246729999998e-11,14828720,1266848,469298776
380500,2231751750,81172212,1.0958248619999998e-11,14829173,1266416,470565192
381000,2197152375,81251536,1.0968957359999999e-11,14688089,1265528,471830720
381500,2190087375,81170639,1.0958036265e-11,14778052,1266864,473097584
382000,2057521208,81171161,1.0958106734999998e-11,14795024,1266408,474363992
382500,2062280000,81169845,1.0957929074999998e-11,14752248,1265944,475629936
383000,2072371667,81253347,1.0969201845e-11,14746963,1265520,476895456
383500,2070113625,81172172,1.095824322e-11,14827861,1267660,478163116
384000,2059995167,81173602,1.095843627e-11,14874358,1267336,479430452
384500,2056467792,81168671,1.0957770584999998e-11,14714102,1267292,480697744
385000,2062007958,81177118,1.0958910929999999e-11,14988622,1266440,481964184
385500,2054203625,81269958,1.0971444329999998e-11,15286817,1266880,483231064
386000,2054154459,81173789,1.0958461515e-11,14880434,1265968,484497032
386500,2049653041,81183087,1.0959716744999998e-11,15182613,1265992,485763024
387000,2051887792,81185434,1.096003359e-11,15258880,1266864,487029888
387500,2053475291,81187036,1.0960249859999999e-11,15310952,1267308,488297196
388000,2052454125,81270281,1.0971487934999999e-11,15297312,1268108,489565304
388500,2056654334,81184427,1.0959897645e-11,15226153,1266852,490832156
389000,2052013333,81184545,1.0959913574999998e-11,15229997,1266432,492098588
389500,2052061583,81183624,1.095978924e-11,15200063,1267296,493365884
390000,2045469250,81269747,1.0971415844999999e-11,15279936,1267292,494633176
390500,2382644833,81189063,1.0960523504999998e-11,15376832,1266432,495899608
391000,2308078375,81183406,1.095975981e-11,15192987,1266872,497166480
391500,2247338583,81166370,1.0957459950000001e-11,14639305,1267592,498434072
392000,2176528541,81236117,1.0966875795e-11,14186980,1267692,499701764
392500,2053518125,81155489,1.0955991014999999e-11,14285669,1266888,500968652
393000,2055846750,81162718,1.0956966929999998e-11,14520635,1266856,502235508
393500,2054772792,81170462,1.0958012369999999e-11,14772302,1268108,503503616
394000,2072640584,81167437,1.0957603994999999e-11,14673997,1265992,504769608
394500,2046547084,81253052,1.0969162019999999e-11,14737346,1266400,506036008
395000,2055247459,81170214,1.0957978889999999e-11,14764235,1266872,507302880
395500,2053951084,81175179,1.0958649164999999e-11,14925610,1268108,508570988
396000,2044753166,81171300,1.09581255e-11,14799530,1266732,509837720
396500,2057283209,81169897,1.0957936095e-11,14753920,1266848,511104568
397000,2061522000,81250917,1.0968873795e-11,14667958,1265960,512370528
397500,2068585708,81168844,1.0957793939999998e-11,14719723,1266392,513636920
398000,2055543416,81165710,1.0957370849999998e-11,14617872,1268532,514905452
398500,2068558916,81152996,1.0955654459999999e-11,14204663,1265968,516171420
399000,2055632917,81155098,1.0955938229999999e-11,14272974,1266848,517438268
399500,2110719166,81165714,1.095737139e-11,14617993,1265960,518704228
400000,2398255334,81168925,1.0957804874999999e-11,14722358,1265952,519970180
400500,2292257708,81172001,1.0958220134999999e-11,14822305,1266400,521236580
401000,2162823208,81243052,1.096781202e-11,14412374,1266440,522503020
401500,2061129000,81169927,1.0957940144999999e-11,14754902,1265536,523768556
402000,2061856208,81171158,1.0958106329999998e-11,14794922,1266872,525035428
402500,2057559125,81168185,1.0957704975e-11,14698295,1266320,526301748
403000,2061880083,81166663,1.0957499505000001e-11,14648827,1265984,527567732
403500,2054405791,81254425,1.0969347375e-11,14781985,1267776,528835508
404000,2061198625,81171209,1.0958113215e-11,14796585,1267236,530102744
404500,2054713000,81169855,1.0957930425e-11,14752560,1266432,531369176
405000,2055934875,81172169,1.0958242815e-11,14827795,1265992,532635168
405500,2058672167,81168651,1.0957767885e-11,14713430,1268572,533903740
406000,2049614666,81243657,1.0967893695e-11,14432008,1266888,535170628
406500,2050238542,81154411,1.0955845485e-11,14250651,1266864,536437492
407000,2062736708,81156169,1.0956082814999999e-11,14307773,1266856,537704348
407500,2071298791,81158092,1.0956342419999998e-11,14370270,1266872,538971220
408000,2064407333,81251273,1.0968921854999998e-11,14679540,1265984,540237204
408500,2302131291,81172637,1.0958305995e-11,14842981,1266864,541504068
409000,2367687667,81172909,1.0958342714999998e-11,14851836,1266856,542770924
409500,2171804250,81171597,1.0958165595e-11,14809205,1266400,544037324
410000,2224263417,81255200,1.0969451999999999e-11,14807157,1266888,545304212
410500,2053441416,81172590,1.095829965e-11,14841463,1266864,546571076
411000,2056823583,81169353,1.0957862654999999e-11,14736256,1266856,547837932
411500,2066574083,81171588,1.0958164379999998e-11,14808888,1267320,549105252
412000,2063757042,81170604,1.0958031539999998e-11,14776902,1267244,550372496
412500,2055626291,81254527,1.0969361144999998e-11,14785286,1267336,551639832
413000,2058484209,81169306,1.095785631e-11,14734745,1266856,552906688
413500,2056659500,81161170,1.0956757949999998e-11,14470304,1267212,554173900
414000,2051450167,81155746,1.095602571e-11,14294039,1266796,555440696
414500,2054167625,81167443,1.0957604805e-11,14674188,1266440,556707136
415000,2059613625,81254893,1.0969410554999999e-11,14797181,1268216,557975352
415500,2060727250,81174859,1.0958605965e-11,14915201,1266888,559242240
416000,2051090584,81168873,1.0957797854999999e-11,14720648,1265968,560508208
416500,2050632250,81168840,1.09577934e-11,14719592,1266880,561775088
417000,2041176417,81172268,1.0958256179999997e-11,14830977,1267204,563042292
417500,2389453167,81252533,1.0969091954999998e-11,14720504,1266440,564308732
418000,2259800416,81168407,1.0957734945e-11,14705515,1266888,565575620
418500,2334190958,81169838,1.0957928129999999e-11,14752026,1266872,566842492
419000,2459934958,81254852,1.096940502e-11,14795856,1267692,568110184
419500,2091771708,81170483,1.0958015205e-11,14772982,1266872,569377056
420000,2058820833,81170651,1.0958037884999999e-11,14778439,1266424,570643480
420500,2062168583,81165081,1.0957285935e-11,14597416,1267236,571910716
421000,2067451958,81154120,1.09558062e-11,14241168,1265508,573176224
421500,2057210125,81243543,1.0967878305e-11,14428316,1267312,574443536
422000,2064480791,81159017,1.0956467295e-11,14400326,1266840,575710376
422500,2053409542,81160610,1.0956682349999998e-11,14452098,1265976,576976352
423000,2062577666,81170606,1.0958031809999998e-11,14776966,1266408,578242760
423500,2051329375,81254873,1.0969407855e-11,14796552,1266856,579509616
424000,2061615542,81171934,1.0958211089999999e-11,14820145,1266856,580776472
424500,2053753417,81169279,1.0957852664999998e-11,14733865,1266408,582042880
425000,2057830125,81170407,1.0958004944999999e-11,14770513,1265504,583308384
425500,2057024625,81172221,1.0958249834999998e-11,14829459,1266848,584575232
426000,2055152667,81253932,1.096928082e-11,14765967,1266888,585842120
426500,2054747000,81168586,1.0957759109999999e-11,14711317,1266888,587109008
427000,2335737209,81170227,1.0957980644999998e-11,14764669,1267668,588376676
427500,2249743084,81168047,1.0957686345e-11,14693804,1266880,589643556
428000,2333049541,81255108,1.0969439579999999e-11,14804189,1267336,590910892
428500,2246819541,81164144,1.0957159439999999e-11,14566967,1267684,592178576
429000,2063059250,81155796,1.0956032459999999e-11,14295643,1267692,593446268
429500,2074482959,81156991,1.0956193784999999e-11,14334504,1268200,594714468
430000,2051753916,81165262,1.095731037e-11,14603291,1265976,595980444
430500,2051861708,81257485,1.0969760475e-11,14881444,1267668,597248112
431000,2059519042,81167443,1.0957604805e-11,14674183,1267336,598515448
431500,2052734292,81168589,1.0957759515e-11,14711422,1266424,599781872
432000,2051673292,81170341,1.0957996034999997e-11,14768365,1266772,601048644
432500,2057424000,81255960,1.0969554599999998e-11,14831879,1267776,602316420
433000,2052754916,81169339,1.0957860764999999e-11,14735796,1265984,603582404
433500,2051966708,81170007,1.0957950944999998e-11,14757525,1267244,604849648
434000,2054467167,81168797,1.0957787594999998e-11,14718200,1265992,606115640
434500,2052036458,81174835,1.0958602725e-11,14914431,1265544,607381184
435000,2045917208,81261895,1.0970355825e-11,15024758,1267684,608648868
435500,2052160625,81171118,1.095810093e-11,14793607,1267744,609916612
436000,2120796625,81140245,1.0953933075e-11,13790243,1266408,611183020
436500,2155042584,81142555,1.0954244924999997e-11,13865327,1265960,612448980
437000,2262310791,81149783,1.0955220704999999e-11,14100217,1266408,613715388
437500,2149741666,81161083,1.0956746205e-11,14467488,1267312,614982700
438000,2201805333,81158433,1.0956388455e-11,14381338,1265968,616248668
438500,2057660875,81159023,1.0956468104999998e-11,14400527,1266880,617515548
439000,2058111791,81160685,1.0956692474999998e-11,14454536,1266416,618781964
439500,22000499917,176672094,2.385073269e-11,14373792,-111923520,506858444
440000,3276941083,81261372,1.0970285219999998e-11,14387248,1266860,508125304
440500,2069066125,81159907,1.0956587444999998e-11,14429257,1266864,509392168
441000,2054818875,81158565,1.0956406275e-11,14385630,1267776,510659944
441500,2071388708,81158393,1.0956383054999998e-11,14380055,1266872,511926816
442000,2055896791,81262820,1.0970480699999998e-11,14434313,1266440,513193256
442500,2053925917,81157426,1.0956252509999998e-11,14348645,1268116,514461372
443000,2057205583,81155471,1.0955988584999999e-11,14285090,1265536,515726908
443500,2051645750,81153962,1.0955784870000001e-11,14236052,1267244,516994152
444000,2059202000,81144033,1.0954444454999998e-11,13913337,1267328,518261480
444500,2061956375,81247678,1.096843653e-11,13942193,1266340,519527820
445000,2054395041,81150292,1.095528942e-11,14116763,1265512,520793332
445500,2070410875,81151333,1.0955429954999998e-11,14150590,1267308,522060640
446000,2079500125,81158047,1.0956336345e-11,14368803,1266880,523327520
446500,2129002541,81259296,1.097000496e-11,14319781,1266440,524593960
447000,2221079959,81155327,1.0955969145e-11,14280416,1267228,525861188
447500,2269825291,81155761,1.0956027734999998e-11,14294513,1265984,527127172
448000,2053168667,81158466,1.0956392909999998e-11,14382432,1265992,528393164
448500,2050851209,81158080,1.09563408e-11,14369872,1266880,529660044
449000,2051997917,81258105,1.0969844174999998e-11,14281061,1267236,530927280
449500,2055169084,81156975,1.0956191625e-11,14333962,1265984,532193264
450000,2064350208,81158281,1.0956367935e-11,14376428,1267328,533460592
450500,2058677041,81145456,1.0954636559999999e-11,13959589,1268944,534729536
451000,2046715042,81249720,1.0968712199999998e-11,14008539,1266888,535996424
451500,2060241667,81157757,1.0956297195e-11,14359401,1266440,537262864
452000,2051350166,81157040,1.0956200399999999e-11,14336076,1267668,538530532
452500,2057194417,81152711,1.0955615984999998e-11,14195392,1266432,539796964
453000,2036903917,81157025,1.0956198374999999e-11,14335585,1265536,541062500
453500,2052586791,81260509,1.0970168714999999e-11,14359179,1266888,542329388
454000,2053199500,81156973,1.0956191355e-11,14333911,1267236,543596624
454500,2052094167,81157196,1.095622146e-11,14341143,1266888,544863512
455000,2057276084,81158155,1.0956350925e-11,14372318,1266888,546130400
455500,2051872250,81157909,1.0956317714999999e-11,14364341,1266440,547396840
456000,2072865125,81258589,1.0969909515000001e-11,14296802,1266408,548663248
456500,2053974333,81157509,1.0956263714999998e-11,14351308,1266864,549930112
457000,2066350959,81157469,1.0956258315e-11,14350006,1265968,551196080
457500,2153043875,81150047,1.0955256345e-11,14108811,1267212,552463292
458000,2225961958,81251679,1.0968976665e-11,14072207,1266848,553730140
458500,2310312459,81157958,1.0956324329999999e-11,14365915,1266440,554996580
459000,2203491125,81158947,1.0956457845e-11,14398050,1266864,556263444
459500,2062734042,81156777,1.0956164895e-11,14327540,1267336,557530780
460000,2070033625,81248930,1.096860555e-11,13982864,1267312,558798092
460500,2054576916,81151355,1.0955432924999998e-11,14151311,1266440,560064532
461000,2074089333,81157293,1.0956234555e-11,14344317,1267328,561331860
461500,2053890708,81156908,1.0956182579999999e-11,14331785,1267336,562599196
462000,2060470042,81155137,1.0955943494999998e-11,14274221,1267660,563866856
462500,2053731291,81260303,1.0970140904999999e-11,14352491,1267336,565134192
463000,2063826084,81158142,1.0956349169999999e-11,14371913,1266880,566401072
463500,2063328875,81155230,1.095595605e-11,14277271,1265992,567667064
464000,2051010583,81155208,1.0955953079999999e-11,14276527,1267236,568934300
464500,2058374334,81156705,1.0956155175e-11,14325207,1267336,570201636
465000,2058819333,81253710,1.0969250849999998e-11,14138208,1267236,571468872
465500,2055036000,81153544,1.0955728439999998e-11,14222451,1266440,572735312
466000,2209055250,81143458,1.095436683e-11,13894677,1267312,574002624
466500,2300103167,81143069,1.0954314314999999e-11,13882043,1266888,575269512
467000,2399600917,81259646,1.0970052209999998e-11,14331144,1267668,576537180
467500,2317732750,81158364,1.095637914e-11,14379111,1266888,577804068
468000,2229343959,81157901,1.0956316634999999e-11,14364075,1266880,579070948
468500,2068567583,81156444,1.0956119939999998e-11,14316713,1267236,580338184
469000,2051974292,81260251,1.0970133885e-11,14350825,1266440,581604624
469500,2050701916,81156757,1.0956162194999998e-11,14326871,1266880,582871504
470000,2057950834,81160083,1.0956611204999999e-11,14434982,1267676,584139180
470500,2048885875,81158198,1.0956356729999998e-11,14373734,1265636,585404816
471000,2065803750,81154908,1.0955912579999998e-11,14266779,1266856,586671672
471500,2057627583,81257601,1.0969776135e-11,14264689,1266400,587938072
472000,2065456000,81154945,1.0955917575e-11,14267988,1266860,589204932
472500,2058442500,81148874,1.0955097989999998e-11,14070690,1266772,590471704
473000,2053591750,81140127,1.0953917144999998e-11,13786397,1266440,591738144
473500,2074650708,81145664,1.0954664639999998e-11,13966370,1267312,593005456
474000,2052760375,81259387,1.0970017244999998e-11,14322735,1266424,594271880
474500,2051552917,81157044,1.0956200939999998e-11,14336221,1266440,595538320
475000,2057746875,81156659,1.0956148964999998e-11,14323711,1266888,596805208
475500,2144555292,81159864,1.095658164e-11,14427846,1266440,598071648
476000,2229502792,81255232,1.0969456320000001e-11,14187696,1266432,599338080
476500,2373086750,81156690,1.095615315e-11,14324712,1266424,600604504
477000,2146108167,81155927,1.0956050145e-11,14299904,1266396,601870900
477500,2071570417,81157961,1.0956324734999999e-11,14366005,1266872,603137772
478000,2063044166,81259745,1.0970065574999999e-11,14334363,1267692,604405464
478500,2068819375,81152941,1.0955647035e-11,14202857,1265992,605671456
479000,2071290000,81155264,1.095596064e-11,14278369,1266440,606937896
479500,2069378375,81157161,1.0956216734999998e-11,14340028,1266412,608204308
480000,2053981084,81158678,1.0956421529999998e-11,14389330,1265984,609470292
480500,2061978834,81253393,1.0969208054999999e-11,14127930,1270288,610740580
481000,2052512458,81141102,1.095404877e-11,13818106,1266432,612007012
481500,2053446583,81141133,1.0954052954999998e-11,13819109,1265992,613273004
482000,2053283541,81155736,1.0956024359999999e-11,14293702,1268124,614541128
482500,2051608417,81157697,1.0956289094999999e-11,14357448,1266880,615808008
483000,2052637959,81262416,1.0970426159999999e-11,14421167,1266888,617074896
483500,2069018292,81160534,1.095667209e-11,14449645,1266764,618341660
484000,2052595541,81156514,1.0956129389999999e-11,14318989,1265544,619607204
484500,2059329375,81158230,1.095636105e-11,14374763,1266856,620874060
485000,2121759541,81158924,1.095645474e-11,14397299,1266432,622140492
485500,2604048167,81159264,1.0956500639999998e-11,14408367,1266340,623406832
486000,2317893541,81159499,1.0956532365e-11,14415998,1266864,624673696
486500,2190764333,81159149,1.0956485114999998e-11,14404610,1266856,625940552
487000,2059254542,81266518,1.097097993e-11,14554477,1268556,627209108
487500,2053068125,81151735,1.0955484224999998e-11,14163672,1265504,628474612
488000,2051123209,81153455,1.0955716424999998e-11,14219585,1265956,629740568
488500,2065791375,81153427,1.0955712644999999e-11,14218671,1266860,631007428
489000,2051545250,81158769,1.0956433815000001e-11,14392268,1266400,632273828
489500,2062302083,81260634,1.0970185589999998e-11,14363249,1265952,633539780
490000,2052158250,81158566,1.0956406409999998e-11,14385695,1266416,634806196
490500,2049715125,81161122,1.095675147e-11,14468760,1266412,636072608
491000,2047922750,81155743,1.0956025305e-11,14293939,1267644,637340252
491500,2052777334,81156538,1.095613263e-11,14319781,1267336,638607588
492000,2051839333,81260109,1.0970114714999998e-11,14346203,1266888,639874476
492500,2050703167,81156323,1.0956103605e-11,14312766,1267236,641141712
493000,2051830667,81155281,1.0955962934999998e-11,14278907,1266880,642408592
493500,2049713959,81157384,1.0956246839999999e-11,14347266,1267328,643675920
494000,2058810916,81269882,1.097143407e-11,14663800,1266888,644942808
494500,2194452917,81164028,1.095714378e-11,14563183,1266780,646209588
495000,2182574083,81156164,1.0956082139999999e-11,14307616,1267656,647477244
495500,2411106708,81156056,1.095606756e-11,14304110,1266432,648743676
496000,2277053708,81243745,1.0967905574999999e-11,13814354,1266412,650010088
496500,2061865417,81139757,1.0953867195e-11,13774368,1266872,651276960
497000,2074923917,81138840,1.09537434e-11,13744584,1265544,652542504
497500,2074567125,81141293,1.0954074555e-11,13824324,1267692,653810196
498000,2070591333,81140969,1.0954030814999998e-11,13813789,1267328,655077524
498500,2058906708,81243544,1.0967878439999999e-11,13807838,1266888,656344412
499000,2061342667,81141136,1.0954053359999999e-11,13819201,1266756,657611168
499500,2059923500,81139001,1.0953765135e-11,13749809,1265992,658877160
500000,2050887500,81139578,1.095384303e-11,13768563,1265984,660143144
500500,2053832708,81261931,1.0970360684999999e-11,14864778,1267684,661410828
501000,2061045041,81353794,1.0982762189999999e-11,14510699,1267364,662678192
501500,2052043375,81262122,1.097038647e-11,14870995,1266932,663945124
502000,2057914041,81275835,1.0972237725e-11,15316671,1266468,665211592
502500,2053285125,81268147,1.0971199845e-11,15066815,1266892,666478484
503000,2051794083,81369450,1.0984875749999999e-11,15019537,1267380,667745864
503500,2136665000,81269185,1.0971339974999998e-11,15100539,1267828,669013692
504000,2358875084,81269406,1.0971369809999999e-11,15107741,1266940,670280632
504500,2289449459,81269140,1.09713339e-11,15099072,1266484,671547116
505000,2249442208,81374112,1.098550512e-11,15171052,1268168,672815284
505500,2061127125,81271864,1.0971701639999999e-11,15187613,1267360,674082644
506000,2055587125,81269351,1.0971362384999999e-11,15105932,1266492,675349136
506500,2051810209,81269880,1.09714338e-11,15123138,1266932,676616068
507000,2062738458,81258003,1.0969830404999999e-11,14737142,1267744,677883812
507500,2067369916,81359053,1.0983472155e-11,14681619,1268192,679152004
508000,2058765958,81271439,1.0971644264999999e-11,15173805,1267836,680419840
508500,2055391125,81270317,1.0971492794999998e-11,15137327,1266940,681686780
509000,2057503125,81266126,1.097092701e-11,15001134,1267272,682954052
509500,2062691459,81372890,1.0985340149999999e-11,15131339,1267836,684221888
510000,2068238166,81272076,1.097173026e-11,15194512,1267820,685489708
510500,2071031333,81273237,1.0971886994999998e-11,15232227,1266932,686756640
511000,2066237000,81268525,1.0971250875e-11,15079094,1266916,688023556
511500,2052312834,81267668,1.097113518e-11,15051260,1266012,689289568
512000,2056093750,81372380,1.09852713e-11,15114757,1265564,690555132
512500,2327308000,81270229,1.0971480914999998e-11,15134485,1266916,691822048
513000,2110258458,81271043,1.0971590805e-11,15160932,1266468,693088516
513500,2212306583,81269989,1.0971448514999999e-11,15126669,1266460,694354976
514000,2169560875,81373601,1.0985436134999998e-11,15154438,1267364,695622340
514500,2255338333,81271033,1.0971589455e-11,15160602,1267272,696889612
515000,2055834250,81274014,1.097199189e-11,15257498,1267356,698156968
515500,2057861875,81287353,1.0973792655e-11,15691017,1267364,699424332
516000,2066475125,81268713,1.0971276255e-11,15085223,1266908,700691240
516500,2050979000,81368968,1.098481068e-11,15003860,1266484,701957724
517000,2069528792,81269863,1.0971431504999998e-11,15122582,1267828,703225552
517500,2060503375,81282403,1.0973124404999999e-11,15530118,1268168,704493720
518000,2054366625,81285260,1.0973510099999997e-11,15622985,1266892,705760612
518500,2054064333,81285944,1.097360244e-11,15645230,1266916,707027528
519000,2048150666,81386066,1.098711891e-11,15559551,1266492,708294020
519500,2054393541,81284459,1.0973401964999999e-11,15596959,1267388,709561408
520000,2058487208,81285764,1.097357814e-11,15639371,1266468,710827876
520500,2069118875,81284419,1.0973396565e-11,15595642,1266940,712094816
521000,2055916333,81387880,1.0987363799999999e-11,15618507,1267372,713362188
521500,2057287666,81283811,1.0973314485e-11,15575881,1266940,714629128
522000,2209050500,81282215,1.0973099024999998e-11,15524030,1268524,715897652
522500,2333871500,81270193,1.0971476055e-11,15133307,1267380,717165032
523000,2172553000,81369591,1.0984894784999998e-11,15024097,1266492,718431524
523500,2393271208,81268419,1.0971236564999998e-11,15075651,1267372,719698896
524000,2061545875,81279140,1.0972683899999999e-11,15424092,1266932,720965828
524500,2048955042,81285188,1.0973500379999999e-11,15620639,1268160,722233988
525000,2048435709,81284207,1.0973367945e-11,15588749,1266932,723500920
525500,2066412958,81395185,1.0988349974999999e-11,15855904,1267380,724768300
526000,2057628459,81282684,1.0973162339999999e-11,15539264,1266460,726034760
526500,2056180708,81282499,1.0973137365e-11,15533260,1266924,727301684
527000,2049716250,81282960,1.0973199599999999e-11,15548231,1266932,728568616
527500,2051562292,81284584,1.097341884e-11,15601002,1267720,729836336
528000,2052794208,81385682,1.098706707e-11,15547051,1266492,731102828
528500,2053687416,81285593,1.0973555054999999e-11,15633817,1268284,732371112
529000,2060090708,81284465,1.0973402775000001e-11,15597160,1268988,733640100
529500,2061018125,81270560,1.0971525599999999e-11,15145232,1267380,734907480
530000,2038205000,81382943,1.0986697305e-11,15458048,1266940,736174420
530500,2056543541,81287992,1.097387892e-11,15711790,1267720,737442140
531000,2055296833,81286632,1.0973695319999999e-11,15667584,1267356,738709496
531500,2409261125,81285029,1.0973478914999998e-11,15615488,1267352,739976848
532000,2243178000,81285843,1.0973588804999999e-11,15641935,1266916,741243764
532500,2294633541,81388002,1.0987380269999998e-11,15622469,1266484,742510248
533000,2188162250,81286256,1.0973644559999999e-11,15655340,1267796,743778044
533500,2052146417,81287898,1.0973866229999998e-11,15708718,1267812,745045856
534000,2050914917,81288328,1.0973924279999998e-11,15722680,1267812,746313668
534500,2051714500,81388297,1.0987420095e-11,15632050,1266484,747580152
535000,2050176875,81287263,1.0973780504999998e-11,15688069,1267388,748847540
535500,2051949666,81287547,1.0973818844999998e-11,15697299,1266892,750114432
536000,2057218458,81284769,1.0973443814999997e-11,15607020,1267836,751382268
536500,2057436458,81282448,1.0973130479999999e-11,15531605,1266908,752649176
537000,2053458667,81381609,1.0986517214999998e-11,15414701,1267720,753916896
537500,2052973000,81269160,1.0971336599999998e-11,15099731,1267812,755184708
538000,2061730708,81271729,1.0971683414999999e-11,15183233,1267836,756452544
538500,2056009208,81271735,1.0971684224999999e-11,15183422,1267264,757719808
539000,2050162000,81389155,1.0987535924999999e-11,15659944,1266916,758986724
539500,2070215583,81285752,1.097357652e-11,15638988,1266460,760253184
540000,27193847708,198677283,2.6821433204999998e-11,15689159,-137496052,622757132
540500,2038154542,81289785,1.0974120975e-11,15770048,1267828,624024960
541000,2299666417,81282363,1.0973119004999998e-11,15528832,1266940,625291900
541500,2224255125,81411609,1.0990567214999998e-11,15628686,1267776,626559676
542000,2184344917,81284554,1.0973414790000001e-11,15600043,1267264,627826940
542500,2197389333,81281868,1.0973052179999999e-11,15512742,1267372,629094312
543000,11382666958,81432495,1.0993386825e-11,15487363,1266460,630360772
543500,2064234666,81284941,1.0973467034999999e-11,15612616,1267372,631628144
544000,2069819291,81412490,1.099068615e-11,15657350,1267380,632895524
544500,2070711917,81274030,1.097199405e-11,15258004,1268076,634163600
545000,2067726958,81267418,1.0971101429999999e-11,15043130,1267380,635430980
545500,2052320584,81269588,1.097139438e-11,15113646,1266492,636697472
546000,2072110375,81282449,1.0973130615e-11,15531630,1268144,637965616
546500,2053354584,81409101,1.0990228635e-11,15547211,1266916,639232532
547000,2055436333,81284045,1.0973346074999999e-11,15583490,1268276,640500808
547500,2059558167,81282682,1.097316207e-11,15539197,1266916,641767724
548000,2058224333,81284605,1.0973421674999999e-11,15601706,1267836,643035560
548500,2051406625,81284347,1.0973386844999999e-11,15593319,1267804,644303364
549000,2034245375,81410113,1.0990365255e-11,15580081,1266484,645569848
549500,2056053459,81283244,1.0973237939999997e-11,15557480,1266468,646836316
550000,2059644458,81283593,1.0973285054999998e-11,15568797,1267348,648103664
550500,2117363625,81290825,1.0974261375e-11,15803844,1267812,649371476
551000,2340269083,81395229,1.0988355915e-11,15096341,1267828,650639304
551500,2272703916,81277718,1.0972491929999998e-11,15377869,1266940,651906244
552000,2124165083,81282573,1.0973147355e-11,15535657,1266476,653172720
552500,2064936292,81281696,1.097302896e-11,15507144,1267296,654440016
553000,2052091958,81284932,1.0973465819999999e-11,15612329,1267828,655707844
553500,2051807583,81410866,1.099046691e-11,15604547,1266932,656974776
554000,2050532500,81286515,1.0973679524999999e-11,15663778,1268184,658242960
554500,2051158792,81283048,1.097321148e-11,15551102,1266904,659509864
555000,2051177833,81286633,1.0973695455e-11,15667596,1266492,660776356
555500,2047402417,81411319,1.0990528064999998e-11,15619272,1267388,662043744
556000,2058616000,81285052,1.0973482019999998e-11,15616226,1266908,663310652
556500,2053733208,81285683,1.0973567205e-11,15636724,1267356,664578008
557000,2055288209,81285514,1.0973544389999998e-11,15631252,1267364,665845372
557500,2056290708,81280252,1.0972834019999997e-11,15460208,1268168,667113540
558000,2056124833,81396205,1.0988487675000001e-11,15128062,1266900,668380440
558500,2054111167,81269080,1.0971325799999998e-11,15097117,1266908,669647348
559000,2071216250,81274750,1.097209125e-11,15281401,1266916,670914264
559500,2052799583,81290341,1.0974196034999998e-11,15788132,1267812,672182076
560000,2051103542,81274374,1.097204049e-11,15269199,1266916,673448992
560500,2068822375,81416813,1.0991269755e-11,15797850,1267380,674716372
561000,2065565000,81286496,1.0973676959999998e-11,15663138,1267348,675983720
561500,2189720458,81284495,1.0973406825e-11,15598133,1266460,677250180
562000,2227636458,81284570,1.097341695e-11,15600571,1266452,678516632
562500,2335175042,81410896,1.0990470959999999e-11,15605534,1266900,679783532
563000,2203352083,81285279,1.0973512665e-11,15623593,1266900,681050432
563500,2268366416,81287384,1.097379684e-11,15692008,1267804,682318236
564000,2050703416,81285906,1.0973597309999999e-11,15643993,1267388,683585624
564500,2058417708,81412140,1.09906389e-11,15645961,1267364,684852988
565000,2066038167,81285526,1.0973546009999998e-11,15631621,1266468,686119456
565500,2065781000,81287764,1.0973848139999997e-11,15704346,1267356,687386812
566000,2052881916,81276662,1.0972349369999999e-11,15343555,1268184,688654996
566500,2064223417,81265872,1.097089272e-11,14992877,1266916,689921912
567000,2072085459,81394471,1.0988253584999998e-11,15071728,1267372,691189284
567500,2052414791,81270616,1.0971533159999998e-11,15147061,1267812,692457096
568000,2052744958,81283514,1.097327439e-11,15566229,1268600,693725696
568500,2059691875,81287191,1.0973770785e-11,15685731,1268700,694994396
569000,2061713708,81281928,1.0973060279999998e-11,15514680,1266940,696261336
569500,2053159083,81408014,1.0990081889999998e-11,15511860,1266940,697528276
570000,2059840667,81283456,1.0973266559999999e-11,15564373,1266940,698795216
570500,2209150709,81288574,1.0973957489999999e-11,15730687,1267828,700063044
571000,2184460041,81281581,1.0973013434999999e-11,15503418,1266036,701329080
571500,2254055625,81408599,1.0990160865e-11,15530882,1267828,702596908
572000,2213807750,81284352,1.0973387519999999e-11,15593482,1269072,703865980
572500,2129764209,81282614,1.0973152889999998e-11,15537000,1266484,705132464
573000,2063637167,81282255,1.0973104424999998e-11,15525320,1266476,706398940
573500,2073742541,81398374,1.098878049e-11,15198557,1268640,707667580
574000,2080282375,81270161,1.0971471734999997e-11,15132282,1267744,708935324
574500,2066322292,81283060,1.0973213099999999e-11,15551491,1267380,710202704
575000,2062953750,81283240,1.09732374e-11,15557355,1267380,711470084
575500,2052127792,81290354,1.097419779e-11,15788540,1266900,712736984
576000,2063683167,81401128,1.098915228e-11,15288077,1267812,714004796
576500,2054272750,81287745,1.0973845574999998e-11,15703745,1266940,715271736
577000,2058372750,81288620,1.0973963699999998e-11,15732198,1267828,716539564
577500,2072412708,81287569,1.0973821814999998e-11,15698028,1268284,717807848
578000,2053872875,81283634,1.097329059e-11,15570138,1266900,719074748
578500,2057243167,81411841,1.0990598535e-11,15636228,1267796,720342544
579000,2049912167,81284468,1.0973403179999998e-11,15597263,1267808,721610352
579500,2238268125,81285798,1.0973582729999998e-11,15640470,1267828,722878180
580000,2263523916,81287850,1.097385975e-11,15707158,1267796,724145976
580500,2217467458,81413066,1.099076391e-11,15676047,1266908,725412884
581000,2264722167,81283693,1.0973298554999998e-11,15572049,1267836,726680720
581500,2214860708,81278442,1.097258967e-11,15401402,1268192,727948912
582000,2053472958,81280231,1.0972831184999999e-11,15459550,1267736,729216648
582500,2052516250,81396954,1.0988588789999999e-11,15152420,1267352,730484000
583000,2052615083,81269795,1.0971422325e-11,15120362,1266924,731750924
583500,2051013834,81268751,1.0971281384999999e-11,15086448,1267380,733018304
584000,2067618875,81284355,1.0973387924999999e-11,15593577,1267744,734286048
584500,2052408833,81285199,1.0973501864999999e-11,15621013,1266924,735552972
585000,2068683958,81410704,1.099044504e-11,15599290,1267836,736820808
585500,2062115250,81293793,1.0974662054999998e-11,15900306,1269080,738089888
586000,2073103500,81287322,1.0973788469999999e-11,15689993,1266464,739356352
586500,2068681459,81284452,1.0973401019999998e-11,15596735,1266468,740622820
587000,2070183541,81287389,1.0973797515e-11,15692189,1268260,741891080
587500,2052686375,81412710,1.0990715849999999e-11,15664486,1267800,743158880
588000,2065151208,81283923,1.0973329605e-11,15579543,1266908,744425788
588500,2060671250,81283676,1.0973296259999998e-11,15571488,1268168,745693956
589000,2325356666,81269377,1.0971365895e-11,15106784,1267364,746961320
589500,2360368417,81396427,1.0988517645e-11,15135289,1267364,748228684
590000,2236739792,81276582,1.097233857e-11,15340938,1266020,749494704
590500,2092276333,81290153,1.0974170655e-11,15782015,1267364,750762068
591000,2059426333,81283871,1.0973322585e-11,15577835,1267812,752029880
591500,2051400416,81408312,1.099012212e-11,15521542,1266912,753296792
592000,2055722167,81284139,1.0973358764999998e-11,15586564,1267836,754564628
592500,2061278750,81282687,1.0973162744999999e-11,15539355,1266492,755831120
593000,2053162125,81285288,1.0973513879999999e-11,15623914,1267836,757098956
593500,2063137000,81284067,1.0973349044999998e-11,15584211,1267712,758366668
594000,2073082084,81410546,1.0990423709999998e-11,15594147,1266916,759633584
594500,2055426792,81283435,1.0973263725e-11,15563668,1266940,760900524
595000,2050753000,81283206,1.0973232809999999e-11,15556236,1267364,762167888
595500,2051120375,81287965,1.0973875274999999e-11,15710906,1266484,763434372
596000,2052585584,81280155,1.0972820924999998e-11,15457080,1266044,764700416
596500,2051985167,81402847,1.0989384345000001e-11,15343954,1267736,765968152
597000,2051625542,81267663,1.0971134504999999e-11,15051076,1266932,767235084
597500,2050654292,81283058,1.097321283e-11,15551435,1268192,768503276
598000,2051932166,81284608,1.0973422079999999e-11,15601792,1266940,769770216
598500,2059056292,81282750,1.097317125e-11,15541410,1269080,771039296
599000,2123367333,81282878,1.097318853e-11,15545562,1267804,772307100
599500,2685398750,81283486,1.097327061e-11,15565340,1266932,773574032
600000,2418900167,81283944,1.0973332439999999e-11,15580207,1268184,774842216
600500,2210294875,81410375,1.0990400625e-11,15588610,1267388,776109604
601000,2069131041,81283587,1.0973284244999998e-11,15568611,1267364,777376968
601500,2059248500,81279261,1.0972700234999999e-11,15428007,1267712,778644680
602000,2061999500,81279560,1.09727406e-11,15437734,1266916,779911596
602500,2073210334,81281935,1.0973061224999999e-11,15514912,1266940,781178536
603000,2060340083,81399189,1.0988890514999998e-11,15225073,1267728,782446264
603500,2058780625,81268713,1.0971276255e-11,15085223,1268184,783714448
604000,2051759250,81266161,1.0970931734999999e-11,15002271,1266484,784980932
604500,2064442083,81274368,1.097203968e-11,15268980,1266924,786247856
605000,2046822375,81410460,1.0990412099999998e-11,15591367,1266492,787514348
605500,2057591292,81283580,1.0973283299999999e-11,15568392,1266940,788781288
606000,2057946625,81280365,1.0972849275e-11,15463911,1266900,790048188
606500,2054899708,81283454,1.0973266289999999e-11,15564297,1266932,791315120
607000,2050764917,81281226,1.097296551e-11,15491875,1267696,792582816
607500,2058899125,81411093,1.0990497554999998e-11,15611945,1268256,793851072
608000,2061500250,81286900,1.0973731499999999e-11,15676283,1267372,795118444
608500,2167757000,81282742,1.0973170169999998e-11,15541137,1267288,796385732
609000,2395900833,81285158,1.097349633e-11,15619681,1267380,797653112
609500,2214600292,81418980,1.09915623e-11,15868246,1266044,798919156
610000,2384354667,81288594,1.0973960189999999e-11,15731333,1268996,800188152
610500,2053721125,81287352,1.0973792519999998e-11,15690972,1267388,801455540
611000,2054848166,81271584,1.0971663839999998e-11,15178532,1267356,802722896
611500,2053536917,81273515,1.0971924525e-11,15241282,1268192,803991088
612000,2062752792,81412559,1.0990695464999998e-11,15659592,1266940,805258028
612500,2050014875,81286571,1.0973687084999998e-11,15665595,1266044,806524072
613000,2073285208,81285900,1.0973596499999999e-11,15643781,1266476,807790548
613500,2064023833,81288665,1.0973969774999999e-11,15733639,1268608,809059156
614000,2061290833,81413219,1.0990784564999999e-11,15681025,1267836,810326992
614500,2058998084,81287629,1.0973829914999999e-11,15699991,1267380,811594372
615000,2056689875,81286844,1.0973723939999998e-11,15674474,1269080,812863452
615500,2073962916,81288372,1.0973930219999999e-11,15724133,1266492,814129944
616000,2061072583,81287323,1.0973788605e-11,15690026,1266908,815396852
616500,2060683292,81410702,1.0990444769999998e-11,15599220,1266468,816663320
617000,2122491375,81272312,1.0971762119999999e-11,15202188,1268488,817931808
617500,2233042459,81271673,1.0971675854999998e-11,15181405,1267380,819199188
618000,2248826333,81269154,1.097133579e-11,15099537,1266932,820466120
618500,2160517792,81396541,1.0988533035e-11,15138979,1268616,821734736
619000,2257456583,81271812,1.0971694619999999e-11,15185909,1267828,823002564
619500,2073622542,81272836,1.0971832859999998e-11,15219197,1267828,824270392
620000,2070714625,81271174,1.0971608489999999e-11,15165196,1268184,825538576
620500,2071066083,81274638,1.0972076129999999e-11,15277784,1266940,826805516
621000,2072246334,81400835,1.0989112724999998e-11,15278554,1266468,828071984
621500,2064145042,81272118,1.097173593e-11,15195880,1268168,829340152
622000,2065123292,81283813,1.0973314754999998e-11,15575974,1266044,830606196
622500,2050273542,81288167,1.0973902545e-11,15717453,1267800,831873996
623000,2051967000,81413320,1.0990798200000001e-11,15684318,1266940,833140936
623500,2050714000,81287452,1.0973806019999998e-11,15694237,1268168,834409104
624000,2050478417,81287067,1.0973754044999998e-11,15681725,1267348,835676452
624500,2051832250,81288808,1.097398908e-11,15738280,1266940,836943392
625000,2061166292,81290506,1.0974218309999999e-11,15793483,1267820,838211212
625500,2070225708,81414951,1.0991018385e-11,15737332,1268640,839479852
626000,2052344041,81286855,1.0973725424999998e-11,15674813,1266900,840746752
626500,2198912084,81287248,1.0973778479999998e-11,15687612,1268192,842014944
627000,2405132625,81281764,1.0973038139999998e-11,15509353,1269412,843284356
627500,2250687875,81381540,1.09865079e-11,14651459,1266940,844551296
628000,2220811791,81254961,1.0969419735e-11,14638263,1267364,845818660
628500,2060559208,81269111,1.0971329985e-11,15098134,1268184,847086844
629000,2061006250,81265601,1.0970856134999999e-11,14984082,1267380,848354224
629500,2068717125,81275436,1.097218386e-11,15303707,1268168,849622392
630000,2054880667,81396730,1.0988558549999999e-11,15145135,1266044,850888436
630500,2064731208,81277853,1.0972510155e-11,15382246,1267380,852155816
631000,2053141000,81273735,1.0971954225e-11,15248431,1266916,853422732
631500,2069715125,81269972,1.097144622e-11,15126109,1267720,854690452
632000,2052940000,81268720,1.09712772e-11,15085427,1266492,855956944
632500,2054122625,81398886,1.0988849609999999e-11,15215206,1267388,857224332
633000,2065779208,81272110,1.0971734849999998e-11,15195607,1267380,858491712
633500,2054598792,81269716,1.0971411659999999e-11,15117819,1268968,859760680
634000,2050812083,81253976,1.0969286759999999e-11,14606242,1267380,861028060
634500,2052499000,81381016,1.0986437159999999e-11,14634445,1267388,862295448
635000,2055495417,81256598,1.096964073e-11,14691471,1268600,863564048
635500,2283950417,81263975,1.0970636624999999e-11,14931230,1267828,864831876
636000,2286541084,81272190,1.097174565e-11,15198218,1266916,866098792
636500,2277699000,81395961,1.0988454735e-11,15120135,1268176,867366968
637000,2196406083,81269587,1.0971394244999999e-11,15113609,1266932,868633900
637500,2061652667,81271247,1.0971618345e-11,15167556,1267380,869901280
638000,2051977500,81270764,1.0971553139999999e-11,15151869,1266940,871168220
638500,2059911750,81269273,1.0971351854999999e-11,15103410,1267736,872435956
639000,2051485083,81394962,1.0988319869999998e-11,15087691,1267804,873703760
639500,2053752083,81271086,1.0971596609999999e-11,15162333,1266932,874970692
640000,2051258583,81270919,1.0971574065e-11,15156896,1267380,876238072
640500,2051905834,81257377,1.0969745894999999e-11,14716778,1269436,877507508
641000,2052139750,81272712,1.097181612e-11,15215177,1266908,878774416
641500,2052895125,81398246,1.098876321e-11,15194408,1267296,880041712
642000,2051105583,81271529,1.0971656415e-11,15176716,1267388,881309100
642500,2051758084,81273102,1.097186877e-11,15227853,1266912,882576012
643000,2051526666,81274915,1.0972113524999998e-11,15286785,1267836,883843848
643500,2052149333,81398137,1.0988748495e-11,15190847,1268160,885112008
644000,2052942625,81270542,1.097152317e-11,15144642,1267828,886379836
644500,2052074917,81270227,1.0971480644999999e-11,15134397,1267380,887647216
645000,2186746292,81273854,1.0971970289999999e-11,15252278,1267820,888915036
645500,2392232750,81272892,1.0971840419999999e-11,15221009,1268168,890183204
646000,2357582917,81397205,1.0988622675e-11,15160570,1266012,891449216
646500,2160142459,81270136,1.0971468359999998e-11,15131468,1266932,892716148
647000,2163507167,81271493,1.0971651555e-11,15175553,1268988,893985136
647500,2058336833,81285180,1.09734993e-11,15620366,1266932,895252068
648000,2057522042,81410353,1.0990397655e-11,15587902,1266484,896518552
648500,2058067750,81286571,1.0973687084999998e-11,15665583,1266476,897785028
649000,2086144459,81288781,1.0973985435e-11,15737431,1268616,899053644
649500,2051369959,81283211,1.0973233484999998e-11,15556379,1267388,900321032
650000,2055773792,81412109,1.0990634715e-11,15644973,1267360,901588392
650500,2056523000,81288834,1.097399259e-11,15739150,1267388,902855780
651000,2065768875,81286884,1.097372934e-11,15675770,1266916,904122696
651500,2052541541,81284286,1.097337861e-11,15591341,1268640,905391336
652000,2050231334,81282262,1.097310537e-11,15525559,1266932,906658268
652500,2062715792,81411953,1.0990613655e-11,15639905,1267388,907925656
653000,2054622542,81284445,1.0973400075e-11,15596503,1268192,909193848
653500,2056771750,81280010,1.0972801349999999e-11,15452348,1268156,910462004
654000,2052385625,81262563,1.0970446004999998e-11,14885327,1267820,911729824
654500,2436104291,81256587,1.0969639245e-11,14691105,1266484,912996308
655000,2266692833,81381029,1.0986438914999998e-11,14634853,1267296,914263604
655500,2326515208,81265276,1.0970812259999999e-11,14973491,1265688,915529292
656000,2113855833,81272475,1.0971784125e-11,15207466,1267812,916797104
656500,2054689833,81270316,1.0971492659999999e-11,15137303,1267720,918064824
657000,2051571000,81396540,1.0988532899999999e-11,15138954,1266484,919331308
657500,2064116792,81271719,1.0971682065e-11,15182886,1267364,920598672
658000,2055863125,81271194,1.0971611189999999e-11,15165829,1268192,921866864
658500,2049794084,81272018,1.0971722429999998e-11,15192611,1267380,923134244
659000,2072445750,81268360,1.0971228599999999e-11,15073739,1266484,924400728
659500,2052805250,81394675,1.0988281124999998e-11,15078356,1266484,925667212
660000,2074293708,81273519,1.0971925064999998e-11,15241399,1268184,926935396
660500,2052282792,81272617,1.0971803295e-11,15212093,1266584,928201980
661000,2050865416,81272047,1.0971726344999999e-11,15193555,1268600,929470580
661500,2051364625,81400102,1.098901377e-11,15254731,1268192,930738772
662000,2074579916,81285885,1.0973594474999998e-11,15643313,1266932,932005704
662500,2052966500,81287318,1.0973787929999998e-11,15689875,1267372,933273076
663000,2051397208,81288289,1.0973919014999999e-11,15721439,1268632,934541708
663500,33392836209,225636726,3.0460958009999994e-11,15638655,-169347556,765194152
664000,2061092542,81441736,1.099463436e-11,15671240,1267380,766461532
664500,2203460917,81287134,1.0973763089999998e-11,15683892,1267720,767729252
665000,2220945250,81286055,1.0973617424999999e-11,15648828,1267380,768996632
665500,2174335917,81288823,1.0973991105e-11,15738784,1265688,770262320
666000,2328559458,81443041,1.0994810535000001e-11,15713665,1266452,771528772
666500,2059083500,81286267,1.0973646044999998e-11,15655699,1268176,772796948
667000,2067449250,81285914,1.097359839e-11,15644236,1266492,774063440
667500,2070073209,81285950,1.097360325e-11,15645410,1266932,775330372
668000,2079373334,81273102,1.097186877e-11,15227843,1268548,776598920
668500,2063537125,81428593,1.0992860054999999e-11,15244113,1267836,777866756
669000,2053247792,81288104,1.0973894039999998e-11,15715427,1267388,779134144
669500,11073935625,81441837,1.0994647994999999e-11,15674531,1268176,780402320
670000,2065122333,81286053,1.0973617155e-11,15648747,1266940,781669260
670500,2077268959,81285866,1.0973591909999999e-11,15642681,1267388,782936648
671000,2053817292,81444811,1.0995049485e-11,15771186,1268160,784204808
671500,2070238667,81284930,1.0973465549999999e-11,15612250,1266044,785470852
672000,2054421708,81285413,1.0973530755e-11,15627971,1266924,786737776
672500,2053417083,81287829,1.0973856914999998e-11,15706479,1267388,788005164
673000,2066472375,81288537,1.0973952495e-11,15729493,1268168,789273332
673500,2435750375,81440698,1.099449423e-11,15637505,1267828,790541160
674000,2229934583,81286718,1.097370693e-11,15670379,1266484,791807644
674500,2318487375,81281635,1.0973020724999998e-11,15505159,1267728,793075372
675000,2201594459,81273847,1.0971969345e-11,15252056,1266940,794342312
675500,2057012333,81441519,1.0994605064999998e-11,15664203,1267736,795610048
676000,2053209833,81286006,1.0973610809999999e-11,15647227,1269028,796879076
676500,2055256500,81285806,1.0973583810000001e-11,15640716,1267388,798146464
677000,2059468834,81286851,1.0973724884999999e-11,15674684,1267380,799413844
677500,2063857625,81444335,1.0994985224999999e-11,15755709,1267736,800681580
678000,2059381417,81286701,1.0973704635e-11,15669813,1266476,801948056
678500,2053819292,81288887,1.0973999745e-11,15740855,1268276,803216332
679000,2051275709,81288367,1.0973929544999999e-11,15723966,1266036,804482368
679500,2049872042,81287662,1.097383437e-11,15701046,1267296,805749664
680000,2052306459,81441783,1.0994640704999999e-11,15672763,1267380,807017044
680500,2068705083,81289222,1.0974044969999999e-11,15751765,1266044,808283088
681000,2074868458,81289480,1.09740798e-11,15760129,1267720,809550808
681500,2038138084,81269867,1.0971432045e-11,15122723,1268192,810819000
682000,2065552417,81270356,1.097149806e-11,15138623,1268284,812087284
682500,2107450875,81435280,1.09937628e-11,15461439,1266940,813354224
683000,2238494459,81287493,1.0973811555e-11,15695572,1267744,814621968
683500,2331384333,81287382,1.0973796569999999e-11,15691947,1267836,815889804
684000,2229292792,81287411,1.0973800484999999e-11,15692879,1266044,817155848
684500,2332097791,81442895,1.0994790825e-11,15708929,1269080,818424928
685000,2064908334,81282873,1.0973187854999999e-11,15545424,1266916,819691844
685500,2058442916,81286382,1.0973661569999999e-11,15659459,1266916,820958760
686000,2053613917,81282031,1.0973074184999998e-11,15518049,1266916,822225676
686500,2064552333,81286770,1.0973713949999999e-11,15672054,1268192,823493868
687000,2052135042,81445534,1.0995147089999998e-11,15794691,1267372,824761240
687500,2066476417,81293200,1.0974581999999999e-11,15881054,1266840,826028080
688000,2067129833,81288065,1.0973888774999999e-11,15714150,1267388,827295468
688500,2062296875,81288715,1.0973976524999998e-11,15735259,1267296,828562764
689000,2052890292,81442505,1.0994738175e-11,15696253,1266924,829829688
689500,2050385084,81286988,1.097374338e-11,15679157,1266492,831096180
690000,2058571375,81289551,1.0974089385000001e-11,15762452,1268640,832364820
690500,2050823875,81283948,1.0973332979999999e-11,15580346,1266128,833630948
691000,2051216167,81270912,1.0971573119999998e-11,15156676,1266468,834897416
691500,2214091291,81424949,1.0992368114999999e-11,15125658,1268608,836166024
692000,2411708459,81282436,1.0973128859999998e-11,15531198,1267388,837433412
692500,2233680500,81283888,1.0973324879999998e-11,15578379,1266940,838700352
693000,2295955875,81283825,1.0973316375e-11,15576355,1266940,839967292
693500,2237099000,81437823,1.0994106104999999e-11,15544063,1268608,841235900
694000,2059345458,81283928,1.097333028e-11,15579695,1267380,842503280
694500,2060049459,81286740,1.09737099e-11,15671072,1269064,843772344
695000,2054918250,81283138,1.0973223629999997e-11,15554025,1266484,845038828
695500,2064536917,81290046,1.0974156209999998e-11,15778545,1267360,846306188
696000,2061976125,81440971,1.0994531085e-11,15646404,1267804,847573992
696500,2038860750,81283268,1.097324118e-11,15558259,1269852,848843844
697000,2054042791,81270373,1.0971500354999999e-11,15139155,1267364,850111208
697500,2056406500,81270946,1.097157771e-11,15157792,1269040,851380248
698000,2063446458,81426979,1.0992642164999999e-11,15191636,1266932,852647180
698500,2071129375,81272034,1.097172459e-11,15193132,1267388,853914568
699000,2062596458,81271557,1.0971660194999999e-11,15177628,1267736,855182304
699500,2052101375,81270402,1.0971504269999999e-11,15140087,1267380,856449684
700000,2052243375,81269503,1.0971382904999999e-11,15110885,1267364,857717048
700500,2049591333,81423372,1.099215522e-11,15074407,1266044,858983092
701000,2087269375,81270064,1.097145864e-11,15129127,1268284,860251376
701500,2258488084,81268099,1.0971193364999999e-11,15065242,1266900,861518276
702000,2337017125,81272195,1.0971746325e-11,15198369,1267388,862785664
702500,2186201583,81425953,1.0992503655e-11,15158290,1266924,864052588
703000,2320374250,81285023,1.0973478104999998e-11,15615290,1268184,865320772
703500,2055226833,81284667,1.0973430044999998e-11,15603699,1266932,866587704
704000,2053249584,81285080,1.09734858e-11,15617133,1268276,867855980
704500,2038703958,81285727,1.0973573145e-11,15638165,1266476,869122456
705000,2036007833,81440133,1.0994417954999998e-11,15619158,1267380,870389836
705500,2053268167,81290760,1.09742526e-11,15801752,1269536,871659372
706000,2058225916,81284944,1.0973467439999999e-11,15612721,1266940,872926312
706500,2059760250,81284481,1.0973404935e-11,15597680,1266484,874192796
707000,2055778125,81439543,1.0994338304999999e-11,15599968,1266492,875459288
707500,2057507708,81285700,1.09735695e-11,15637287,1268952,876728240
708000,2069509250,81265530,1.0970846549999998e-11,14981769,1266020,877994260
708500,2067923958,81270561,1.0971525735e-11,15145259,1268284,879262544
709000,2070679500,81269862,1.097143137e-11,15122553,1267372,880529916
709500,2052629625,81439025,1.0994268375e-11,15583140,1266492,881796408
710000,2060005167,81284413,1.0973395754999999e-11,15595469,1268192,883064600
710500,2191533000,81284998,1.0973474729999999e-11,15614482,1266492,884331092
711000,2219732625,81283408,1.097326008e-11,15562814,1266492,885597584
711500,2199390125,81439809,1.0994374215e-11,15608633,1266460,886864044
712000,2297641791,81287624,1.097382924e-11,15699817,1266932,888130976
712500,2209576584,81286044,1.0973615939999999e-11,15648478,1268192,889399168
713000,2061041416,81287477,1.0973809394999999e-11,15695046,1267388,890666556
713500,2062563167,81288462,1.0973942369999999e-11,15727055,1269056,891935612
714000,2065505417,81284390,1.0973392649999997e-11,15594696,1266036,893201648
714500,2059471791,81280053,1.0972807155e-11,15453769,1267288,894468936
715000,2050766291,81271853,1.0971700155e-11,15187272,1267388,895736324
715500,2066728291,81285163,1.0973497005e-11,15619832,1267372,897003696
716000,2051152500,81439968,1.099439568e-11,15613776,1266468,898270164
716500,2063784625,81285806,1.0973583810000001e-11,15640743,1267804,899537968
717000,2069850166,81274769,1.0972093815e-11,15282030,1266460,900804428
717500,2065724708,81274791,1.0972096785e-11,15282746,1266916,902071344
718000,2072568584,81288813,1.0973989755e-11,15738460,1266908,903338252
718500,2067074583,81442211,1.0994698485e-11,15686669,1268252,904606504
719000,2058566208,81287043,1.0973750804999999e-11,15680918,1266460,905872964
719500,2061105208,81289002,1.0974015269999998e-11,15744611,1266908,907139872
720000,2245820375,81286226,1.097364051e-11,15654367,1266916,908406788
720500,2151453209,81445295,1.0995114824999999e-11,15786922,1267352,909674140
721000,2236296083,81283278,1.0973242529999999e-11,15558578,1266892,910941032
721500,2365225875,81286724,1.0973707739999999e-11,15670550,1268284,912209316
722000,2074418916,81285430,1.0973533049999998e-11,15628516,1267336,913476652
722500,2054026583,81440500,1.09944675e-11,15631068,1266908,914743560
723000,2071527166,81280003,1.0972800405e-11,15452120,1267720,916011280
723500,2041591459,81273704,1.097195004e-11,15247401,1266460,917277740
724000,2057195834,81285666,1.097356491e-11,15636180,1267364,918545104
724500,2053344250,81272718,1.0971816929999998e-11,15215376,1267388,919812492
725000,2062244375,81421371,1.0991885084999999e-11,15009369,1266460,921078952
725500,2051696125,81273072,1.0971864719999999e-11,15226866,1267388,922346340
726000,2052640542,81283912,1.097332812e-11,15579165,1267364,923613704
726500,2063353375,81283664,1.097329464e-11,15571114,1266916,924880620
727000,2072528958,81440871,1.0994517585e-11,15643132,1266940,926147560
727500,2056643541,81286266,1.097364591e-11,15655675,1267356,927414916
728000,2050179458,81284398,1.097339373e-11,15594966,1266916,928681832
728500,2239013750,81286540,1.0973682899999999e-11,15664605,1267388,929949220
729000,2206348583,81284199,1.0973366865e-11,15588491,1266452,931215672
729500,2348050209,81439979,1.0994397165e-11,15614127,1266892,932482564
730000,2278061708,81285544,1.097354844e-11,15632211,1266908,933749472
730500,2256701666,81287333,1.0973789954999999e-11,15690373,1266916,935016388
731000,2262021958,81284267,1.0973376045000001e-11,15590698,1266036,936282424
731500,2067885959,81431018,1.0993187429999998e-11,15322904,1267744,937550168
732000,2069898000,81273387,1.0971907244999998e-11,15237096,1267388,938817556
732500,2072169125,81285641,1.0973561535e-11,15635378,1268640,940086196
733000,2046395291,81286039,1.0973615265e-11,15648301,1267820,941354016
733500,2051940958,81284338,1.0973385629999999e-11,15593022,1266020,942620036
734000,2056867625,81443026,1.0994808509999999e-11,15713185,1267388,943887424
734500,2059475791,81287072,1.097375472e-11,15681856,1266940,945154364
735000,2052654541,81288086,1.097389161e-11,15714845,1266940,946421304
735500,2051415125,81288948,1.097400798e-11,15742829,1267736,947689040
736000,2063379500,81441916,1.099465866e-11,15677092,1266940,948955980
736500,2067831791,81288176,1.097390376e-11,15717747,1267836,950223816
737000,2060650292,81283517,1.0973274795e-11,15566345,1266848,951490664
737500,2064738209,81289228,1.0974045779999999e-11,15751960,1267808,952758472
738000,2064398875,81288191,1.0973905784999998e-11,15718250,1267380,954025852
738500,2174260125,81430763,1.0993153005e-11,15314637,1268996,955294848
739000,2208537750,81272079,1.0971730665e-11,15194606,1266044,956560892
739500,2306949750,81287188,1.097377038e-11,15685649,1266932,957827824
740000,2124971792,81287908,1.097386758e-11,15709035,1267836,959095660
740500,2186158250,81441967,1.0994665545e-11,15678753,1267296,960362956
741000,2056680083,81286896,1.097373096e-11,15676159,1267356,961630312
741500,2055111917,81285151,1.0973495384999997e-11,15619448,1268284,962898596
742000,2053733125,81286042,1.097361567e-11,15648402,1267708,964166304
742500,2051624375,81283573,1.0973282354999998e-11,15568158,1267388,965433692
743000,2051864375,81439870,1.099438245e-11,15610612,1266940,966700632
743500,2056613625,81286985,1.0973742975e-11,15679061,1268192,967968824
744000,2050688916,81284461,1.0973402234999999e-11,15597034,1266924,969235748
744500,2052080125,81287606,1.0973826809999999e-11,15699219,1267372,970503120
745000,2052474500,81427730,1.099274355e-11,15216052,1268548,971771668
745500,2054361417,81271657,1.0971673694999999e-11,15180883,1266584,973038252
746000,2051808625,81267794,1.0971152189999999e-11,15055354,1267364,974305616
746500,2052255667,81268035,1.0971184725e-11,15063167,1267364,975572980
747000,2052984750,81274961,1.0972119735e-11,15288276,1267804,976840784
747500,2056708542,81439075,1.0994275124999999e-11,15584775,1267388,978108172
748000,2056105958,81283732,1.0973303819999999e-11,15573342,1266900,979375072
748500,2239298417,81285885,1.0973594474999998e-11,15643301,1267812,980642884
749000,2162754167,81282488,1.097313588e-11,15532887,1266900,981909784
749500,2260238417,81439829,1.0994376914999998e-11,15609283,1267364,983177148
750000,2181674792,81283403,1.0973259404999998e-11,15562626,1266896,984444044
750500,2057762875,81285660,1.09735641e-11,15636001,1266908,985710952
751000,2058194292,81267871,1.0971162585e-11,15057835,1268284,986979236
751500,2058044042,81267516,1.0971114659999999e-11,15046298,1266940,988246176
752000,2065598417,81424459,1.0992301965e-11,15109732,1267744,989513920
752500,2055322625,81273022,1.0971857969999998e-11,15225254,1267372,990781292
753000,2071578667,81277942,1.097252217e-11,15385162,1268532,992049824
753500,2054674166,81272292,1.0971759419999999e-11,15201520,1266940,993316764
754000,2058489958,81271102,1.0971598769999998e-11,15162839,1267744,994584508
754500,2078359375,81426482,1.0992575069999999e-11,15175486,1267812,995852320
755000,2051750667,81270592,1.0971529919999999e-11,15146284,1266940,997119260
755500,2051193125,81268263,1.0971215504999999e-11,15070595,1266036,998385296
756000,2052639166,81273726,1.097195301e-11,15248135,1267348,999652644
756500,2051286125,81429347,1.0992961845e-11,15268608,1266908,1000919552
757000,2072494583,81287176,1.0973768759999998e-11,15685266,1267364,1002186916
757500,2365217875,81288603,1.0973961404999998e-11,15731617,1267796,1003454712
758000,2325045334,81288671,1.0973970584999999e-11,15733852,1267812,1004722524
758500,2313796542,81441817,1.0994645295e-11,15673878,1266916,1005989440
759000,2206652208,81286660,1.0973699099999998e-11,15668502,1266468,1007255908
759500,2208825750,81287370,1.097379495e-11,15691546,1267356,1008523264
760000,2068596125,81288212,1.0973908619999999e-11,15718935,1268692,1009791956
760500,2056805416,81287402,1.0973799269999999e-11,15692586,1266468,1011058424
761000,2057317500,81437105,1.0994009174999997e-11,15520749,1267364,1012325788
761500,2073865500,81282823,1.0973181104999998e-11,15543794,1266916,1013592704
762000,2052672958,81284589,1.0973419515e-11,15601183,1267380,1014860084
762500,2052154292,81284361,1.0973388734999999e-11,15593784,1267812,1016127896
763000,2038685208,81284017,1.0973342295e-11,15582593,1267380,1017395276
763500,2064739583,81276056,1.0972267559999999e-11,15323873,1268192,1018663468
764000,2056628708,81267259,1.0971079964999998e-11,15037949,1267364,1019930832
764500,2052335417,81266616,1.097099316e-11,15017050,1266932,1021197764
765000,2051993667,81279268,1.0972701179999998e-11,15428239,1267352,1022465116
765500,2049746584,81434650,1.0993677749999999e-11,15440956,1268640,1023733756
766000,2050566666,81286890,1.097373015e-11,15675957,1267828,1025001584
766500,2051055125,81284814,1.0973449889999999e-11,15608489,1266492,1026268076
767000,2053052083,81286406,1.0973664809999998e-11,15660230,1266924,1027535000
767500,2050890167,81284005,1.0973340674999997e-11,15582193,1268184,1028803184
768000,2052237083,81439885,1.0994384474999998e-11,15611087,1266940,1030070124
768500,2056897000,81285804,1.0973583539999998e-11,15640652,1266484,1031336608
769000,2135452334,81284679,1.0973431665e-11,15604113,1268164,1032604772
769500,2436162959,81283490,1.0973271149999998e-11,15565458,1267324,1033872096
770000,2227469666,81440802,1.099450827e-11,15640904,1267388,1035139484
770500,2315601625,81279114,1.097268039e-11,15423251,1268160,1036407644
771000,2120463667,81270159,1.0971471465e-11,15132202,1266908,1037674552
771500,2057498125,81267143,1.0971064304999999e-11,15034194,1266940,1038941492
772000,2061046125,81271805,1.0971693675e-11,15185701,1268632,1040210124
772500,2058973250,81441533,1.0994606954999999e-11,15664659,1267828,1041477952
773000,2051010542,81286102,1.0973623769999998e-11,15650362,1267828,1042745780
773500,2070725000,81288325,1.0973923874999998e-11,15722605,1269088,1044014868
774000,2053146250,81284717,1.0973436794999999e-11,15605349,1267380,1045282248
774500,2071223417,81440269,1.0994436315e-11,15623574,1266932,1046549180
775000,2052413375,81287209,1.0973773214999999e-11,15686334,1269088,1047818268
775500,2057039791,81289091,1.0974027284999998e-11,15747485,1266128,1049084396
776000,2059657792,81286003,1.0973610404999999e-11,15647140,1266908,1050351304
776500,2058124542,81284042,1.0973345669999999e-11,15583390,1266468,1051617772
777000,2061798459,81440940,1.0994526899999998e-11,15645395,1266908,1052884680
777500,2053138167,81286853,1.0973725154999999e-11,15674767,1267784,1054152464
778000,2171784542,81280888,1.0972919879999998e-11,15480891,1267712,1055420176
778500,2185397541,81272341,1.0971766035e-11,15203134,1266916,1056687092
779000,2207052084,81286949,1.0973738115e-11,15677883,1266908,1057954000
779500,2336357625,81441880,1.0994653799999999e-11,15675944,1267360,1059221360
780000,2315352875,81287675,1.0973836124999999e-11,15701472,1266932,1060488292
780500,2100043709,81285840,1.0973588399999997e-11,15641817,1266908,1061755200
781000,2057512208,81273089,1.0971867014999998e-11,15227444,1267348,1063022548
781500,2049521500,81439360,1.09943136e-11,15594026,1266916,1064289464
782000,2064799167,81283768,1.0973308679999998e-11,15574483,1267380,1065556844
782500,2070179000,81286976,1.0973741759999998e-11,15678747,1267372,1066824216
783000,2053078250,81286332,1.097365482e-11,15657824,1266932,1068091148
783500,2072184375,81441918,1.0994658929999999e-11,15677151,1267720,1069358868
784000,2055780417,81283358,1.097325333e-11,15561156,1267380,1070626248
784500,2052874625,81282700,1.09731645e-11,15539788,1266904,1071893152
785000,2051914208,81285414,1.0973530889999998e-11,15628004,1267380,1073160532
785500,2049017709,81289134,1.0974033089999999e-11,15748905,1266940,1074427472
786000,2051043417,81438978,1.099426203e-11,15581620,1267296,1075694768
786500,2053891833,81292460,1.0974482099999998e-11,15856991,1267820,1076962588
787000,2070612750,81286356,1.0973658059999998e-11,15658611,1266492,1078229080
787500,2095403125,81283762,1.097330787e-11,15574293,1268624,1079497704
788000,2258733917,81284504,1.097340804e-11,15598415,1266484,1080764188
788500,2318852833,81296603,1.0975041404999997e-11,15991643,1267380,1082031568
789000,2328738708,81299405,1.0975419675e-11,16082707,1268192,1083299760
789500,2166795417,81301272,1.0975671719999999e-11,16143383,1267364,1084567124
790000,2094467708,81302958,1.0975899329999999e-11,16198176,1266484,1085833608
790500,2071090125,81455555,1.0996499925e-11,16120362,1266940,1087100548
791000,2072922875,81300692,1.0975593419999999e-11,16124508,1266908,1088367456
791500,2074364792,81301443,1.0975694805e-11,16148927,1267356,1089634812
792000,2059704833,81300610,1.0975582349999998e-11,16121847,1266908,1090901720
792500,2057788875,81455262,1.099646037e-11,16110851,1267812,1092169532
793000,2055354000,81299889,1.0975485015e-11,16098435,1267348,1093436880
793500,2059732250,81293329,1.0974599415e-11,15885231,1267720,1094704600
794000,2062577125,81283172,1.0973228219999999e-11,15555115,1266020,1095970620
794500,2052727084,81287880,1.09738638e-11,15708142,1267812,1097238432
795000,2059574042,81452663,1.0996109505e-11,16026365,1267812,1098506244
795500,2063712709,81304459,1.0976101964999999e-11,16246944,1266916,1099773160
796000,2063251125,81299926,1.097549001e-11,16099645,1266916,1101040076
796500,2209047917,81302796,1.0975877459999998e-11,16192916,1267796,1102307872
797000,2328955584,81299239,1.0975397264999999e-11,16077308,1266460,1103574332
797500,2281538500,81302084,1.097578134e-11,16169746,1267788,1104842120
798000,2210247000,81298725,1.0975327874999997e-11,16060607,1266468,1106108588
798500,2305582459,81302592,1.097584992e-11,16186294,1268244,1107376832
799000,2184932292,81455423,1.0996482104999999e-11,16116071,1266004,1108642836
799500,2062871708,81301687,1.0975727744999998e-11,16156847,1268260,1109911096
800000,2060162292,81299719,1.0975462065e-11,16092887,1266012,1111177108
800500,2058320042,81303217,1.0975934294999998e-11,16206588,1267364,1112444472
801000,2053503250,81302850,1.097588475e-11,16194664,1267804,1113712276
801500,2065600375,81447030,1.099534905e-11,15843312,1268100,1114980376
802000,2054193250,81281741,1.0973035034999998e-11,15508614,1267364,1116247740
802500,2052690375,81291246,1.097431821e-11,15817538,1267356,1117515096
803000,2054500209,81301784,1.0975740839999998e-11,16160031,1268640,1118783736
803500,2057131792,81294946,1.097481771e-11,15937792,1267356,1120051092
804000,2051235000,81453078,1.099616553e-11,16039861,1266468,1121317560
804500,2049465166,81301426,1.097569251e-11,16148387,1266940,1122584500
805000,2052646417,81299217,1.0975394295e-11,16076604,1267836,1123852336
805500,2050773666,81301605,1.0975716675e-11,16154215,1267296,1125119632
806000,2052445459,81454762,1.0996392869999999e-11,16094580,1267364,1126386996
806500,2051275416,81300486,1.097556561e-11,16117828,1266492,1127653488
807000,2103857708,81301428,1.097569278e-11,16148440,1269080,1128922568
807500,2281001375,81301867,1.0975752045000001e-11,16162723,1267388,1130189956
808000,2299629166,81455405,1.0996479674999999e-11,16115486,1267388,1131457344
808500,2252665041,81282181,1.0973094435e-11,15522909,1267636,1132724980
809000,2281196958,81284756,1.0973442059999998e-11,15606617,1266940,1133991920
809500,2079896875,81283594,1.0973285189999999e-11,15568837,1266932,1135258852
810000,2068760375,81294753,1.0974791654999999e-11,15931500,1266484,1136525336
810500,2074042500,81460519,1.0997170064999998e-11,16281702,1267744,1137793080
811000,2072111917,81300909,1.0975622714999998e-11,16131583,1266012,1139059092
811500,2067693084,81298708,1.0975325579999998e-11,16060036,1266932,1140326024
812000,2052219583,81296860,1.0975076099999998e-11,16000000,1269080,1141595104
812500,2062896541,81453757,1.0996257194999999e-11,16061940,1266940,1142862044
813000,2063044833,81299588,1.097544438e-11,16088650,1267388,1144129432
813500,2044943667,81297855,1.0975210424999997e-11,16032317,1267296,1145396728
814000,2053215333,81296323,1.0975003605e-11,15982525,1267796,1146664524
814500,2051812084,81298053,1.0975237154999997e-11,16038774,1266492,1147931016
815000,40852390667,258851688,3.494497787999999e-11,15876318,-208015516,939915500
815500,2181081125,81289166,1.097403741e-11,15749922,1268640,941184140
816000,2369096666,81297542,1.097516817e-11,16022147,1266916,942451056
816500,2164246792,81492093,1.1001432555e-11,16160229,1267744,943718800
817000,2165402500,81300701,1.0975594635e-11,16124821,1267388,944986188
817500,2173515625,81299933,1.0975490954999998e-11,16099856,1267804,946253992
818000,2145331416,81303024,1.097590824e-11,16200326,1267364,947521356
818500,2058748125,81493558,1.1001630329999999e-11,16207844,1269064,948790420
819000,2053893291,81302222,1.0975799969999999e-11,16174251,1267364,950057784
819500,2052317083,81302315,1.0975812525e-11,16177272,1266940,951324724
820000,2070241208,81301669,1.0975725315e-11,16156268,1266932,952591656
820500,2059449250,81494757,1.1001792194999998e-11,16246819,1268624,953860280
821000,2052867958,81287376,1.097379576e-11,15691752,1267356,955127636
821500,2050520959,81287476,1.097380926e-11,15694999,1267736,956395372
822000,2071371542,81300896,1.0975620959999999e-11,16131165,1266932,957662304
822500,2055739667,81299022,1.097536797e-11,16070263,1266452,958928756
823000,2062547625,81492543,1.1001493304999998e-11,16174871,1266924,960195680
823500,2058691833,81304167,1.0976062544999999e-11,16237452,1268164,961463844
824000,2065393042,81301452,1.0975696019999998e-11,16149237,1267364,962731208
824500,2091716583,81302091,1.0975782285e-11,16169987,1266932,963998140
825000,22805426584,81757250,1.103722875e-11,16119131,1267828,965265968
825500,2056665375,81305146,1.097619471e-11,16269277,1268604,966534572
826000,2063646541,81493124,1.1001571739999999e-11,16193757,1267356,967801928
826500,2060181500,81299867,1.0975482045e-11,16097701,1268508,969070436
827000,2055900333,81286428,1.097366778e-11,15660948,1266908,970337344
827500,2055346041,81288085,1.0973891474999999e-11,15714793,1266460,971603804
828000,2055525583,81290603,1.0974231404999998e-11,15796640,1267364,972871168
828500,2053337667,81480644,1.099988694e-11,15788153,1268608,974139776
829000,2063215042,81287405,1.0973799674999999e-11,15692702,1267364,975407140
829500,2052381834,81289885,1.0974134475e-11,15773300,1267364,976674504
830000,2050942666,81287832,1.0973857319999998e-11,15706576,1266940,977941444
830500,2053573541,81289699,1.0974109364999999e-11,15767243,1268168,979209612
831000,2074063333,81478930,1.0999655549999997e-11,15732454,1266468,980476080
831500,2051904375,81286729,1.0973708415e-11,15670739,1267736,981743816
832000,2066543625,81297648,1.097518248e-11,16025582,1266908,983010724
832500,2064612666,81301545,1.0975708574999999e-11,16152252,1268284,984279008
833000,2135280584,81490636,1.1001235859999998e-11,16112905,1267372,985546380
833500,2305218125,81301620,1.09757187e-11,16154687,1269052,986815432
834000,2302343875,81299176,1.097538876e-11,16075264,1266924,988082356
834500,2301675125,81299708,1.097546058e-11,16092550,1266460,989348816
835000,2059400250,81490478,1.100121453e-11,16107746,1266476,990615292
835500,2057610083,81303104,1.0975919039999999e-11,16202909,1266932,991882224
836000,2055710667,81301698,1.097572923e-11,16157208,1266468,993148692
836500,2051113417,81300228,1.0975530779999998e-11,16109429,1268160,994416852
837000,2064055291,81298713,1.0975326255e-11,16060199,1267388,995684240
837500,2056866125,81488177,1.1000903895e-11,16032979,1268192,996952432
838000,2054382000,81283845,1.0973319075e-11,15576994,1266484,998218916
838500,2055345958,81288149,1.0973900114999999e-11,15716884,1268192,999487108
839000,2058868417,81295922,1.097494947e-11,15969488,1266004,1000753112
839500,2056106000,81293098,1.0974568229999998e-11,15877723,1267836,1002020948
840000,2057931167,81495151,1.1001845384999999e-11,16259639,1268608,1003289556
840500,2054527958,81301042,1.0975640669999999e-11,16135915,1266484,1004556040
841000,2071816833,81302856,1.097588556e-11,16194875,1267356,1005823396
841500,2221170334,81298668,1.097532018e-11,16058737,1267260,1007090656
842000,2409439416,81490426,1.100120751e-11,16106060,1267828,1008358484
842500,2088387583,81301414,1.097569089e-11,16147980,1268284,1009626768
843000,2186588291,81302844,1.0975883939999998e-11,16194450,1267828,1010894596
843500,2240138625,81298264,1.097526564e-11,16045614,1267744,1012162340
844000,2205891417,81486986,1.1000743109999998e-11,15994264,1268168,1013430508
844500,2064346291,81283900,1.0973326499999998e-11,15578769,1266468,1014696976
845000,2081335458,81285761,1.0973577735e-11,15639277,1266932,1015963908
845500,2070641375,81289897,1.0974136094999999e-11,15773677,1268192,1017232100
846000,2070293459,81299785,1.0975470975e-11,16095038,1267356,1018499456
846500,2033820625,81488087,1.1000891744999999e-11,16030057,1268192,1019767648
847000,2051634667,81298566,1.0975306409999998e-11,16055424,1267364,1021035012
847500,2051762125,81301086,1.097564661e-11,16137322,1266932,1022301944
848000,2052504750,81299223,1.0975395105e-11,16076777,1266932,1023568876
848500,2051690084,81486414,1.1000665889999998e-11,15975678,1267264,1024836140
849000,2050806458,81298365,1.0975279274999998e-11,16048908,1267808,1026103948
849500,2052759000,81298017,1.0975232294999998e-11,16037583,1267388,1027371336
850000,2054616708,81300148,1.0975519979999998e-11,16106834,1268624,1028639960
850500,2052489625,81296525,1.0975030874999999e-11,15989097,1268612,1029908572
851000,2051681375,81482779,1.1000175165e-11,15857541,1267804,1031176376
851500,2052359000,81300619,1.0975583564999998e-11,16122148,1266012,1032442388
852000,2422113208,81301649,1.0975722615e-11,16155621,1266916,1033709304
852500,2257067959,81300893,1.0975620554999999e-11,16131075,1267836,1034977140
853000,2255738792,81478751,1.0999631385e-11,15726619,1267364,1036244504
853500,2209002125,81291264,1.0974320639999999e-11,15818106,1268244,1037512748
854000,2224361959,81301195,1.0975661325000001e-11,16140880,1266900,1038779648
854500,2055284666,81299717,1.0975461795e-11,16092842,1266908,1040046556
855000,2052596458,81493227,1.1001585644999999e-11,16197113,1266916,1041313472
855500,2055611042,81303332,1.0975949819999998e-11,16210310,1267804,1042581276
856000,2062986292,81298627,1.0975314645e-11,16057401,1266908,1043848184
856500,2061413583,81299119,1.0975381065e-11,16073402,1267744,1045115928
857000,2055497375,81299284,1.097540334e-11,16078774,1267820,1046383748
857500,2048452625,81490496,1.1001216959999999e-11,16108345,1267388,1047651136
858000,2054818208,81298503,1.0975297904999999e-11,16053390,1268988,1048920124
858500,2052204583,81288857,1.0973995694999998e-11,15739883,1266492,1050186616
859000,2052207917,81301081,1.0975645934999998e-11,16137178,1267388,1051454004
859500,2052520666,81299301,1.0975405635e-11,16079322,1268168,1052722172
860000,2051633750,81473398,1.0998908729999998e-11,15552665,1267388,1053989560
860500,2049944625,81285991,1.0973608784999998e-11,15646737,1266568,1055256128
861000,2059644958,81301685,1.0975727475e-11,16156794,1267364,1056523492
861500,2195658208,81296994,1.097509419e-11,16004330,1268140,1057791632
862000,2394742917,81488876,1.1000998259999998e-11,16055703,1266924,1059058556
862500,2224750834,81299667,1.0975455045e-11,16091209,1266476,1060325032
863000,2211653500,81297812,1.0975204619999999e-11,16030915,1268616,1061593648
863500,2324776167,81296605,1.0975041675e-11,15991687,1266940,1062860588
864000,2052174208,81487953,1.1000873654999998e-11,16025704,1267388,1064127976
864500,2064231791,81296164,1.097498214e-11,15977384,1268192,1065396168
865000,2064631208,81294684,1.097478234e-11,15929260,1268640,1066664808
865500,2050965833,81291880,1.0974403799999998e-11,15838154,1267804,1067932612
866000,2053802875,81287237,1.0973776994999998e-11,15687235,1267364,1069199976
866500,2059916458,81472317,1.0998762795e-11,15517524,1267744,1070467720
867000,2059128042,81296981,1.0975092435e-11,16003932,1267364,1071735084
867500,2059334083,81298000,1.0975229999999998e-11,16037037,1266924,1073002008
868000,2057605292,81298860,1.0975346099999999e-11,16065004,1266492,1074268500
868500,2051239917,81299571,1.0975442084999998e-11,16088079,1268192,1075536692
869000,2052592333,81489688,1.1001107879999998e-11,16082085,1267388,1076804080
869500,2051034000,81299179,1.0975389165e-11,16075345,1268632,1078072712
870000,2051499166,81300420,1.0975556699999998e-11,16115692,1267388,1079340100
870500,2052766708,81303262,1.0975940369999999e-11,16208039,1266464,1080606564
871000,2053022167,81300430,1.0975558049999999e-11,16116004,1267364,1081873928
871500,2052308375,81486833,1.1000722455e-11,15989292,1267652,1083141580
872000,2084348417,81282151,1.0973090384999998e-11,15521953,1267836,1084409416
872500,2497291375,81290463,1.0974212504999999e-11,15792086,1266492,1085675908
873000,2291528750,81488378,1.100093103e-11,16039499,1266924,1086942832
873500,2474099416,81299935,1.0975491224999998e-11,16099930,1268176,1088211008
874000,2116121417,81298040,1.09752354e-11,16038354,1266492,1089477500
874500,2058269583,81297335,1.0975140224999999e-11,16015422,1267388,1090744888
875000,2055954750,81298510,1.0975298849999998e-11,16053625,1268184,1092013072
875500,2056597917,81497967,1.1002225544999998e-11,16351162,1266932,1093280004
876000,2053060958,81303558,1.0975980329999999e-11,16217680,1266912,1094546916
876500,2066046709,81299562,1.0975440869999998e-11,16087811,1266460,1095813376
877000,2055765209,81300302,1.097554077e-11,16111838,1266908,1097080284
877500,2064931084,81492779,1.1001525165e-11,16182539,1267388,1098347672
878000,2058327458,81301388,1.0975687379999998e-11,16147143,1267348,1099615020
878500,2050116000,81300847,1.0975614344999999e-11,16129550,1266916,1100881936
879000,2059928250,81298658,1.0975318829999998e-11,16058430,1267696,1102149632
879500,2060189541,81284379,1.0973391164999998e-11,15594346,1266916,1103416548
880000,2055872834,81482691,1.1000163285e-11,15854693,1267348,1104683896
880500,2051320292,81302853,1.0975885155e-11,16194761,1266900,1105950796
881000,2091986208,81294319,1.0974733065e-11,15917408,1267364,1107218160
881500,2162879584,81301481,1.0975699934999999e-11,16150157,1267812,1108485972
882000,2478650500,81491459,1.1001346964999999e-11,16139643,1267356,1109753328
882500,2296029125,81300403,1.0975554405e-11,16115125,1267808,1111021136
883000,2164262834,81300947,1.0975627844999999e-11,16132796,1267812,1112288948
883500,2090048208,81301080,1.0975645799999999e-11,16137128,1267812,1113556760
884000,2059350042,81490602,1.1001231269999998e-11,16111790,1267356,1114824116
884500,2076792917,81301264,1.097567064e-11,16143109,1266908,1116091024
885000,2052408000,81301907,1.0975757444999999e-11,16164013,1267356,1117358380
885500,2049792833,81304324,1.0976083739999999e-11,16242581,1267364,1118625744
886000,2051091125,81301586,1.0975714109999998e-11,16153575,1267812,1119893556
886500,2057804208,81488901,1.1001001635e-11,16056494,1267796,1121161352
887000,2058349500,81300596,1.0975580459999998e-11,16121397,1267356,1122428708
887500,2061429958,81292344,1.0974466439999999e-11,15853235,1268932,1123697640
888000,2078739041,81265575,1.0970852624999999e-11,14983234,1266012,1124963652
888500,2063917375,81267680,1.0971136799999999e-11,15051620,1266904,1126230556
889000,2053509791,81459387,1.0997017244999998e-11,15097306,1267796,1127498352
889500,2051533542,81271137,1.0971603494999999e-11,15163980,1266908,1128765260
890000,2221350792,81286188,1.097363538e-11,15653136,1267356,1130032616
890500,2267989708,81288254,1.097391429e-11,15720299,1267356,1131299972
891000,2261962416,81473385,1.0998906974999999e-11,15552240,1266916,1132566888
891500,2354718250,81281969,1.0973065815e-11,15516036,1266492,1133833380
892000,2379701125,81283191,1.0973230784999998e-11,15555740,1266924,1135100304
892500,2077937334,81284627,1.0973424644999998e-11,15602413,1267364,1136367668
893000,2068819334,81473153,1.0998875654999998e-11,15544689,1266452,1137634120
893500,2057916292,81283606,1.097328681e-11,15569231,1267356,1138901476
894000,2064627834,81284140,1.0973358899999999e-11,15586568,1266900,1140168376
894500,2062940583,81283702,1.0973299769999998e-11,15572359,1266484,1141434860
895000,2051170417,81281356,1.097298306e-11,15496108,1266940,1142701800
895500,2072085250,81477472,1.0999458719999998e-11,15685072,1266468,1143968268
896000,2052159084,81283135,1.0973223225e-11,15553933,1268152,1145236420
896500,2083821792,81275873,1.0972242854999999e-11,15317925,1267356,1146503776
897000,2055177792,81276163,1.0972282004999999e-11,15327338,1266916,1147770692
897500,2056303083,81276863,1.0972376504999999e-11,15350093,1266916,1149037608
898000,2055277000,81466484,1.0997975339999999e-11,15327943,1267364,1150304972
898500,2068686667,81273438,1.097191413e-11,15238757,1267364,1151572336
899000,2074754708,81274227,1.0972020644999999e-11,15264416,1266916,1152839252
899500,2123095042,81274702,1.097208477e-11,15279864,1266916,1154106168
900000,2308314292,81464667,1.0997730045e-11,15268887,1266460,1155372628
900500,2222828875,81271446,1.097164521e-11,15174032,1266020,1156638648
901000,2330793667,81281510,1.0973003849999999e-11,15501125,1266916,1157905564
901500,2248515666,81292380,1.09744713e-11,15854380,1267356,1159172920
902000,2058977916,81490157,1.1001171194999998e-11,16097306,1266924,1160439844
902500,2052437792,81302132,1.097578782e-11,16171343,1268184,1161708028
903000,2056872667,81299809,1.0975474215e-11,16095821,1267380,1162975408
903500,2058770917,81299930,1.0975490549999998e-11,16099754,1267364,1164242772
904000,2056149084,81297665,1.0975184775e-11,16026158,1266020,1165508792
904500,2055871250,81488173,1.1000903355e-11,16032828,1267388,1166776180
905000,2057712667,81297310,1.097513685e-11,16014622,1266904,1168043084
905500,2048975625,81300685,1.0975592474999998e-11,16124300,1266912,1169309996
906000,2061887625,81297766,1.0975198409999999e-11,16029445,1266904,1170576900
906500,2054000375,81299789,1.0975471515e-11,16095195,1267380,1171844280
907000,2072989250,81489391,1.1001067784999999e-11,16072421,1266460,1173110740
907500,2057386375,81298685,1.0975322474999999e-11,16059302,1266484,1174377224
908000,2052264125,81291554,1.0974359789999999e-11,15827545,1268608,1175645832
908500,2050934709,81285264,1.097351064e-11,15623096,1268184,1176914016
909000,2051006167,81479621,1.0999748835e-11,15754915,1266932,1178180948
909500,2050269375,81299101,1.0975378635e-11,16072823,1266908,1179447856
910000,2057401208,81288641,1.0973966535e-11,15732882,1266492,1180714348
910500,2253967000,81303213,1.0975933754999999e-11,16206463,1267364,1181981712
911000,2245889417,81297940,1.09752219e-11,16035100,1267836,1183249548
911500,2209053417,81488341,1.1000926034999998e-11,16038310,1266940,1184516488
912000,2246994166,81299056,1.097537256e-11,16071353,1267836,1185784324
912500,2328174584,81300777,1.0975604894999998e-11,16127302,1266940,1187051264
913000,2066250500,81300663,1.0975589504999999e-11,16123578,1268612,1188319876
913500,2073925750,81488301,1.1000920635e-11,16037001,1266940,1189586816
914000,2071121541,81299649,1.0975452614999999e-11,16090636,1266900,1190853716
914500,2056990291,81298400,1.0975283999999999e-11,16050016,1266940,1192120656
915000,2052959333,81299590,1.097544465e-11,16088705,1267380,1193388036
915500,2061208750,81485657,1.1000563695e-11,15951065,1268640,1194656676
916000,2060260000,81282196,1.0973096459999999e-11,15523395,1267380,1195924056
916500,2054076625,81283559,1.0973280464999998e-11,15567686,1266932,1197190988
917000,2054770834,81283311,1.0973246984999998e-11,15559633,1266940,1198457928
917500,2065300333,81299598,1.0975445729999999e-11,16088965,1268168,1199726096
918000,2053529709,81486364,1.1000659139999999e-11,15974058,1267364,1200993460
918500,2051129083,81298844,1.097534394e-11,16064450,1267820,1202261280
919000,2050125667,81299732,1.0975463819999998e-11,16093327,1267380,1203528660
919500,2336909417,81296810,1.097506935e-11,15998356,1268168,1204796828
920000,2199549125,81294454,1.0974751289999999e-11,15921801,1266460,1206063288
920500,2417903042,81301875,1.0975753125e-11,16162966,1266012,1207329300
921000,2243844666,81297395,1.0975148324999999e-11,16017369,1266908,1208596208
921500,2170030625,81299079,1.0975375664999998e-11,16072100,1267388,1209863596
922000,2069750750,81300137,1.0975518494999999e-11,16106505,1268184,1211131780
922500,2069284667,81484063,1.1000348505e-11,15899285,1268192,1212399972
923000,2063805500,81286040,1.09736154e-11,15648326,1266932,1213666904
923500,2060734875,81297408,1.097515008e-11,16017785,1266492,1214933396
924000,2049815375,81300556,1.097557506e-11,16120124,1267288,1216200684
924500,2057304791,81491978,1.1001417029999999e-11,16156489,1267820,1217468504
925000,2058299042,81300737,1.0975599495e-11,16125996,1267836,1218736340
925500,2050811916,81300950,1.0975628249999999e-11,16132920,1266476,1220002816
926000,2047788833,81299504,1.097543304e-11,16085912,1266900,1221269716
926500,2054440167,81297136,1.0975113359999998e-11,16008958,1266044,1222535760
927000,2054087375,81488992,1.1001013919999999e-11,16059461,1268192,1223803952
927500,2079779875,81299415,1.0975421025e-11,16083030,1267380,1225071332
928000,2044636542,81296516,1.097502966e-11,15988814,1266484,1226337816
928500,2284455333,81298995,1.0975364325e-11,16069357,1267380,1227605196
929000,2562351083,81296907,1.0975082444999999e-11,16001505,1268184,1228873380
929500,2364944791,81480594,1.099988019e-11,15786527,1269976,1230143356
930000,2222451667,81294425,1.0974747375e-11,15920852,1267288,1231410644
930500,2387186000,81307001,1.0976445134999999e-11,16329564,1268692,1232679336
931000,2204876500,81477865,1.0999511774999998e-11,15697826,1267800,1233947136
931500,2066004334,81284221,1.0973369835e-11,15589212,1266460,1235213596
932000,2067240167,81289646,1.0974102209999998e-11,15765534,1266916,1236480512
932500,2065380084,81302128,1.0975787279999999e-11,16171198,1266916,1237747428
933000,2061944250,81302490,1.097583615e-11,16182965,1266912,1239014340
933500,2052861833,81490562,1.100122587e-11,16110480,1266468,1240280808
934000,2064597833,81302752,1.0975871519999998e-11,16191469,1267340,1241548148
934500,2052143958,81300265,1.0975535775e-11,16110642,1266916,1242815064
935000,2053112042,81304532,1.097611182e-11,16249340,1267812,1244082876
935500,2054885875,81302482,1.097583507e-11,16182704,1267364,1245350240
936000,2050016458,81490473,1.1001213855e-11,16107595,1267800,1246618040
936500,2062173792,81301245,1.0975668075e-11,16142512,1266940,1247884980
937000,2051430500,81301695,1.0975728824999998e-11,16157132,1266916,1249151896
937500,2061978833,81296812,1.0975069619999999e-11,15998438,1268184,1250420080
938000,2229974375,81478505,1.0999598174999999e-11,15718619,1267356,1251687436
938500,2268346500,81282061,1.0973078235e-11,15519032,1266908,1252954344
939000,2353337042,81285083,1.0973486205e-11,15617222,1266916,1254221260
939500,2165291625,81284918,1.0973463929999999e-11,15611875,1266900,1255488160
940000,2187375834,81486496,1.1000676959999999e-11,15978350,1267364,1256755524
940500,2062989667,81306116,1.097632566e-11,16300796,1268260,1258023784
941000,2067298416,81298552,1.0975304519999999e-11,16054986,1267796,1259291580
941500,2045040833,81298298,1.097527023e-11,16046714,1268248,1260559828
942000,2040637583,81299788,1.097547138e-11,16095161,1266916,1261826744
942500,2055370750,81489004,1.1001015540000001e-11,16059841,1266468,1263093212
943000,2054087208,81300420,1.0975556699999998e-11,16115703,1267812,1264361024
943500,2054126375,81299935,1.0975491224999998e-11,16099910,1266940,1265627964
944000,2060973083,81299785,1.0975470975e-11,16095044,1267364,1266895328
944500,2057485625,81298785,1.0975335974999999e-11,16062551,1266908,1268162236
945000,2054950292,81488873,1.1000997855e-11,16055582,1267364,1269429600
945500,2050338041,81300273,1.0975536854999999e-11,16110925,1266468,1270696068
946000,2070961625,81289592,1.097409492e-11,15763767,1268624,1271964692
946500,2055365500,81280087,1.0972811745e-11,15454865,1266916,1273231608
947000,2058481375,81477552,1.099946952e-11,15687660,1267812,1274499420
947500,2372235250,81298607,1.0975311945e-11,16056768,1267804,1275767224
948000,2411327333,81296734,1.0975059089999998e-11,15995880,1267356,1277034580
948500,2276159833,81296453,1.0975021154999999e-11,15986762,1266468,1278301048
949000,2314771458,81487597,1.1000825595e-11,16014121,1266916,1279567964
949500,2205401167,81297244,1.0975127940000001e-11,16012462,1267364,1280835328
950000,2060306541,81299568,1.0975441679999998e-11,16088014,1266908,1282102236
950500,2048639375,81303037,1.0975909995e-11,16200737,1266924,1283369160
951000,2089202667,81297883,1.0975214204999999e-11,16033220,1268276,1284637436
951500,2055690416,81487622,1.1000828969999999e-11,16014947,1266940,1285904376
952000,2053787917,81299252,1.0975399019999998e-11,16077725,1267388,1287171764
952500,2049772583,81300009,1.0975501215e-11,16102345,1268152,1288439916
953000,2054311708,81296286,1.0974998609999998e-11,15981340,1266900,1289706816
953500,2051138000,81486635,1.1000695725e-11,15982847,1266484,1290973300
954000,2051791916,81290113,1.0974165254999999e-11,15780707,1267288,1292240588
954500,2054735125,81280879,1.0972918665e-11,15480610,1268260,1293508848
955000,2056339000,81284243,1.0973372804999999e-11,15589927,1266932,1294775780
955500,2051277958,81286422,1.097366697e-11,15660743,1266492,1296042272
956000,2052484417,81476743,1.0999360305e-11,15661367,1266492,1297308764
956500,2054107167,81297970,1.0975225949999999e-11,16036049,1266940,1298575704
957000,2053641209,81299091,1.0975377284999998e-11,16072492,1266932,1299842636
957500,2067492542,81298953,1.0975358655e-11,16067998,1268184,1301110820
958000,2162486125,81297717,1.0975191794999999e-11,16027853,1266044,1302376864
958500,2231710791,81485791,1.1000581785e-11,15955419,1266924,1303643788
959000,2248136333,81297144,1.0975114439999998e-11,16009235,1268592,1304912380
959500,2268675625,81294649,1.0974777614999998e-11,15928120,1267820,1306180200
960000,2107589750,81297608,1.0975177079999999e-11,16024310,1266492,1307446692
960500,2072987875,81494529,1.1001761415e-11,16239424,1267388,1308714080
961000,2051702375,81294093,1.0974702555e-11,15910055,1266908,1309980988
961500,2056095958,81299089,1.0975377015e-11,16072445,1266824,1311247812
962000,2065329083,81290404,1.097420454e-11,15790185,1267364,1312515176
962500,2056595291,81478338,1.099957563e-11,15713219,1267364,1313782540
963000,2073537875,81289781,1.0974120435e-11,15769915,1267348,1315049888
963500,2059506666,81288867,1.0973997044999999e-11,15740203,1266460,1316316348
964000,2065971375,81289364,1.0974064140000001e-11,15756385,1267348,1317583696
964500,2052350083,81290760,1.09742526e-11,15801753,1267356,1318851052
965000,2063994000,81478932,1.099965582e-11,15732496,1266468,1320117520
965500,2054796916,81292882,1.097453907e-11,15870711,1267364,1321384884
966000,2053041792,81298861,1.0975346235e-11,16065020,1266012,1322650896
966500,2056324708,81301516,1.0975704659999997e-11,16151297,1267828,1323918724
967000,2061822791,81303521,1.0975975334999998e-11,16216466,1266924,1325185648
967500,2271190250,81489969,1.1001145814999998e-11,16091219,1266900,1326452548
968000,2442450500,81301140,1.0975653899999999e-11,16139075,1266908,1327719456
968500,2173233792,81299756,1.097546706e-11,16094086,1267364,1328986820
969000,2382478875,81300478,1.097556453e-11,16117582,1267812,1330254632
969500,2284599375,81488728,1.100097828e-11,16050894,1266460,1331521092
970000,2062389041,81300899,1.0975621364999999e-11,16131263,1267364,1332788456
970500,2063524292,81296002,1.0974960269999999e-11,15972087,1269064,1334057520
971000,2057278917,81288668,1.0973970179999999e-11,15733764,1267836,1335325356
971500,2053213541,81301578,1.0975713029999998e-11,16153326,1267380,1336592736
972000,2054145833,81303102,1.097591877e-11,16202844,1267360,1337860096
972500,2051165041,81303382,1.0975956569999999e-11,16211962,1267296,1339127392
973000,2051229834,81297479,1.0975159664999999e-11,16020094,1267372,1340394764
973500,2050982125,81299124,1.0975381739999999e-11,16073575,1266428,1341661192
974000,2054833792,81493768,1.100165868e-11,16214684,1266492,1342927684
974500,2064191292,81302022,1.097577297e-11,16167752,1266492,1344194176
975000,2049075666,81302070,1.097577945e-11,16169316,1267264,1345461440
975500,2055246042,81302857,1.0975885694999997e-11,16194891,1267388,1346728828
976000,2051224250,81298284,1.097526834e-11,16046277,1266012,1347994840
976500,2051654250,81490122,1.100116647e-11,16096174,1267372,1349262212
977000,2053996375,81298033,1.0975234455e-11,16038098,1266940,1350529152
977500,2052927792,81288306,1.0973921309999999e-11,15721986,1268532,1351797684
978000,2062615875,81288840,1.0973993399999999e-11,15739355,1267356,1353065040
978500,2311686209,81302052,1.0975777019999998e-11,16168740,1267388,1354332428
979000,2286540333,81492288,1.100145888e-11,16166574,1267836,1355600264
979500,2173552000,81300560,1.0975575599999999e-11,16120217,1268192,1356868456
980000,2256999708,81298068,1.097523918e-11,16039251,1266484,1358134940
980500,2144249500,81494873,1.1001807854999999e-11,16250605,1267812,1359402752
981000,2113619292,81298694,1.0975323689999998e-11,16059580,1266908,1360669660
981500,2061605917,81298751,1.0975331384999999e-11,16061447,1266924,1361936584
982000,2057763834,81300380,1.09755513e-11,16114386,1267704,1363204288
982500,2068487625,81300431,1.0975558185e-11,16116035,1266932,1364471220
983000,2058875708,81491133,1.1001302954999998e-11,16129055,1267380,1365738600
983500,2055016375,81299767,1.0975468545e-11,16094465,1266932,1367005532
984000,2048798416,81295133,1.0974842955000001e-11,15943847,1268100,1368273632
984500,2055716916,81283957,1.0973334195e-11,15580649,1266940,1369540572
985000,2050289667,81282316,1.0973112659999999e-11,15527315,1267372,1370807944
985500,2051981208,81474275,1.0999027124999999e-11,15581165,1266924,1372074868
986000,2051217792,81297579,1.0975173164999999e-11,16023346,1266916,1373341784
986500,2051335667,81297897,1.0975216094999998e-11,16033676,1266924,1374608708
987000,2062148000,81300443,1.0975559804999998e-11,16116434,1266492,1375875200
987500,2057033875,81300481,1.0975564935e-11,16117671,1267372,1377142572
988000,2055216333,81491360,1.10013336e-11,16136415,1267380,1378409952
988500,2204872125,81299989,1.0975498515e-11,16101691,1267364,1379677316
989000,2123306625,81299100,1.09753785e-11,16072801,1266908,1380944224
989500,2223199333,81299619,1.0975448565e-11,16089651,1266460,1382210684
990000,2211727916,81489454,1.1001076289999999e-11,16074458,1266940,1383477624
990500,2115282083,81299347,1.0975411844999998e-11,16080798,1266044,1384743668
991000,2054943208,81282861,1.0973186235e-11,15545034,1266044,1386009712
991500,2052463583,81285555,1.0973549925e-11,15632564,1266924,1387276636
992000,2074227625,81481212,1.0999963619999999e-11,15806599,1266012,1388542648
992500,2059340084,81296362,1.097500887e-11,15983792,1266816,1389809464
993000,2061106250,81284330,1.097338455e-11,15592763,1266492,1391075956
993500,2054091541,81286990,1.097374365e-11,15679199,1266908,1392342864
994000,2050927000,81288984,1.0974012839999999e-11,15744028,1266940,1393609804
994500,2064769375,81479999,1.0999799865e-11,15767192,1266940,1394876744
995000,2074190792,81289776,1.097411976e-11,15769764,1267836,1396144580
995500,2061056250,81288697,1.0973974094999999e-11,15734699,1266484,1397411064
996000,2057251000,81280465,1.0972862775e-11,15467151,1266940,1398678004
996500,2053531958,81276895,1.0972380824999997e-11,15351107,1266484,1399944488
997000,2067662041,81482920,1.10001942e-11,15862108,1266940,1401211428
997500,2064067000,81295076,1.097483526e-11,15942012,1267728,1402479156
998000,2248519292,81293798,1.0974662729999998e-11,15900469,1266940,1403746096
998500,2124076167,81296847,1.0975074344999999e-11,15999565,1266476,1405012572
999000,2245446208,81487285,1.1000783474999998e-11,16003969,1266484,1406279056
999500,2451863416,81294204,1.097471754e-11,15913677,1267744,1407546800
1000000,2074335583,81294948,1.0974817979999999e-11,15937834,1266932,1408813732
1000500,2073376209,81296943,1.0975087304999998e-11,16002690,1266484,1410080216
1001000,49816462667,299423909,4.0422227715e-11,16104107,-255663032,1154417184
1001500,2055971750,81299348,1.0975411979999999e-11,16080848,1267364,1155684548
1002000,2064385500,81301751,1.0975736384999999e-11,16158951,1267348,1156951896
1002500,2057346125,81296732,1.0975058819999999e-11,15995839,1266916,1158218812
1003000,2063013417,81290424,1.0974207239999998e-11,15790803,1267744,1159486556
1003500,2053612125,81517670,1.1004885449999999e-11,15582113,1268640,1160755196
1004000,2053965750,81282268,1.0973106179999998e-11,15525741,1266924,1162022120
1004500,2079932875,81291046,1.0974291209999999e-11,15811033,1266932,1163289052
1005000,2057694041,81297343,1.0975141304999999e-11,16015692,1266484,1164555536
1005500,2072226750,81301600,1.0975715999999998e-11,16154040,1268600,1165824136
1006000,2062056125,81533963,1.1007085005e-11,16111616,1266452,1167090588
1006500,2057962042,81298289,1.0975269015e-11,16046423,1266908,1168357496
1007000,2075910958,81297005,1.0975095674999999e-11,16004710,1267340,1169624836
1007500,2207410875,81301318,1.0975677929999997e-11,16144865,1267364,1170892200
1008000,2175844416,81532113,1.1006835255e-11,16051492,1266012,1172158212
1008500,2068120792,81300120,1.0975516199999999e-11,16105932,1267808,1173426020
1009000,2115847375,81298381,1.0975281435e-11,16049431,1267356,1174693376
1009500,2361260542,81299125,1.0975381875e-11,16073593,1267796,1175961172
1010000,2052884875,81297483,1.0975160205e-11,16020238,1266908,1177228080
1010500,2063947167,81533180,1.1006979299999997e-11,16086192,1268184,1178496264
1011000,2067200750,81288318,1.097392293e-11,15722380,1267364,1179763628
1011500,2055772542,81298138,1.097524863e-11,16041510,1266484,1181030112
1012000,2072113917,81300071,1.0975509585e-11,16104331,1266908,1182297020
1012500,2050041417,81530800,1.1006657999999999e-11,16008831,1267364,1183564384
1013000,2050681375,81287341,1.0973791034999998e-11,15690611,1267812,1184832196
1013500,2052020667,81292758,1.0974522329999998e-11,15866665,1267356,1186099552
1014000,2053182958,81300469,1.0975563315e-11,16117278,1267828,1187367380
1014500,2051780541,81296786,1.097506611e-11,15997595,1266452,1188633832
1015000,2051537959,81298727,1.0975328145e-11,16060671,1266940,1189900772
1015500,14084998708,81769864,1.1038931639999999e-11,16184207,1267356,1191168128
1016000,2054181250,81299650,1.097545275e-11,16090661,1266484,1192434612
1016500,2037485917,81300360,1.09755486e-11,16113732,1267836,1193702448
1017000,2178083666,81535069,1.1007234314999999e-11,16147557,1268248,1194970696
1017500,2144989583,81299856,1.097548056e-11,16097367,1268168,1196238864
1018000,2373739833,81294342,1.0974736169999999e-11,15918144,1266456,1197505320
1018500,2392366833,81295214,1.097485389e-11,15946494,1268176,1198773496
1019000,2272363916,81528034,1.1006284589999999e-11,15918942,1267828,1200041324
1019500,2308725834,81287841,1.0973858535e-11,15706883,1266932,1201308256
1020000,2070031833,81279963,1.0972795005e-11,15450816,1267264,1202575520
1020500,2073698042,81282311,1.0973111984999999e-11,15527146,1266916,1203842436
1021000,2064396083,81532581,1.1006898434999998e-11,16066715,1266460,1205108896
1021500,2069199625,81300247,1.0975533345e-11,16110052,1266908,1206375804
1022000,2063265250,81300935,1.0975626225e-11,16132421,1267804,1207643608
1022500,2052642500,81299843,1.0975478804999998e-11,16096941,1267804,1208911412
1023000,2062671375,81297036,1.0975099859999999e-11,16005710,1266020,1210177432
1023500,2052946917,81533568,1.1007031679999999e-11,16098798,1267356,1211444788
1024000,2058832875,81296095,1.0974972825000001e-11,15975109,1266468,1212711256
1024500,2053263833,81299452,1.097542602e-11,16084231,1267356,1213978612
1025000,2050516625,81299966,1.0975495409999998e-11,16100921,1266908,1215245520
1025500,2053430583,81303218,1.0975934429999998e-11,16206610,1267360,1216512880
1026000,2076761125,81297252,1.097512902e-11,16012745,1266932,1217779812
1026500,2058539083,81291167,1.0974307544999999e-11,15814946,1268988,1219048800
1027000,2622052125,81266691,1.0971003285e-11,15019503,1266900,1220315700
1027500,2343943250,81269545,1.0971388574999998e-11,15112241,1267364,1221583064
1028000,2287450792,81282705,1.0973165175e-11,15539957,1266916,1222849980
1028500,2298128458,81281726,1.097303301e-11,15508135,1266940,1224116920
1029000,2216068541,81283460,1.09732671e-11,15564476,1266916,1225383836
1029500,2061472709,81286033,1.0973614455e-11,15648125,1267356,1226651192
1030000,2060394541,81283359,1.0973253464999999e-11,15561198,1266908,1227918100
1030500,2057148917,81284236,1.097337186e-11,15589703,1266940,1229185040
1031000,2051436208,81284398,1.097339373e-11,15594960,1267836,1230452876
1031500,2069319916,81282862,1.0973186369999999e-11,15545048,1266484,1231719360
1032000,2053203208,81517858,1.1004910829999998e-11,15588215,1267388,1232986748
1032500,2073207625,81281352,1.0972982519999999e-11,15495959,1267744,1234254492
1033000,2062982875,81282426,1.0973127509999999e-11,15530895,1267388,1235521880
1033500,2071300584,81281490,1.0973001149999998e-11,15500452,1266484,1236788364
1034000,2070133333,81284305,1.0973381175e-11,15591951,1267828,1238056192
1034500,2067508709,81516512,1.1004729119999998e-11,15544451,1268516,1239324708
1035000,2052629916,81285733,1.0973573955e-11,15638346,1266460,1240591168
1035500,2052707541,81303680,1.0975996799999998e-11,16221650,1267372,1241858540
1036000,2430904291,81290559,1.0974225465e-11,15795196,1267348,1243125888
1036500,2352658333,81531640,1.10067714e-11,16036134,1266468,1244392356
1037000,2423096875,81299836,1.0975477859999999e-11,16096693,1266908,1245659264
1037500,2262833417,81301217,1.0975664295e-11,16141584,1267804,1246927068
1038000,2161079709,81297766,1.0975198409999999e-11,16029421,1267348,1248194416
1038500,2096982625,81532111,1.1006834985e-11,16051421,1266468,1249460884
1039000,2052321917,81302046,1.0975776209999998e-11,16168535,1267804,1250728688
1039500,2058596916,81300258,1.097553483e-11,16110435,1267332,1251996020
1040000,2064080333,81301972,1.0975766219999999e-11,16166122,1267356,1253263376
1040500,2065539417,81299536,1.097543736e-11,16086951,1265572,1254528948
1041000,2057378916,81530369,1.1006599815e-11,15994810,1267804,1255796752
1041500,2075056042,81297145,1.0975114574999999e-11,16009244,1266932,1257063684
1042000,2050647917,81304713,1.0976136255e-11,16255202,1267364,1258331048
1042500,2054416208,81304164,1.0976062139999999e-11,16237379,1267728,1259598776
1043000,2050640292,81300030,1.0975504049999998e-11,16103004,1268152,1260866928
1043500,2050665125,81530609,1.1006632215e-11,16002617,1267812,1262134740
1044000,2052331459,81297786,1.0975201109999999e-11,16030075,1266940,1263401680
1044500,2072020209,81298958,1.097535933e-11,16068171,1267388,1264669068
1045000,2051809375,81299970,1.097549595e-11,16101070,1266900,1265935968
1045500,2061316333,81538344,1.1007676439999998e-11,16254020,1266484,1267202452
1046000,2155698500,81284691,1.0973433284999997e-11,15604499,1266456,1268468908
1046500,2395148583,81287095,1.0973757824999999e-11,15682625,1267380,1269736288
1047000,2286931833,81285696,1.0973568959999999e-11,15637175,1267288,1271003576
1047500,2286090333,81518778,1.100503503e-11,15618113,1266932,1272270508
1048000,2117091583,81288000,1.097388e-11,15712021,1267380,1273537888
1048500,2069680959,81286986,1.0973743109999997e-11,15679079,1267388,1274805276
1049000,2064748875,81290052,1.097415702e-11,15778713,1268176,1276073452
1049500,2053926041,81531621,1.1006768835e-11,16035513,1268176,1277341628
1050000,2070064708,81288332,1.097392482e-11,15722819,1266940,1278608568
1050500,2054430458,81282153,1.0973090654999999e-11,15522023,1266932,1279875500
1051000,2069190250,81268641,1.0971266535e-11,15082856,1266452,1281141952
1051500,2051818083,81280299,1.0972840365e-11,15461752,1268596,1282410548
1052000,2059249667,81516013,1.1004661754999999e-11,15528250,1267388,1283677936
1052500,2070815583,81284369,1.0973389814999999e-11,15594027,1266044,1284943980
1053000,2056098125,81284127,1.0973357145e-11,15586148,1266492,1286210472
1053500,2074075250,81284818,1.0973450429999999e-11,15608632,1268612,1287479084
1054000,2068500500,81283712,1.097330112e-11,15572684,1266924,1288746008
1054500,2057790166,81518109,1.1004944714999998e-11,15596385,1266484,1290012492
1055000,2117794958,81283187,1.0973230244999999e-11,15555608,1268168,1291280660
1055500,2324681875,81282749,1.0973171115e-11,15541393,1266136,1292546796
1056000,2425612583,81520483,1.1005265205e-11,15673506,1267348,1293814144
1056500,2214906375,81285592,1.0973554919999998e-11,15633783,1268640,1295082784
1057000,2118041709,81276851,1.0972374884999998e-11,15349679,1267288,1296350072
1057500,2056347875,81272898,1.0971841229999999e-11,15221229,1268284,1297618356
1058000,2051113916,81274134,1.097200809e-11,15261385,1268640,1298886996
1058500,2058578750,81508325,1.1003623874999998e-11,15278381,1266484,1300153480
1059000,2053688833,81278937,1.0972656494999999e-11,15417493,1266924,1301420404
1059500,2050657958,81285624,1.0973559239999999e-11,15634801,1268632,1302689036
1060000,2052764250,81286553,1.0973684655e-11,15665024,1266940,1303955976
1060500,2070765125,81284938,1.0973466629999999e-11,15612527,1267388,1305223364
1061000,2065400584,81519383,1.1005116705e-11,15637781,1266916,1306490280
1061500,2055435959,81280315,1.0972842524999999e-11,15462285,1268176,1307758456
1062000,2070011042,81283661,1.0973294235e-11,15571013,1267388,1309025844
1062500,2052242250,81282115,1.0973085524999999e-11,15520757,1267388,1310293232
1063000,2050819125,81517702,1.1004889769999999e-11,15583151,1269048,1311562280
1063500,2074258125,81275720,1.09722222e-11,15312920,1267736,1312830016
1064000,2079235417,81266865,1.0971026775000001e-11,15025163,1267388,1314097404
1064500,2074043333,81268570,1.0971256949999999e-11,15080553,1268168,1315365572
1065000,2051248583,81266161,1.0970931734999999e-11,15002268,1266492,1316632064
1065500,2060985083,81525168,1.1005897679999999e-11,15825802,1266468,1317898532
1066000,2123658750,81285196,1.0973501459999999e-11,15620894,1266892,1319165424
1066500,2213249333,81284843,1.0973453804999999e-11,15609417,1267744,1320433168
1067000,2465989833,81282928,1.097319528e-11,15547188,1266940,1321700108
1067500,2196285542,81518842,1.100504367e-11,15620184,1267388,1322967496
1068000,2227638625,81283244,1.0973237939999997e-11,15557478,1268632,1324236128
1068500,2237790500,81280356,1.097284806e-11,15463611,1265148,1325501276
1069000,2072414250,81284125,1.0973356874999999e-11,15586114,1266044,1326767320
1069500,2074830959,81518551,1.1005004385e-11,15610734,1267388,1328034708
1070000,2063416667,81283835,1.0973317724999999e-11,15576666,1269408,1329304116
1070500,2066574166,81286188,1.097363538e-11,15653164,1265680,1330569796
1071000,2053594041,81286669,1.0973700314999998e-11,15668777,1267356,1331837152
1071500,2050757541,81299810,1.0975474349999999e-11,16095862,1268140,1333105292
1072000,2059925459,81534576,1.1007167759999999e-11,16131550,1266484,1334371776
1072500,2050816708,81302002,1.097577027e-11,16167094,1266932,1335638708
1073000,2057447084,81299654,1.0975453289999998e-11,16090787,1267712,1336906420
1073500,2071281792,81300134,1.0975518089999998e-11,16106393,1266932,1338173352
1074000,2073269625,81301883,1.0975754205e-11,16163230,1267388,1339440740
1074500,2066135167,81534379,1.1007141164999998e-11,16125141,1268624,1340709364
1075000,2076218416,81298734,1.097532909e-11,16060899,1267380,1341976744
1075500,2084610042,81298875,1.0975348125e-11,16065463,1266940,1343243684
1076000,2176667917,81302476,1.097583426e-11,16182487,1266908,1344510592
1076500,2274384500,81531414,1.1006740889999999e-11,16028784,1268192,1345778784
1077000,2219875458,81295400,1.0974879e-11,15952548,1268192,1347046976
1077500,2300935500,81291427,1.0974342645e-11,15823422,1267836,1348314812
1078000,2227736625,81300358,1.097554833e-11,16113669,1268640,1349583452
1078500,2054761125,81529720,1.1006512199999999e-11,15973725,1266484,1350849936
1079000,2050399625,81299095,1.0975377825e-11,16072628,1267388,1352117324
1079500,2052080583,81300082,1.097551107e-11,16104686,1268192,1353385516
1080000,2049560666,81297494,1.097516169e-11,16020590,1267380,1354652896
1080500,2068486334,81305966,1.0976305409999998e-11,16295941,1266916,1355919812
1081000,2072374167,81536002,1.1007360269999998e-11,16177876,1267348,1357187160
1081500,2054012125,81297676,1.097518626e-11,16026497,1268164,1358455324
1082000,2049829750,81298247,1.0975263345e-11,16045050,1267372,1359722696
1082500,2074665125,81301081,1.0975645934999998e-11,16137167,1267388,1360990084
1083000,2056461250,81303844,1.097601894e-11,16226950,1269508,1362259592
1083500,2074923791,81525917,1.1005998794999998e-11,15850116,1267280,1363526872
1084000,2075888041,81292952,1.097454852e-11,15872960,1266476,1364793348
1084500,2058946250,81297767,1.0975198545e-11,16029458,1267744,1366061092
1085000,2056303542,81290678,1.0974241529999999e-11,15799056,1266940,1367328032
1085500,2058934208,81520288,1.100523888e-11,15667191,1266452,1368594484
1086000,2058794375,81301472,1.0975698719999998e-11,16149880,1266916,1369861400
1086500,2056067208,81300439,1.0975559265e-11,16116307,1267744,1371129144
1087000,2205613000,81298964,1.097536014e-11,16068375,1266492,1372395636
1087500,2246150875,81298085,1.0975241475e-11,16039795,1266492,1373662128
1088000,2281704917,81534829,1.1007201915e-11,16139767,1267836,1374929964
1088500,2232904958,81298798,1.0975337729999998e-11,16062984,1267288,1376197252
1089000,2215366291,81300453,1.0975561155e-11,16116768,1267364,1377464616
1089500,2189793166,81299288,1.0975403879999997e-11,16078878,1266932,1378731548
1090000,2055271833,81528775,1.1006384624999999e-11,15943005,1268548,1380000096
1090500,2053431250,81284398,1.097339373e-11,15594978,1265688,1381265784
1091000,2050722000,81288664,1.097396964e-11,15733617,1267796,1382533580
1091500,2066735875,81281786,1.0973041109999998e-11,15510070,1267288,1383800868
1092000,2052007625,81520001,1.1005200135e-11,15657870,1266940,1385067808
1092500,2065118208,81298543,1.0975303305e-11,16054694,1267380,1386335188
1093000,2051773833,81299699,1.0975459365e-11,16092260,1267720,1387602908
1093500,2057857208,81299732,1.0975463819999998e-11,16093315,1267828,1388870736
1094000,2066098875,81300619,1.0975583564999998e-11,16122162,1267828,1390138564
1094500,2041509000,81530190,1.100657565e-11,15988992,1267736,1391406300
1095000,2057160750,81297988,1.097522838e-11,16036629,1266924,1392673224
1095500,2051429042,81301678,1.0975726529999998e-11,16156577,1267388,1393940612
1096000,2062352917,81298674,1.097532099e-11,16058927,1266468,1395207080
1096500,2236583375,81300258,1.097553483e-11,16110407,1269056,1396476136
1097000,2334870875,81526280,1.1006047799999999e-11,15861913,1267744,1397743880
1097500,2320404459,81282522,1.0973140469999998e-11,15534011,1266492,1399010372
1098000,2311450125,81297612,1.097517762e-11,16024407,1269080,1400279452
1098500,2353662583,81532097,1.1006833094999999e-11,16050976,1267372,1401546824
1099000,2187771333,81299629,1.0975449914999999e-11,16089976,1267388,1402814212
1099500,2059289417,81299667,1.0975455045e-11,16091198,1268608,1404082820
1100000,2059849167,81298077,1.0975240395e-11,16039536,1266924,1405349744
1100500,2074231667,81297059,1.0975102964999999e-11,16006438,1267372,1406617116
1101000,2051532500,81531667,1.1006775044999999e-11,16037010,1267364,1407884480
1101500,2051731375,81298165,1.0975252274999999e-11,16042408,1267812,1409152292
1102000,2060664208,81297561,1.0975170735e-11,16022769,1267364,1410419656
1102500,2050298333,81298373,1.0975280355e-11,16049153,1266940,1411686596
1103000,2051929458,81298445,1.0975290075e-11,16051515,1268252,1412954848
1103500,2052406500,81533989,1.1007088514999998e-11,16112466,1267380,1414222228
1104000,2051168917,81294652,1.0974778019999998e-11,15928242,1268964,1415491192
1104500,2066848542,81282823,1.0973181104999998e-11,15543794,1266916,1416758108
1105000,2071688083,81284944,1.0973467439999999e-11,15612735,1266940,1418025048
1105500,2054631791,81520188,1.100522538e-11,15663931,1267356,1419292404
1106000,2078790042,81289178,1.0974039029999998e-11,15750315,1267820,1420560224
1106500,2285316542,81298176,1.0975253759999999e-11,16042745,1267364,1421827588
1107000,2386050250,81297772,1.097519922e-11,16029630,1266484,1423094072
1107500,2183554167,81532501,1.1006887635e-11,16064109,1267720,1424361792
1108000,2264973125,81298404,1.0975284540000001e-11,16050161,1267348,1425629140
1108500,2890367958,81294884,1.097480934e-11,15935751,1266908,1426896048
1109000,2056962916,81298988,1.0975363379999998e-11,16069161,1267792,1428163840
1109500,2051093334,81529484,1.1006480339999999e-11,15966036,1266940,1429430780
1110000,2052867166,81298014,1.0975231889999998e-11,16037500,1267788,1430698568
1110500,2055049125,81301480,1.0975699799999998e-11,16150135,1266492,1431965060
1111000,2063433208,81296857,1.0975075694999998e-11,15999887,1267388,1433232448
1111500,2058535000,81308964,1.0976710139999998e-11,16393371,1266912,1434499360
1112000,2066139125,81533992,1.1007088919999998e-11,16112564,1268996,1435768356
1112500,2059368542,81291990,1.097441865e-11,15841698,1266940,1437035296
1113000,2051733750,81291847,1.0974399344999999e-11,15837066,1267812,1438303108
1113500,2068458959,81298089,1.0975242014999998e-11,16039923,1267820,1439570928
1114000,2054179417,81299407,1.0975419945e-11,16082775,1268184,1440839112
1114500,2058588959,81527447,1.1006205345e-11,15899862,1266452,1442105564
1115000,2130162750,81295936,1.097495136e-11,15969961,1266916,1443372480
1115500,2252149500,81301082,1.0975646069999999e-11,16137187,1267380,1444639860
1116000,2260075458,81284361,1.0973388734999999e-11,15593784,1266932,1445906792
1116500,2206100792,81518516,1.100499966e-11,15609606,1266492,1447173284
1117000,2233711208,81285758,1.097357733e-11,15639161,1268160,1448441444
1117500,2169041583,81285160,1.0973496599999998e-11,15619750,1267356,1449708800
1118000,2058629542,81287049,1.0973751614999999e-11,15681143,1266932,1450975732
1118500,2055878291,81529199,1.1006441864999998e-11,15956783,1266044,1452241776
1119000,2055418709,81290178,1.097417403e-11,15782806,1268988,1453510764
1119500,2073968792,81285070,1.097348445e-11,15616813,1267380,1454778144
1120000,2056965250,81286633,1.0973695455e-11,15667598,1266484,1456044628
1120500,2066593500,81289117,1.0974030795e-11,15748351,1267388,1457312016
1121000,2039063625,81516005,1.1004660674999999e-11,15527995,1266468,1458578484
1121500,2049785708,81290379,1.0974201165e-11,15789356,1266492,1459844976
1122000,2052054500,81298864,1.097534664e-11,16065129,1267380,1461112356
1122500,2051040250,81299265,1.0975400774999999e-11,16078146,1267736,1462380092
1123000,2049789250,81299704,1.0975460039999999e-11,16092397,1266940,1463647032
1123500,2052072333,81532849,1.1006934614999998e-11,16075428,1267388,1464914420
1124000,2051223833,81297310,1.097513685e-11,16014611,1267720,1466182140
1124500,2051520333,81296906,1.097508231e-11,16001468,1266028,1467448168
1125000,2050709708,81299804,1.0975473539999999e-11,16095656,1267388,1468715556
1125500,2052025500,81300211,1.0975528484999998e-11,16108889,1267828,1469983384
1126000,2052591166,81530899,1.1006671365e-11,16012032,1266900,1471250284
1126500,2059398917,81297859,1.0975210965e-11,16032443,1266908,1472517192
1127000,2130900416,81297824,1.0975206240000001e-11,16031319,1267364,1473784556
1127500,2319606792,81293893,1.0974675554999998e-11,15903569,1268168,1475052724
1128000,2271344333,81517652,1.1004883019999998e-11,15581510,1267356,1476320080
1128500,2171274125,81281831,1.0973047184999999e-11,15511528,1267340,1477587420
1129000,2230570625,81289297,1.0974055095e-11,15754190,1266916,1478854336
1129500,2215992083,81300593,1.0975580054999998e-11,16121309,1267348,1480121684
1130000,2074406000,81522168,1.1005492679999999e-11,15728271,1266020,1481387704
1130500,2048284083,81301535,1.0975707225e-11,16151924,1266468,1482654172
1131000,2050643375,81298702,1.097532477e-11,16059839,1268244,1483922416
1131500,2058716333,81302023,1.0975773105e-11,16167790,1267364,1485189780
1132000,2055992583,81531614,1.1006767889999998e-11,16035284,1266932,1486456712
1132500,2062189958,81299832,1.0975477319999998e-11,16096574,1268260,1487724972
1133000,2075679125,81298397,1.0975283594999999e-11,16049949,1266940,1488991912
1133500,2057224542,81299223,1.0975395105e-11,16076782,1266492,1490258404
1134000,2062566667,81299321,1.0975408335e-11,16079957,1267812,1491526216
1134500,2065022542,81531544,1.100675844e-11,16032992,1267348,1492793564
1135000,2056016792,81298051,1.0975236885e-11,16038699,1266492,1494060056
1135500,2066972125,81300957,1.0975629195e-11,16133154,1267812,1495327868
1136000,2054203041,81291742,1.097438517e-11,15833647,1267744,1496595612
1136500,2166963500,81282524,1.097314074e-11,15534054,1266932,1497862544
1137000,2340715792,81515184,1.1004549839999997e-11,15501296,1267380,1499129924
1137500,2367621875,81282884,1.097318934e-11,15545758,1266492,1500396416
1138000,2228558667,81290779,1.0974255164999999e-11,15802338,1266896,1501663312
1138500,2180355000,81300633,1.0975585454999998e-11,16122625,1266940,1502930252
1139000,2082651458,81299380,1.0975416299999998e-11,16081882,1267264,1504197516
1139500,2064233958,81296603,1.0975041404999997e-11,15991629,1267348,1505464864
1140000,2058138292,81299034,1.097536959e-11,16070644,1267340,1506732204
1140500,2069665833,81302998,1.0975904729999999e-11,16199483,1267388,1507999592
1141000,2065115375,81533084,1.100696634e-11,16083075,1267380,1509266972
1141500,2051188750,81300622,1.0975583969999998e-11,16122254,1266932,1510533904
1142000,2059913708,81301730,1.097573355e-11,16158255,1267712,1511801616
1142500,2051268667,81297799,1.0975202864999998e-11,16030513,1267380,1513068996
1143000,2054595167,81299640,1.0975451399999998e-11,16090337,1266940,1514335936
1143500,2054436625,81525078,1.1005885529999998e-11,15822862,1267736,1515603672
1144000,2071686542,81284910,1.097346285e-11,15611608,1267388,1516871060
1144500,2057149208,81297466,1.097515791e-11,16019679,1267296,1518138356
1145000,2071477959,81298681,1.0975321934999999e-11,16059164,1267788,1519406144
1145500,2592910208,81536163,1.1007382005e-11,16183131,1266916,1520673060
1146000,2393384333,81297320,1.0975138199999999e-11,16014952,1268592,1521941652
1146500,2390962166,81295579,1.0974903165e-11,15958351,1266940,1523208592
1147000,2350990708,81296059,1.0974967965e-11,15973962,1268632,1524477224
1147500,2266244500,81528943,1.1006407305e-11,15948469,1266940,1525744164
1148000,2078408458,81295109,1.0974839714999999e-11,15943094,1267388,1527011552
1148500,2054312375,81295340,1.0974870899999998e-11,15950569,1268192,1528279744
1149000,2068809292,81296966,1.0975090409999998e-11,16003445,1267836,1529547580
1149500,2060402958,81295632,1.097491032e-11,15960071,1267388,1530814968
1150000,2053266042,81501871,1.1002752584999999e-11,15068634,1269800,1532084768
1150500,2070413209,81292383,1.0974471705e-11,15854478,1266044,1533350812
1151000,2055178875,81267204,1.097107254e-11,15036172,1266484,1534617296
1151500,2072894333,81267518,1.0971114929999998e-11,15046362,1266940,1535884236
1152000,2056694958,81503649,1.1002992614999998e-11,15126433,1268184,1537152420
1152500,2057199958,81283560,1.0973280599999999e-11,15567755,1267380,1538419800
1153000,2063227292,81285673,1.0973565854999999e-11,15636399,1267372,1539687172
1153500,2060917416,81287671,1.0973835585e-11,15701355,1267388,1540954560
1154000,2050675917,81283666,1.0973294909999999e-11,15571193,1267716,1542222276
1154500,2060184958,81520364,1.100524914e-11,15669639,1266940,1543489216
1155000,2143422500,81286091,1.0973622284999998e-11,15649995,1266916,1544756132
1155500,2261453875,81287307,1.0973786444999999e-11,15689513,1267288,1546023420
1156000,2236479666,81285544,1.097354844e-11,15632233,1266908,1547290328
1156500,2275203333,81519759,1.1005167465e-11,15649995,1269056,1548559384
1157000,2175944166,81269867,1.0971432045e-11,15122696,1266916,1549826300
1157500,2086743708,81270133,1.0971467954999998e-11,15131368,1266452,1551092752
1158000,2064718500,81282404,1.097312454e-11,15530172,1267812,1552360564
1158500,2056213791,81520398,1.100525373e-11,15670756,1266900,1553627464
1159000,2064259667,81287018,1.097374743e-11,15680133,1267356,1554894820
1159500,2050551917,81287593,1.0973825055e-11,15698796,1268260,1556163080
1160000,2061441208,81286666,1.0973699909999998e-11,15668694,1266020,1557429100
1160500,2056856834,81286914,1.0973733389999999e-11,15676742,1266004,1558695104
1161000,2066714541,81517782,1.100490057e-11,15585727,1266900,1559962004
1161500,2052654667,81283200,1.0973231999999998e-11,15556053,1267372,1561229376
1162000,2051495791,81283258,1.0973239829999999e-11,15557914,1267356,1562496732
1162500,2051712166,81284013,1.0973341755e-11,15582458,1268276,1563765008
1163000,2053625166,81284895,1.0973460824999999e-11,15611117,1266492,1565031500
1163500,2050232667,81520004,1.100520054e-11,15657970,1268268,1566299768
1164000,2244107417,81287011,1.0973746484999999e-11,15679893,1268608,1567568376
1164500,2332501292,81278186,1.0972555109999998e-11,15393082,1268640,1568837016
1165000,2189905000,81268018,1.0971182429999999e-11,15062609,1266492,1570103508
1165500,2221946166,81510048,1.1003856479999998e-11,15334380,1266908,1571370416
1166000,2246463750,81285352,1.0973522519999997e-11,15625986,1266916,1572637332
1166500,2198612583,81285812,1.0973584619999998e-11,15640909,1266484,1573903816
1167000,2082831000,81284719,1.0973437064999998e-11,15605398,1266916,1575170732
1167500,2052186375,81518504,1.100499804e-11,15609204,1268640,1576439372
1168000,2055582625,81284535,1.0973412224999998e-11,15599420,1266932,1577706304
1168500,2053434917,81286479,1.0973674664999998e-11,15662596,1266932,1578973236
1169000,2059679125,81286263,1.0973645505e-11,15655585,1266932,1580240168
1169500,2059853042,81285386,1.0973527109999999e-11,15627070,1266036,1581506204
1170000,2054496708,81521058,1.100534283e-11,15692209,1267296,1582773500
1170500,2053492625,81286204,1.097363754e-11,15653651,1266492,1584039992
1171000,2049852292,81284289,1.0973379015e-11,15591441,1267348,1585307340
1171500,2051637958,81284522,1.0973410469999999e-11,15599002,1266916,1586574256
1172000,2050228042,81283124,1.0973221739999998e-11,15553565,1269056,1587843312
1172500,2051104375,81505090,1.100318715e-11,15173258,1266900,1589110212
1173000,2061823792,81270485,1.0971515474999999e-11,15142802,1267344,1590377556
1173500,2061554458,81270140,1.0971468899999998e-11,15131589,1266908,1591644464
1174000,2055387208,81273025,1.0971858374999998e-11,15225353,1266908,1592911372
1174500,2053439375,81286307,1.0973651445e-11,15657019,1267356,1594178728
1175000,2055134584,81520596,1.100528046e-11,15677208,1267804,1595446532
1175500,2106219250,81287128,1.0973762279999998e-11,15683709,1266916,1596713448
1176000,2378622666,81285205,1.0973502674999999e-11,15621213,1266908,1597980356
1176500,2248008125,81286151,1.0973630385e-11,15651940,1267804,1599248160
1177000,2325762292,81519764,1.1005168139999999e-11,15650171,1267364,1600515524
1177500,2154741875,81287190,1.0973770649999999e-11,15685703,1266492,1601782016
1178000,2237841417,81285420,1.0973531699999999e-11,15628176,1266940,1603048956
1178500,2051820584,81520072,1.1005209719999998e-11,15660152,1267788,1604316744
1179000,2051915750,81284631,1.0973425184999999e-11,15602529,1266012,1605582756
1179500,2058079625,81287077,1.0973755395e-11,15682053,1267356,1606850112
1180000,2052667834,81287581,1.0973823435e-11,15698412,1267796,1608117908
1180500,2065699875,81298577,1.0975307894999998e-11,16055801,1267716,1609385624
1181000,2055705709,81522058,1.1005477829999999e-11,15724714,1267804,1610653428
1181500,2057880041,81288652,1.097396802e-11,15733222,1266916,1611920344
1182000,2055965333,81290007,1.0974150944999999e-11,15777247,1266932,1613187276
1182500,2061730417,81289044,1.0974020939999999e-11,15745958,1267372,1614454648
1183000,2072545292,81289438,1.0974074129999999e-11,15758783,1267388,1615722036
1183500,2054141791,81522850,1.1005584749999998e-11,15750451,1267288,1616989324
1184000,2057857875,81287184,1.0973769839999997e-11,15685527,1266916,1618256240
1184500,2062063334,81289716,1.0974111659999999e-11,15767788,1267812,1619524052
1185000,2093552542,81287566,1.0973821409999997e-11,15697916,1267796,1620791848
1185500,2402823500,81293248,1.097458848e-11,15882587,1266940,1622058788
1186000,2217103125,81284835,1.0973452724999999e-11,15609169,1267372,1623326160
1186500,2178333000,81291703,1.0974379905e-11,15832382,1267836,1624593996
1187000,2239390792,81300724,1.0975597739999998e-11,16125571,1266476,1625860472
1187500,2213215083,81535504,1.100729304e-11,16161708,1268160,1627128632
1188000,2053501334,81299199,1.0975391864999998e-11,16075990,1267372,1628396004
1188500,2068414791,81301484,1.0975700339999999e-11,16150274,1266932,1629662936
1189000,2069433000,81301204,1.0975662539999998e-11,16141156,1266492,1630929428
1189500,2052740750,81299952,1.0975493519999998e-11,16100487,1267736,1632197164
1190000,2069046542,81535805,1.1007333674999999e-11,16171486,1267356,1633464520
1190500,2051702959,81302820,1.0975880699999999e-11,16193682,1267836,1634732356
1191000,2073823125,81297595,1.0975175325e-11,16023876,1266940,1635999296
1191500,2082237959,81298909,1.0975352714999998e-11,16066589,1267380,1637266676
1192000,2080299875,81298636,1.0975315859999999e-11,16057687,1268940,1638535616
1192500,2053851416,81515913,1.1004648254999999e-11,15525015,1267372,1639802988
1193000,2055397750,81283107,1.0973219445e-11,15552997,1267380,1641070368
1193500,2052914416,81300673,1.0975590855e-11,16123910,1267280,1642337648
1194000,2069143834,81300327,1.0975544144999999e-11,16112662,1267372,1643605020
1194500,2072171708,81299310,1.097540685e-11,16079602,1267812,1644872832
1195000,2055103417,81534464,1.1007152639999999e-11,16127906,1267728,1646140560
1195500,2050448666,81305420,1.0976231699999998e-11,16278200,1267812,1647408372
1196000,2157988167,81299197,1.0975391595e-11,16075950,1267356,1648675728
1196500,89833044167,343219972,4.633469622e-11,16053233,-268794848,1379880880
1197000,2058176042,81299086,1.0975376609999999e-11,16072325,1267836,1381148716
1197500,2061894250,81297020,1.09750977e-11,16005179,1267388,1382416104
1198000,2057986500,81574845,1.1012604075e-11,16068082,1268156,1383684260
1198500,2062163792,81292084,1.097443134e-11,15844776,1267736,1384951996
1199000,2051294084,81283937,1.0973331495e-11,15580002,1268284,1386220280
1199500,2056954917,81286791,1.0973716784999998e-11,15672733,1267720,1387488000
1200000,2056522458,81569532,1.1011886819999999e-11,15895386,1267356,1388755356
1200500,2052312167,81283924,1.097332974e-11,15579546,1265240,1390020596
1201000,2079273750,81299481,1.0975429934999998e-11,16085163,1266916,1391287512
1201500,2107540375,81294680,1.09747818e-11,15929116,1266484,1392553996
1202000,2092930792,81296232,1.0974991319999999e-11,15979589,1267744,1393821740
1202500,2187086292,81573803,1.1012463405e-11,16034224,1266940,1395088680
1203000,2070367833,81298706,1.0975325309999998e-11,16059995,1267380,1396356060
1203500,2094506541,81297789,1.0975201514999999e-11,16030169,1267736,1397623796
1204000,2166760792,81297504,1.0975163039999999e-11,16020933,1268276,1398892072
1204500,2052133417,81571768,1.1012188679999998e-11,15968070,1266924,1400158996
1205000,2051496958,81295463,1.0974887504999999e-11,15954566,1267680,1401426676
1205500,2071745334,81297304,1.097513604e-11,16014397,1268156,1402694832
1206000,2064186792,81288580,1.09739583e-11,15730886,1269056,1403963888
1206500,2052301542,81293569,1.0974631815e-11,15893045,1267804,1405231692
1207000,2056073958,81576405,1.1012814674999998e-11,16118766,1266932,1406498624
1207500,2058932583,81299859,1.0975480965e-11,16097451,1267388,1407766012
1208000,2071068000,81301500,1.0975702499999998e-11,16150794,1267388,1409033400
1208500,2059400375,81300163,1.0975522005e-11,16107316,1267704,1410301104
1209000,2059133667,81298070,1.0975239449999999e-11,16039311,1266912,1411568016
1209500,2048453417,81576508,1.101282858e-11,16122130,1267388,1412835404
1210000,2056133083,81300844,1.0975613939999997e-11,16129466,1268284,1414103688
1210500,2058155291,81302853,1.0975885155e-11,16194754,1268640,1415372328
1211000,2294122083,81301314,1.097567739e-11,16144744,1266908,1416639236
1211500,2593629458,81575527,1.1012696144999998e-11,16090248,1267736,1417906972
1212000,2203926709,81292999,1.0974554864999999e-11,15874503,1267744,1419174716
1212500,2128060500,81289895,1.0974135824999999e-11,15773615,1267364,1420442080
1213000,2182539333,81301306,1.097567631e-11,16144490,1267828,1421709908
1213500,2063517166,81575202,1.101265227e-11,16079684,1268160,1422978068
1214000,2077023083,81300498,1.097556723e-11,16118214,1266916,1424244984
1214500,2068395542,81299774,1.0975469489999998e-11,16094698,1266492,1425511476
1215000,2061132083,81301775,1.0975739625000001e-11,16159709,1267372,1426778848
1215500,2046377708,81305652,1.097626302e-11,16285724,1267728,1428046576
1216000,2040112500,81578191,1.1013055785e-11,16176807,1267804,1429314380
1216500,2052207375,81299104,1.0975379039999997e-11,16072934,1267744,1430582124
1217000,2051607083,81301875,1.0975753125e-11,16162983,1268284,1431850408
1217500,2052436708,81300722,1.0975597469999998e-11,16125508,1266484,1433116892
1218000,2066255709,81298584,1.0975308839999999e-11,16056024,1268640,1434385532
1218500,2058226667,81570288,1.1011988879999998e-11,15919964,1267728,1435653260
1219000,2054875083,81293335,1.0974600224999997e-11,15885424,1266492,1436919752
1219500,2063977834,81303193,1.0975931054999999e-11,16205802,1268616,1438188368
1220000,2199970250,81296109,1.0974974715e-11,15975578,1267388,1439455756
1220500,2418215084,81565346,1.101132171e-11,15759370,1267828,1440723584
1221000,2300659167,81302845,1.0975884075e-11,16194491,1268252,1441991836
1221500,2109173458,81298472,1.0975293719999999e-11,16052359,1266840,1443258676
1222000,2262505375,81298108,1.097524458e-11,16040558,1266044,1444524720
1222500,2161456042,81577727,1.1012993144999999e-11,16161736,1267388,1445792108
1223000,2053119583,81298247,1.0975263345e-11,16045056,1266940,1447059048
1223500,2070721292,81300255,1.0975534425e-11,16110320,1268168,1448327216
1224000,2047141000,81297471,1.0975158585e-11,16019848,1267388,1449594604
1224500,2042200208,81573667,1.1012445044999997e-11,16029804,1266044,1450860648
1225000,2054549917,81299368,1.0975414679999999e-11,16081486,1266940,1452127588
1225500,2056368542,81291202,1.0974312269999998e-11,15816089,1267736,1453395324
1226000,2053291958,81287540,1.0973817899999999e-11,15697096,1267348,1454662672
1226500,2051039583,81285229,1.0973505915000001e-11,15621986,1268612,1455931284
1227000,2050670708,81565616,1.101135816e-11,15768139,1267380,1457198664
1227500,2049791875,81300980,1.09756323e-11,16133870,1267380,1458466044
1228000,2068499125,81301282,1.0975673069999998e-11,16143713,1268160,1459734204
1228500,2056930083,81300054,1.097550729e-11,16103784,1267352,1461001556
1229000,2057193625,81299537,1.0975437494999999e-11,16086996,1267828,1462269384
1229500,2139622625,81577313,1.1012937255e-11,16148277,1268616,1463538000
1230000,2401884333,81295318,1.0974867929999998e-11,15949884,1266468,1464804468
1230500,2244805250,81300316,1.0975542659999999e-11,16112304,1266492,1466070960
1231000,2145868833,81305031,1.0976179184999999e-11,16265549,1267356,1467338316
1231500,2238646417,81575008,1.1012626079999997e-11,16073381,1268176,1468606492
1232000,2058822375,81291792,1.097439192e-11,15835272,1267736,1469874228
1232500,2058492666,81284531,1.0973411685e-11,15599289,1267380,1471141608
1233000,2054444375,81295192,1.0974850919999999e-11,15945793,1266932,1472408540
1233500,2059454750,81579602,1.1013246269999999e-11,16222687,1268192,1473676732
1234000,2061806000,81298588,1.097530938e-11,16056132,1267380,1474944112
1234500,2067066709,81302787,1.0975876245e-11,16192619,1267836,1476211948
1235000,2057580792,81300689,1.0975593014999999e-11,16124423,1267388,1477479336
1235500,2061163000,81304143,1.0976059304999999e-11,16236693,1268176,1478747512
1236000,2059852291,81577444,1.101295494e-11,16152530,1266908,1480014420
1236500,2060625625,81299067,1.0975374044999999e-11,16071713,1266492,1481280912
1237000,2056183208,81298988,1.0975363379999998e-11,16069165,1267744,1482548656
1237500,2053034459,81300034,1.0975504589999999e-11,16103143,1266484,1483815140
1238000,2066226417,81300489,1.0975566015e-11,16117945,1267828,1485082968
1238500,2053467083,81572804,1.101232854e-11,16001747,1268532,1486351500
1239000,2054234625,81278912,1.097265312e-11,15416663,1266916,1487618416
1239500,2074144042,81291425,1.0974342374999999e-11,15823364,1268240,1488886656
1240000,2066508792,81299035,1.0975369724999999e-11,16070672,1266940,1490153596
1240500,2089404125,81577686,1.1012987609999998e-11,16160404,1268192,1491421788
1241000,2134578500,81299825,1.0975476374999999e-11,16096356,1266452,1492688240
1241500,2212767875,81298710,1.097532585e-11,16060119,1267836,1493956076
1242000,2253438500,81295739,1.0974924764999998e-11,15963549,1267296,1495223372
1242500,2319811792,81570665,1.1012039774999998e-11,15932227,1266036,1496489408
1243000,2370989209,81298473,1.0975293855e-11,16052424,1266932,1497756340
1243500,2052015208,81300427,1.0975557644999999e-11,16115897,1267836,1499024176
1244000,2051370958,81298656,1.0975318559999999e-11,16058346,1268184,1500292360
1244500,2057056125,81575107,1.1012639445e-11,16076579,1267380,1501559740
1245000,2066916125,81300016,1.0975502159999998e-11,16102549,1266940,1502826680
1245500,2051487583,81289276,1.0974052259999998e-11,15753492,1269860,1504096540
1246000,2063468500,81282089,1.0973082015e-11,15519944,1266468,1505363008
1246500,2052894750,81284687,1.0973432745e-11,15604364,1268168,1506631176
1247000,2047981500,81572141,1.1012239035e-11,15980182,1266044,1507897220
1247500,2052896750,81297444,1.0975154939999999e-11,16018952,1266908,1509164128
1248000,2051549333,81299954,1.097549379e-11,16100531,1267380,1510431508
1248500,2051231208,81299146,1.0975384709999998e-11,16074272,1268192,1511699700
1249000,17681705625,81879228,1.1053695779999998e-11,16097443,1266916,1512966616
1249500,2064741959,81300580,1.0975578299999999e-11,16120898,1267372,1514233988
1250000,2065918709,81300260,1.09755351e-11,16110495,1266492,1515500480
1250500,2065975042,81297700,1.0975189499999999e-11,16027271,1268160,1516768640
1251000,2586932958,81563460,1.10110671e-11,15698066,1266940,1518035580
1251500,2096573458,81296703,1.0975054905e-11,15994882,1267828,1519303408
1252000,2250724750,81300424,1.0975557239999998e-11,16115831,1267272,1520570680
1252500,2448222833,81564630,1.1011225049999999e-11,15736096,1266884,1521837564
1253000,2244849292,81291978,1.0974417029999998e-11,15841320,1266484,1523104048
1253500,2053318250,81291681,1.0974376935e-11,15831667,1266916,1524370964
1254000,2073775125,81292144,1.097443944e-11,15846707,1267836,1525638800
1254500,2064082334,81293018,1.0974557429999998e-11,15875118,1267388,1526906188
1255000,2050833542,81565159,1.1011296465e-11,15753286,1266940,1528173128
1255500,2069084541,81293056,1.0974562559999997e-11,15876351,1267812,1529440940
1256000,2061158375,81284564,1.0973416139999998e-11,15600347,1267360,1530708300
1256500,2054551792,81288122,1.0973896469999998e-11,15716002,1267804,1531976104
1257000,2066002334,81576926,1.101288501e-11,16135707,1267348,1533243452
1257500,2063058416,81300688,1.0975592879999998e-11,16124398,1267356,1534510808
1258000,2058216625,81301089,1.0975647015e-11,16137434,1267356,1535778164
1258500,2056169334,81300684,1.097559234e-11,16124258,1266916,1537045080
1259000,2057265000,81302319,1.0975813064999998e-11,16177414,1266892,1538311972
1259500,2149658333,81576169,1.1012782815e-11,16111101,1266900,1539578872
1260000,2157852667,81300638,1.0975586129999998e-11,16122780,1266468,1540845340
1260500,2342958375,81302187,1.0975795245e-11,16173122,1266484,1542111824
1261000,2773989375,81300836,1.0975612859999998e-11,16129192,1267348,1543379172
1261500,2286430500,81574716,1.101258666e-11,16063890,1266460,1544645632
1262000,2221314709,81299042,1.097537067e-11,16070908,1268260,1545913892
1262500,2076758000,81299397,1.0975418594999997e-11,16082447,1267348,1547181240
1263000,2057521166,81301027,1.0975638645e-11,16135400,1266916,1548448156
1263500,2072568000,81570667,1.1012040044999998e-11,15932291,1268588,1549716744
1264000,2063632250,81287949,1.0973873115e-11,15710371,1267792,1550984536
1264500,2052734833,81286544,1.097368344e-11,15664725,1266916,1552251452
1265000,2061830958,81290005,1.0974150675e-11,15777214,1266020,1553517472
1265500,2065963667,81303322,1.097594847e-11,16210011,1267372,1554784844
1266000,2051472583,81568753,1.1011781655e-11,15870070,1266932,1556051776
1266500,2052184459,81300492,1.097556642e-11,16118016,1266492,1557318268
1267000,2053622583,81301883,1.0975754205e-11,16163217,1267364,1558585632
1267500,2056028666,81300919,1.0975624065e-11,16131889,1266932,1559852564
1268000,2053739125,81301791,1.0975741785e-11,16160236,1266892,1561119456
1268500,2059732667,81577968,1.1013025679999999e-11,16169556,1267804,1562387260
1269000,2314125166,81299623,1.0975449104999999e-11,16089783,1267380,1563654640
1269500,2258169792,81304605,1.0976121675e-11,16251705,1268616,1564923256
1270000,2297135625,81302289,1.0975809015e-11,16176442,1266900,1566190156
1270500,2388695208,81303225,1.0975935375e-11,16206861,1267388,1567457544
1271000,2193203583,81300961,1.0975629734999998e-11,16133261,1267388,1568724932
1271500,2077077750,81293041,1.0974560535e-11,15875874,1267744,1569992676
1272000,2073358375,81561346,1.101078171e-11,15629337,1267256,1571259932
1272500,2067810166,81283908,1.0973327579999998e-11,15579053,1267364,1572527296
1273000,2067925792,81282853,1.0973185155e-11,15544770,1266484,1573793780
1273500,2059919333,81292645,1.0974507074999999e-11,15863009,1266484,1575060264
1274000,2076394375,81303311,1.0975946985e-11,16209645,1267380,1576327644
1274500,2054000792,81575256,1.101265956e-11,16081438,1267272,1577594916
1275000,2053800667,81299915,1.0975488525e-11,16099283,1267812,1578862728
1275500,2052941625,81301451,1.0975695885e-11,16149199,1266484,1580129212
1276000,2051886167,81301235,1.0975666724999999e-11,16142157,1267836,1581397048
1276500,2051924750,81299139,1.0975383765e-11,16074050,1268616,1582665664
1277000,2051235291,81575517,1.1012694795e-11,16089910,1267380,1583933044
1277500,2049445208,81298657,1.0975318695e-11,16058381,1266940,1585199984
1278000,2051785083,81298681,1.0975321934999999e-11,16059177,1269800,1586469784
1278500,2051084958,81269924,1.0971439739999998e-11,15124584,1267836,1587737620
1279000,2070712792,81269572,1.097139222e-11,15113117,1266044,1589003664
1279500,2146919750,81546603,1.1008791405000001e-11,15150211,1267828,1590271492
1280000,2406937666,81285686,1.097356761e-11,15636836,1268632,1591540124
1280500,2283813958,81291359,1.0974333464999999e-11,15821204,1266940,1592807064
1281000,2278510625,81564871,1.1011257584999999e-11,15743935,1267796,1594074860
1281500,2278934041,81285764,1.097357814e-11,15639349,1266468,1595341328
1282000,2202942416,81284317,1.0973382795e-11,15592330,1266468,1596607796
1282500,2068140333,81283884,1.0973324339999999e-11,15578258,1265564,1597873360
1283000,2066263250,81562085,1.1010881474999998e-11,15653358,1266916,1599140276
1283500,2057716875,81288951,1.0974008385e-11,15742943,1268252,1600408528
1284000,2066296583,81284764,1.0973443139999998e-11,15606846,1266460,1601674988
1284500,2038816166,81284826,1.0973451509999999e-11,15608892,1266900,1602941888
1285000,2043681084,81285425,1.0973532374999998e-11,15628353,1266916,1604208804
1285500,2054019083,81561823,1.1010846104999998e-11,15644860,1266460,1605475264
1286000,2059591292,81278225,1.0972560374999998e-11,15394340,1267720,1606742984
1286500,2064879000,81277390,1.097244765e-11,15367209,1267804,1608010788
1287000,2052527834,81284418,1.0973396429999999e-11,15595617,1266932,1609277720
1287500,2053192875,81284769,1.0973443814999997e-11,15607021,1266940,1610544660
1288000,2075677250,81558084,1.101034134e-11,15523335,1266020,1611810680
1288500,2104006833,81271302,1.0971625769999998e-11,15169358,1267828,1613078508
1289000,2229479750,81275322,1.0972168470000001e-11,15299990,1267364,1614345872
1289500,2412459167,81283448,1.0973265479999999e-11,15564078,1266916,1615612788
1290000,2233484167,81560717,1.1010696795e-11,15608918,1266916,1616879704
1290500,2244135125,81287012,1.0973746619999999e-11,15679912,1267356,1618147060
1291000,2444014333,81282658,1.097315883e-11,15538423,1266924,1619413984
1291500,2087721625,81285261,1.0973510235e-11,15623015,1267812,1620681796
1292000,2048811916,81559160,1.1010486599999999e-11,15558316,1266916,1621948712
1292500,2050695208,81281699,1.0973029365e-11,15507241,1266468,1623215180
1293000,2050625042,81284868,1.097345718e-11,15610235,1267388,1624482568
1293500,2052722791,81285173,1.0973498355e-11,15620166,1267340,1625749908
1294000,2071565333,81561071,1.1010744585e-11,15620434,1266476,1627016384
1294500,2051220542,81284948,1.0973467979999998e-11,15612841,1268192,1628284576
1295000,2053406458,81290362,1.097419887e-11,15788804,1266456,1629551032
1295500,2052182209,81303488,1.0975970879999998e-11,16215396,1267812,1630818844
1296000,2051564542,81283571,1.0973282084999999e-11,15568090,1266940,1632085784
1296500,2064637458,81564504,1.101120804e-11,15731976,1267356,1633353140
1297000,2051963375,81292496,1.0974486959999999e-11,15858146,1266932,1634620072
1297500,2052657458,81298714,1.0975326389999998e-11,16060234,1267380,1635887452
1298000,2051574333,81299708,1.097546058e-11,16092555,1268260,1637155712
1298500,2051783000,81300131,1.0975517684999998e-11,16106283,1266904,1638422616
1299000,2064006166,81574085,1.1012501474999998e-11,16043376,1267828,1639690444
1299500,2478862250,81297434,1.0975153589999998e-11,16018655,1267704,1640958148
1300000,2230102500,81300418,1.0975556429999998e-11,16115621,1267348,1642225496
1300500,2218760375,81298488,1.0975295879999998e-11,16052889,1266484,1643491980
1301000,2248038875,81574541,1.1012563035e-11,16058180,1268284,1644760264
1301500,2236373209,81298603,1.0975311404999998e-11,16056635,1266484,1646026748
1302000,2059910833,81298088,1.097524188e-11,16039889,1269444,1647296192
1302500,2073042209,81281963,1.0973065004999999e-11,15515832,1267372,1648563564
1303000,2057567875,81565557,1.1011350194999999e-11,15766201,1266924,1649830488
1303500,2055906583,81297639,1.0975181264999999e-11,16025313,1266492,1651096980
1304000,2059446958,81298419,1.0975286564999998e-11,16050645,1267712,1652364692
1304500,2053731250,81299142,1.097538417e-11,16074151,1267388,1653632080
1305000,2058795666,81300829,1.0975611915e-11,16128968,1267388,1654899468
1305500,2071810167,81580295,1.1013339824999997e-11,16245207,1267296,1656166764
1306000,2071168666,81299663,1.0975454504999998e-11,16091093,1267364,1657434128
1306500,2073969208,81300464,1.097556264e-11,16117105,1267348,1658701476
1307000,2073963292,81296724,1.097505774e-11,15995550,1266468,1659967944
1307500,2052356125,81571613,1.1012167754999998e-11,15963045,1266468,1661234412
1308000,2062652750,81299557,1.0975440194999999e-11,16087628,1267796,1662502208
1308500,2210032834,81297571,1.0975172085e-11,16023101,1267380,1663769588
1309000,2276932709,81297003,1.0975095405e-11,16004624,1266908,1665036496
1309500,2302328625,81292405,1.0974474675e-11,15855213,1266824,1666303320
1310000,2204133542,81280931,1.0972925685e-11,15482281,1266468,1667569788
1310500,2236204958,81289972,1.097414622e-11,15776135,1266916,1668836704
1311000,2239002375,81280585,1.0972878974999999e-11,15471053,1267348,1670104052
1311500,2063471750,81290975,1.0974281625e-11,15808708,1266924,1671370976
1312000,2065657458,81573866,1.101247191e-11,16036261,1267348,1672638324
1312500,2067889708,81299917,1.0975488794999999e-11,16099339,1266900,1673905224
1313000,2051679959,81299276,1.097540226e-11,16078515,1266932,1675172156
1313500,2061001875,81299394,1.0975418189999997e-11,16082339,1266932,1676439088
1314000,2059697459,81575053,1.1012632154999998e-11,16074834,1266484,1677705572
1314500,2069885250,81299427,1.0975422645e-11,16083421,1267720,1678973292
1315000,2049087084,81300940,1.09756269e-11,16132571,1267812,1680241104
1315500,2061435917,81303607,1.0975986945e-11,16219247,1267804,1681508908
1316000,2057583959,81296533,1.0975031955e-11,15989368,1266916,1682775824
1316500,2054663667,81574081,1.1012500934999999e-11,16043230,1267388,1684043212
1317000,2066300542,81310499,1.0976917365e-11,16443244,1269860,1685313072
1317500,2052520709,81295160,1.09748466e-11,15944747,1266492,1686579564
1318000,2180147750,81295195,1.0974851324999999e-11,15945882,1267352,1687846916
1318500,2280231375,81297661,1.0975184235e-11,16026030,1266940,1689113856
1319000,2394387791,81577742,1.1012995169999999e-11,16162245,1267380,1690381236
1319500,2251286625,81300598,1.097558073e-11,16121458,1268640,1691649876
1320000,2235267208,81298533,1.0975301955e-11,16054354,1267388,1692917264
1320500,2832602666,81580405,1.1013354675e-11,16248780,1267388,1694184652
1321000,2068431167,81284416,1.0973396159999999e-11,15595545,1266492,1695451144
1321500,2076138541,81285680,1.09735668e-11,15636650,1266940,1696718084
1322000,2047498375,81286666,1.0973699909999998e-11,15668688,1267388,1697985472
1322500,2060075459,81287213,1.0973773754999999e-11,15686460,1268640,1699254112
1323000,2057880083,81560104,1.101061404e-11,15588984,1266036,1700520148
1323500,2051793334,81288469,1.0973943315e-11,15727267,1267836,1701787984
1324000,2069023167,81297458,1.097515683e-11,16019428,1268540,1703056524
1324500,2061739500,81288726,1.0973978009999997e-11,15735639,1267804,1704324328
1325000,2050419625,81287985,1.0973877974999999e-11,15711557,1267388,1705591716
1325500,2052660625,81565074,1.1011284989999998e-11,15750509,1267836,1706859552
1326000,2053317542,81284392,1.097339292e-11,15594763,1266916,1708126468
1326500,2049567041,81288444,1.097393994e-11,15726485,1266012,1709392480
1327000,2060723750,81299469,1.0975428315e-11,16084778,1267348,1710659828
1327500,2177565125,81574373,1.1012540354999999e-11,16052732,1266468,1711926296
1328000,2131458708,81303088,1.097591688e-11,16202378,1267812,1713194108
1328500,2445435000,81301269,1.0975671314999999e-11,16143292,1266916,1714461024
1329000,2258963833,81299829,1.0975476914999998e-11,16096479,1266916,1715727940
1329500,2223317000,81577687,1.1012987745e-11,16160428,1267356,1716995296
1330000,2372756375,81301508,1.0975703579999998e-11,16151028,1267804,1718263100
1330500,2055382459,81302421,1.0975826834999999e-11,16180733,1266908,1719530008
1331000,2062069875,81297143,1.0975114304999999e-11,16009173,1267356,1720797364
1331500,2070658542,81574931,1.1012615684999999e-11,16070865,1267812,1722065176
1332000,2064953459,81299605,1.0975446675e-11,16089201,1267380,1723332556
1332500,2053323083,81299871,1.0975482584999998e-11,16097839,1266940,1724599496
1333000,2064245208,81298821,1.0975340835e-11,16063729,1268996,1725868492
1333500,2054848583,81283469,1.0973268315e-11,15564769,1266932,1727135424
1334000,2056616833,81558796,1.101043746e-11,15546489,1266492,1728401916
1334500,2062114083,81290727,1.0974248145e-11,15800656,1266012,1729667928
1335000,2052487541,81294141,1.0974709034999999e-11,15911610,1266468,1730934396
1335500,2051816250,81297756,1.097519706e-11,16029093,1268284,1732202680
1336000,2050068000,81296952,1.0975088519999998e-11,16002962,1267836,1733470516
1336500,2051746583,81575347,1.1012671844999999e-11,16084396,1266940,1734737456
1337000,2053477875,81299967,1.0975495545e-11,16100953,1268152,1736005608
1337500,2051201666,81296955,1.0975088924999998e-11,16003078,1267344,1737272952
1338000,2051725917,81300523,1.0975570605000001e-11,16119029,1266916,1738539868
1338500,2051666792,81300503,1.0975567905e-11,16118368,1266932,1739806800
1339000,2088073375,81298115,1.0975245524999998e-11,16040784,1269088,1741075888
1339500,2244724750,81299251,1.0975398885e-11,16077684,1267364,1742343252
1340000,2378154833,81299574,1.097544249e-11,16088182,1267388,1743610640
1340500,2548637834,81569264,1.1011850639999998e-11,15886698,1268092,1744878732
1341000,2089533584,81283959,1.0973334464999999e-11,15580692,1266452,1746145184
1341500,2384493791,81282452,1.0973131019999998e-11,15531717,1267828,1747413012
1342000,2067516375,81292959,1.0974549464999999e-11,15873207,1267296,1748680308
1342500,2057037000,81574854,1.101260529e-11,16068361,1266932,1749947240
1343000,2061158666,81297455,1.0975156425e-11,16019335,1267812,1751215052
1343500,2056369417,81296784,1.0975065839999998e-11,15997523,1268156,1752483208
1344000,2059908875,81297032,1.097509932e-11,16005576,1267388,1753750596
1344500,2062532917,81299864,1.097548164e-11,16097617,1266924,1755017520
1345000,2056678417,81572522,1.101229047e-11,15992585,1266484,1756284004
1345500,2051881250,81302993,1.0975904055e-11,16199309,1266816,1757550820
1346000,2057354083,81299569,1.0975441815e-11,16088044,1267704,1758818524
1346500,2059458708,81289257,1.0974049694999999e-11,15752904,1268192,1760086716
1347000,2050658417,81280546,1.097287371e-11,15469780,1267380,1761354096
1347500,88785750625,376304771,5.0801144085e-11,15691286,-207327536,1554026560
1348000,2088035750,81298324,1.0975273739999998e-11,16047577,1267364,1555293924
1348500,2221158500,81300763,1.0975603004999999e-11,16126833,1266940,1556560864
1349000,2359895000,81299961,1.0975494734999998e-11,16100774,1268152,1557829016
1349500,2057283791,81602743,1.1016370305e-11,16126571,1267356,1559096372
1350000,2057220584,81297411,1.0975150485e-11,16017889,1266036,1560362408
1350500,2061066292,81306221,1.0976339835e-11,16304223,1267380,1561629788
1351000,2053479041,81302842,1.097588367e-11,16194410,1267812,1562897600
1351500,2057626625,81298529,1.0975301415e-11,16054234,1267712,1564165312
1352000,2052192667,81601500,1.10162025e-11,16086159,1268276,1565433588
1352500,2051682125,81299908,1.0975487579999999e-11,16099049,1266940,1566700528
1353000,2056778541,81301500,1.0975702499999998e-11,16150802,1269512,1567970040
1353500,2057389041,81293857,1.0974670694999999e-11,15902403,1267268,1569237308
1354000,2051480667,81293653,1.0974643154999999e-11,15895768,1266940,1570504248
1354500,2063133666,81603601,1.1016486134999999e-11,16154468,1268168,1571772416
1355000,2051637167,81296722,1.097505747e-11,15995495,1267372,1573039788
1355500,2157995875,81289557,1.0974090194999998e-11,15762642,1266912,1574306700
1356000,2311045875,81304379,1.0976091165e-11,16244336,1267804,1575574504
1356500,2237032584,81602840,1.1016383399999999e-11,16129729,1267744,1576842248
1357000,2289539458,81300155,1.0975520925e-11,16107083,1266492,1578108740
1357500,2220648042,81301874,1.0975752989999998e-11,16162945,1266940,1579375680
1358000,2191056667,81301037,1.0975639995e-11,16135749,1267836,1580643516
1358500,2050552125,81600577,1.1016077895e-11,16056186,1267712,1581911228
1359000,2051688750,81299932,1.097549082e-11,16099824,1266464,1583177692
1359500,2056291583,81301160,1.0975656599999999e-11,16139740,1267372,1584445064
1360000,2062719375,81302350,1.0975817249999998e-11,16178408,1267388,1585712452
1360500,2055845417,81591360,1.10148336e-11,15756637,1267652,1586980104
1361000,2065950792,81290924,1.0974274739999998e-11,15807067,1267812,1588247916
1361500,2052590333,81285384,1.097352684e-11,15627023,1266824,1589514740
1362000,2051507125,81295932,1.097495082e-11,15969808,1266460,1590781200
1362500,2051485500,81302011,1.0975771485e-11,16167380,1267828,1592049028
1363000,2054094875,81604830,1.1016652049999999e-11,16194402,1266932,1593315960
1363500,2051583375,81302128,1.0975787279999999e-11,16171207,1266932,1594582892
1364000,2057888375,81301116,1.097565066e-11,16138293,1267712,1595850604
1364500,2051892959,81300166,1.097552241e-11,16107425,1266908,1597117512
1365000,1980001875,81300928,1.0975625279999998e-11,16132212,1266484,1598383996
1365500,2392006209,81603822,1.1016515969999999e-11,16161628,1266932,1599650928
1366000,2232143166,81305164,1.097619714e-11,16269882,1267812,1600918740
1366500,2245480250,81301205,1.0975662674999998e-11,16141199,1268152,1602186892
1367000,2277257958,81596071,1.1015469585e-11,15909716,1267744,1603454636
1367500,2277792667,81285618,1.0973558429999998e-11,15634608,1267388,1604722024
1368000,2056183291,81296253,1.0974994155e-11,15980260,1267744,1605989768
1368500,2053301709,81299813,1.0975474754999999e-11,16095961,1266492,1607256260
1369000,2065910542,81299584,1.0975443839999998e-11,16088507,1267380,1608523640
1369500,2052146458,81602779,1.1016375165e-11,16127740,1266484,1609790124
1370000,2061432375,81300459,1.0975561965e-11,16116948,1266044,1611056168
1370500,2054571000,81302610,1.0975852349999999e-11,16186860,1267388,1612323556
1371000,2058538541,81303319,1.0975948065e-11,16209898,1267812,1613591368
1371500,2065109583,81295616,1.0974908159999998e-11,15959561,1267744,1614859112
1372000,2062109500,81600039,1.1016005264999998e-11,16038685,1266940,1616126052
1372500,2051932125,81300503,1.0975567905e-11,16118374,1266900,1617392952
1373000,2073092916,81299926,1.097549001e-11,16099624,1266044,1618658996
1373500,2058804375,81302146,1.0975789709999998e-11,16171788,1268168,1619927164
1374000,2065723833,81598000,1.101573e-11,15972422,1268640,1621195804
1374500,2143813792,81280806,1.0972908809999999e-11,15478223,1266484,1622462288
1375000,2426629583,81293717,1.0974651794999997e-11,15897829,1267380,1623729668
1375500,2270279583,81306126,1.097632701e-11,16301136,1268168,1624997836
1376000,2228032875,81603023,1.1016408104999999e-11,16135678,1266908,1626264744
1376500,2252867542,81301908,1.097575758e-11,16164033,1268184,1627532928
1377000,2447888834,81297698,1.097518923e-11,16027212,1266440,1628799368
1377500,2054942292,81300692,1.0975593419999999e-11,16124542,1267388,1630066756
1378000,2050940459,81603723,1.1016502604999998e-11,16158419,1267360,1631334116
1378500,2052001958,81301267,1.0975671045e-11,16143210,1267744,1632601860
1379000,2048261583,81298147,1.0975249845e-11,16041824,1267380,1633869240
1379500,2062899500,81301468,1.097569818e-11,16149748,1266940,1635136180
1380000,2051288917,81301551,1.0975709385e-11,16152437,1267388,1636403568
1380500,2051245416,81604776,1.101664476e-11,16192648,1266484,1637670052
1381000,2052019875,81296323,1.0975003605e-11,15982523,1268168,1638938220
1381500,2072281792,81283244,1.0973237939999997e-11,15557465,1267296,1640205516
1382000,2053795750,81283250,1.0973238749999999e-11,15557664,1266492,1641472008
1382500,2053049208,81289914,1.0974138389999999e-11,15774237,1266456,1642738464
1383000,2052055917,81604288,1.101657888e-11,16176804,1267380,1644005844
1383500,2051139875,81301928,1.097576028e-11,16164687,1269064,1645274908
1384000,2051039958,81299662,1.0975454369999998e-11,16091061,1266924,1646541832
1384500,2097864458,81302844,1.0975883939999998e-11,16194451,1268276,1647810108
1385000,2365028625,81603605,1.1016486675e-11,16154582,1266028,1649076136
1385500,2459609334,81301800,1.0975743e-11,16160542,1266484,1650342620
1386000,2343974042,81304438,1.0976099129999998e-11,16246275,1267812,1651610432
1386500,2686653667,81299768,1.0975468679999998e-11,16094513,1267744,1652878176
1387000,2399730416,81600317,1.1016042795e-11,16047739,1267356,1654145532
1387500,2058826666,81301108,1.097564958e-11,16138038,1267388,1655412920
1388000,2058413292,81290157,1.0974171194999998e-11,15782149,1267736,1656680656
1388500,2055067334,81282000,1.097307e-11,15517019,1267720,1657948376
1389000,2063395416,81587675,1.1014336125e-11,15636846,1267340,1659215716
1389500,2059973417,81295639,1.0974911265e-11,15960309,1267372,1660483088
1390000,2061437208,81301510,1.097570385e-11,16151106,1267728,1661750816
1390500,2051359125,81300113,1.0975515255e-11,16105700,1266476,1663017292
1391000,2064268292,81294041,1.0974695534999999e-11,15908369,1266916,1664284208
1391500,2055903292,81602945,1.1016397574999998e-11,16133147,1266484,1665550692
1392000,2051243750,81300443,1.0975559804999998e-11,16116428,1267248,1666817940
1392500,2065398375,81300118,1.0975515929999999e-11,16105863,1267388,1668085328
1393000,2066980834,81301655,1.0975723425e-11,16155821,1266932,1669352260
1393500,2055025125,81298445,1.0975290075e-11,16051486,1268168,1670620428
1394000,2166834833,81304343,1.0976086305e-11,16243172,1266904,1671887332
1394500,2139658375,81309534,1.0976787089999999e-11,16411896,1267288,1673154620
1395000,3016531292,81303567,1.0975981545e-11,16217951,1266932,1674421552
1395500,2391391458,81606857,1.1016925694999999e-11,16260276,1267728,1675689280
1396000,2300779417,81283449,1.0973265615e-11,15564121,1266020,1676955300
1396500,2205299042,81280610,1.0972882349999999e-11,15471873,1266044,1678221344
1397000,2053369625,81295655,1.0974913424999999e-11,15960810,1268616,1679489960
1397500,2052011750,81600923,1.1016124604999998e-11,16067406,1267364,1680757324
1398000,2066445416,81299911,1.0975487984999999e-11,16099128,1268284,1682025608
1398500,2051512625,81297804,1.097520354e-11,16030673,1268608,1683294216
1399000,2069086375,81296676,1.0975051259999998e-11,15994001,1267388,1684561604
1399500,2051528541,81296686,1.097505261e-11,15994337,1267380,1685828984
1400000,2052255416,81600856,1.1016115559999998e-11,16065233,1268184,1687097168
1400500,2064554417,81301924,1.0975759739999999e-11,16164566,1267356,1688364524
1401000,2066701750,81301404,1.097568954e-11,16147658,1266912,1689631436
1401500,2051960333,81298803,1.0975338404999998e-11,16063139,1267356,1690898792
1402000,2068839709,81297451,1.0975155884999998e-11,16019178,1269396,1692168188
1402500,2051769167,81586725,1.1014207874999998e-11,15605992,1266908,1693435096
1403000,2071389958,81283276,1.0973242259999999e-11,15558490,1266460,1694701556
1403500,2052688625,81289981,1.0974147434999999e-11,15776406,1267804,1695969360
1404000,2050385125,81299811,1.0975474485e-11,16095877,1266900,1697236260
1404500,2052016167,81291128,1.097430228e-11,15813710,1267356,1698503616
1405000,2112068542,81301367,1.0975684544999999e-11,16146456,1267348,1699770964
1405500,2207332750,81303788,1.0976011380000001e-11,16225144,1267364,1701038328
1406000,2355784000,81298380,1.0975281299999999e-11,16049405,1266492,1702304820
1406500,2149019834,81596945,1.1015587575e-11,15938141,1267348,1703572168
1407000,2173915959,81298099,1.0975243364999999e-11,16040260,1267364,1704839532
1407500,2284204583,81297292,1.0975134419999999e-11,16014026,1266044,1706105576
1408000,2072993750,81298228,1.097526078e-11,16044464,1266492,1707372068
1408500,2068804250,81298532,1.097530182e-11,16054332,1267836,1708639904
1409000,2076235041,81601959,1.1016264465e-11,16101082,1266904,1709906808
1409500,2062694750,81298281,1.0975267935e-11,16046173,1268168,1711174976
1410000,2054046583,81291523,1.0974355604999999e-11,15826534,1267744,1712442720
1410500,2065136042,81284971,1.0973471085e-11,15613601,1267364,1713710084
1411000,2051187292,81586086,1.101412161e-11,15585219,1266492,1714976576
1411500,2053580458,81282161,1.0973091735e-11,15522271,1267388,1716243964
1412000,2057787791,81298214,1.097525889e-11,16044004,1268168,1717512132
1412500,2063724250,81295480,1.0974889799999999e-11,15955122,1266924,1718779056
1413000,2069391834,81296641,1.0975046535e-11,15992868,1266492,1720045548
1413500,2083280750,81603500,1.1016472499999999e-11,16151180,1267836,1721313384
1414000,2055447750,81297650,1.097518275e-11,16025664,1268184,1722581568
1414500,2442202250,81298180,1.09752543e-11,16042893,1266900,1723848468
1415000,2197603459,81298520,1.09753002e-11,16053947,1267352,1725115820
1415500,2281426417,81609989,1.1017348514999998e-11,16362071,1268632,1726384452
1416000,2328999000,81298163,1.0975252005e-11,16042316,1267364,1727651816
1416500,2117755833,81298635,1.0975315725e-11,16057684,1266940,1728918756
1417000,2278817667,81284645,1.0973427074999999e-11,15602997,1269412,1730188168
1417500,2054906250,81590077,1.1014660394999998e-11,15714939,1266940,1731455108
1418000,2054073458,81299343,1.0975411305e-11,16080673,1266940,1732722048
1418500,2052828708,81299615,1.0975448024999999e-11,16089516,1268640,1733990688
1419000,2052501208,81297521,1.0975165334999999e-11,16021457,1266940,1735257628
1419500,2057645167,81301040,1.09756404e-11,16135836,1268276,1736525904
1420000,2051576792,81599828,1.101597678e-11,16031824,1268184,1737794088
1420500,2059330250,81302547,1.0975843845e-11,16184811,1266136,1739060224
1421000,2059382833,81300447,1.0975560345e-11,16116570,1267340,1740327564
1421500,2052782875,81298922,1.097535447e-11,16066986,1267364,1741594928
1422000,2061236334,81300431,1.0975558185e-11,16116037,1267348,1742862276
1422500,2051318000,81601149,1.1016155114999998e-11,16074783,1266916,1744129192
1423000,2054356917,81298468,1.097529318e-11,16052228,1266012,1745395204
1423500,2058094917,81299434,1.0975423589999999e-11,16083651,1267364,1746662568
1424000,2092498042,81299863,1.0975481504999998e-11,16097576,1266916,1747929484
1424500,2195958958,81298078,1.0975240529999999e-11,16039565,1268608,1749198092
1425000,2377933541,81287989,1.0973878515e-11,15711680,1266908,1750465000
1425500,2236535458,81301871,1.0975752584999998e-11,16162834,1266912,1751731912
1426000,2216139917,81285402,1.0973529269999998e-11,15627605,1267380,1752999292
1426500,2216570833,81584568,1.1013916679999999e-11,15535872,1266468,1754265760
1427000,2279243542,81283977,1.0973336895000001e-11,15581286,1267812,1755533572
1427500,2072853125,81292001,1.0974420135e-11,15842080,1266932,1756800504
1428000,2068187291,81299931,1.0975490684999999e-11,16099789,1266932,1758067436
1428500,2064127000,81600786,1.101610611e-11,16062963,1266900,1759334336
1429000,2053587958,81299230,1.0975396049999999e-11,16077012,1266484,1760600820
1429500,2069400583,81300796,1.097560746e-11,16127919,1267372,1761868192
1430000,2081280000,81300787,1.0975606244999999e-11,16127618,1266492,1763134684
1430500,2052134084,81298217,1.0975259295e-11,16044101,1266460,1764401144
1431000,2061220791,81599282,1.1015903069999999e-11,16014089,1267388,1765668532
1431500,2055459333,81296691,1.0975053285e-11,15994479,1266492,1766935024
1432000,2066314750,81299281,1.0975402934999998e-11,16078676,1266908,1768201932
1432500,2072433125,81302570,1.0975846949999997e-11,16185553,1266484,1769468416
1433000,2055892375,81300795,1.0975607324999999e-11,16127885,1268972,1770737388
1433500,2064753084,81600007,1.1016000945e-11,16037644,1266916,1772004304
1434000,2110157875,81296795,1.0975067325e-11,15997878,1266916,1773271220
1434500,2700241917,81301519,1.0975705064999999e-11,16151386,1266904,1774538124
1435000,2239543958,81310976,1.097698176e-11,16458767,1266452,1775804576
1435500,2230637500,81623406,1.1019159809999999e-11,16798107,1267372,1777071948
1436000,2230062959,81315073,1.0977534854999997e-11,16591911,1266940,1778338888
1436500,2217744959,81314887,1.0977509745e-11,16585852,1267380,1779606268
1437000,2064765500,81315592,1.0977604919999999e-11,16608795,1266492,1780872760
1437500,2066528917,81617222,1.101832497e-11,16597130,1267716,1782140476
1438000,2057770541,81317678,1.097788653e-11,16676561,1268260,1783408736
1438500,2057301583,81318332,1.097797482e-11,16697818,1267812,1784676548
1439000,2068201125,81314690,1.097748315e-11,16579450,1268168,1785944716
1439500,2058699500,81312691,1.0977213285e-11,16514483,1266460,1787211176
1440000,2052096208,81612893,1.1017740555e-11,16456457,1267704,1788478880
1440500,2054233042,81304235,1.0976071724999999e-11,16239656,1267388,1789746268
1441000,2051918750,81302350,1.0975817249999998e-11,16178402,1266476,1791012744
1441500,2037727750,81314044,1.0977395939999998e-11,16558479,1266468,1792279212
1442000,2048293958,81619490,1.101863115e-11,16670851,1266940,1793546152
1442500,2050983000,81314780,1.0977495299999997e-11,16582385,1267736,1794813888
1443000,2052185125,81315267,1.0977561045e-11,16598200,1267388,1796081276
1443500,2051370334,81314294,1.097742969e-11,16566593,1267828,1797349104
1444000,2052350667,81315656,1.0977613559999999e-11,16610873,1268632,1798617736
1444500,2053427875,81615603,1.1018106405e-11,16544511,1267364,1799885100
1445000,2412688375,81313944,1.0977382439999999e-11,16555231,1266484,1801151584
1445500,2434978917,81314365,1.0977439274999998e-11,16568897,1267372,1802418956
1446000,2308983334,81312518,1.097718993e-11,16508878,1267364,1803686320
1446500,2296918500,81611282,1.1017523069999999e-11,16404086,1267388,1804953708
1447000,2380861166,81306170,1.0976332949999998e-11,16302559,1268100,1806221808
1447500,2069115208,81294950,1.0974818249999998e-11,15937925,1267388,1807489196
1448000,2058361042,81306529,1.0976381415e-11,16314224,1267836,1808757032
1448500,2051514125,81612869,1.1017737314999998e-11,16455659,1267736,1810024768
1449000,2051099666,81309978,1.097684703e-11,16426321,1267820,1811292588
1449500,2060355250,81310090,1.0976862149999999e-11,16429962,1266476,1812559064
1450000,2052870959,81311099,1.0976998365e-11,16462753,1269080,1813828144
1450500,2052465708,81321823,1.0978446105e-11,16811281,1268716,1815096860
1451000,2057483208,81612465,1.1017682774999999e-11,16442531,1266044,1816362904
1451500,2051345500,81313775,1.0977359624999999e-11,16549721,1267352,1817630256
1452000,2075604625,81313840,1.09773684e-11,16551823,1267388,1818897644
1452500,2062641584,81313733,1.0977353955e-11,16548367,1267296,1820164940
1453000,2058060375,81615452,1.1018086019999999e-11,16539622,1266932,1821431872
1453500,2062319917,81324315,1.0978782525e-11,16892283,1267820,1822699692
1454000,2079185250,81320800,1.0978307999999998e-11,16778023,1267296,1823966988
1454500,2501064583,81312563,1.0977196005e-11,16510326,1267256,1825234244
1455000,2320007750,81616531,1.1018231685e-11,16574684,1267388,1826501632
1455500,2372733167,81320949,1.0978328115e-11,16782893,1267380,1827769012
1456000,2257182209,81301176,1.0975658759999998e-11,16140239,1266908,1829035920
1456500,2212403209,81301858,1.0975750829999999e-11,16162427,1267356,1830303276
1457000,2072145500,81619763,1.1018668005e-11,16679726,1267356,1831570632
1457500,2052150875,81315580,1.09776033e-11,16608388,1267356,1832837988
1458000,2051039334,81317559,1.0977870465e-11,16672692,1266916,1834104904
1458500,2065304958,81317261,1.0977830235e-11,16663021,1266932,1835371836
1459000,2065945125,81316956,1.0977789059999999e-11,16653124,1266908,1836638744
1459500,2054064333,81615984,1.101815784e-11,16556899,1266012,1837904756
1460000,2061298167,81317300,1.09778355e-11,16664289,1267804,1839172560
1460500,2070664584,81315871,1.0977642584999999e-11,16617841,1266004,1840438564
1461000,2056740333,81313008,1.0977256079999999e-11,16524804,1267812,1841706376
1461500,2052138333,81312936,1.097724636e-11,16522467,1266492,1842972868
1462000,2073065375,81614408,1.1017945079999998e-11,16505699,1266940,1844239808
1462500,2057928334,81316086,1.0977671609999999e-11,16624819,1266484,1845506292
1463000,2057717458,81315014,1.097752689e-11,16589991,1268944,1846775236
1463500,2098334917,81296568,1.0975036679999999e-11,15990499,1266468,1848041704
1464000,2457599667,81598112,1.101574512e-11,15976082,1267364,1849309068
1464500,107793025666,402170333,5.4292994954999996e-11,16286196,-160353192,1688955876
1465000,2059161125,81316481,1.0977724934999998e-11,16637676,1267836,1690223712
1465500,2066209208,81640556,1.102147506e-11,16696441,1268616,1691492328
1466000,2054690834,81314587,1.0977469245e-11,16576122,1266912,1692759240
1466500,2067066000,81314535,1.0977462224999998e-11,16574428,1266916,1694026156
1467000,2051061667,81314898,1.0977511229999999e-11,16586218,1268168,1695294324
1467500,2056319917,81311764,1.0977088139999998e-11,16484363,1267364,1696561688
1468000,2058003125,81635480,1.1020789799999998e-11,16531466,1266940,1697828628
1468500,2058956208,81313051,1.0977261885e-11,16526191,1267828,1699096456
1469000,2069903917,81316128,1.097767728e-11,16626203,1268624,1700365080
1469500,2133314917,81315944,1.097765244e-11,16620218,1267364,1701632444
1470000,2448319416,81305806,1.0976283809999999e-11,16290731,1267736,1702900180
1470500,2089522583,81303099,1.0975918365e-11,16202749,1268260,1704168440
1471000,2300880625,81295968,1.0974955679999999e-11,15970979,1266492,1705434932
1471500,2083175250,81294662,1.0974779370000001e-11,15928553,1266932,1706701864
1472000,2260811834,81299344,1.0975411439999998e-11,16080719,1266492,1707968356
1472500,2210187958,81634459,1.1020651964999999e-11,16498276,1268192,1709236548
1473000,2086797916,81315564,1.0977601139999999e-11,16607855,1267836,1710504384
1473500,2057163625,81314718,1.097748693e-11,16580384,1267380,1711771764
1474000,2051103750,81313004,1.0977255539999998e-11,16524651,1267736,1713039500
1474500,2064714750,81638460,1.1021192099999998e-11,16628316,1267380,1714306880
1475000,2056139875,81315531,1.0977596684999998e-11,16606802,1266908,1715573788
1475500,2055642500,81316767,1.0977763544999999e-11,16646964,1268276,1716842064
1476000,2083984542,81314430,1.0977448049999999e-11,16571016,1266468,1718108532
1476500,2065552417,81314536,1.0977462359999999e-11,16574467,1267796,1719376328
1477000,2049426125,81637252,1.102102902e-11,16589063,1267380,1720643708
1477500,2070025042,81307368,1.097649468e-11,16341501,1266816,1721910524
1478000,2059089833,81298106,1.0975244309999998e-11,16040472,1266468,1723176992
1478500,2050880875,81301048,1.0975641479999999e-11,16136084,1267356,1724444348
1479000,2111994750,81309760,1.0976817599999999e-11,16419241,1266020,1725710368
1479500,2223818334,81639379,1.1021316165e-11,16658170,1267364,1726977732
1480000,2279744958,81317379,1.0977846164999997e-11,16666850,1267364,1728245096
1480500,2250994000,81317610,1.097787735e-11,16674369,1268252,1729513348
1481000,2461554958,81632628,1.102040478e-11,16438779,1266460,1730779808
1481500,2190198083,81314804,1.097749854e-11,16583182,1267356,1732047164
1482000,2070830292,81314468,1.0977453179999998e-11,16572258,1267836,1733315000
1482500,2059563875,81314287,1.0977428744999998e-11,16566375,1267728,1734582728
1483000,2049317625,81310443,1.0976909805e-11,16441445,1266940,1735849668
1483500,2052690667,81636982,1.1020992569999998e-11,16580283,1267804,1737117472
1484000,2051176166,81313345,1.0977301575e-11,16535737,1267828,1738385300
1484500,2051991083,81315186,1.097755011e-11,16595569,1267380,1739652680
1485000,2051927375,81312307,1.0977161444999999e-11,16502012,1268960,1740921640
1485500,2051886833,81306711,1.0976405984999999e-11,16320140,1267388,1742189028
1486000,2052547417,81313522,1.097732547e-11,16541491,1266932,1743455960
1486500,2051880750,81314262,1.0977425369999998e-11,16565550,1266916,1744722876
1487000,2057577500,81302618,1.0975853429999999e-11,16187110,1268608,1745991484
1487500,2051641500,81302908,1.0975892579999998e-11,16196540,1267364,1747258848
1488000,2051545625,81636295,1.1020899825e-11,16557939,1267828,1748526676
1488500,2120212375,81312612,1.0977202619999999e-11,16511936,1268608,1749795284
1489000,2170430792,81314894,1.097751069e-11,16586101,1267380,1751062664
1489500,2384186459,81313366,1.097730441e-11,16536434,1266484,1752329148
1490000,2115078083,81316465,1.0977722774999999e-11,16637159,1268624,1753597772
1490500,2294047542,81317560,1.0977870599999997e-11,16672729,1267372,1754865144
1491000,2267138541,81314227,1.0977420645e-11,16564398,1266896,1756132040
1491500,2201316083,81314260,1.0977425099999999e-11,16565474,1267364,1757399404
1492000,2052600125,81632013,1.1020321754999998e-11,16418780,1267712,1758667116
1492500,2065742625,81301438,1.0975694129999999e-11,16148767,1266908,1759934024
1493000,2067027708,81295873,1.0974942854999999e-11,15967920,1266916,1761200940
1493500,2056701708,81296997,1.0975094595e-11,16004426,1266916,1762467856
1494000,2052753875,81295982,1.0974957569999999e-11,15971459,1266908,1763734764
1494500,2052423958,81632736,1.1020419359999999e-11,16442275,1267348,1765002112
1495000,2052889625,81313157,1.0977276195e-11,16529627,1266908,1766269020
1495500,2060462709,81318720,1.0978027199999997e-11,16710426,1267356,1767536376
1496000,2058648458,81310170,1.097687295e-11,16432549,1267704,1768804080
1496500,2064089083,81310986,1.0976983109999999e-11,16459075,1267828,1770071908
1497000,2063312750,81633109,1.1020469714999999e-11,16454394,1267388,1771339296
1497500,2050992542,81311813,1.0977094755e-11,16485967,1267712,1772607008
1498000,2072330292,81311873,1.0977102854999998e-11,16487897,1266940,1773873948
1498500,2083191084,81314565,1.0977466275e-11,16575407,1266904,1775140852
1499000,2472033458,81310482,1.097691507e-11,16442695,1269412,1776410264
1499500,2324439292,81293596,1.0974635459999999e-11,15893896,1266940,1777677204
1500000,2249528875,81296129,1.0974977414999997e-11,15976241,1266932,1778944136
1500500,2295170917,81293772,1.097465922e-11,15899639,1266036,1780210172
1501000,2332847834,81633697,1.1020549095e-11,16473517,1267372,1781477544
1501500,2046421375,81309517,1.0976784795e-11,16411339,1267388,1782744932
1502000,2070241792,81312132,1.0977137819999999e-11,16496339,1267372,1784012304
1502500,2050409708,81314513,1.0977459254999999e-11,16573704,1268616,1785280920
1503000,2058157125,81310813,1.0976959754999998e-11,16453463,1266484,1786547404
1503500,2050502709,81632943,1.1020447304999999e-11,16448986,1266492,1787813896
1504000,2053181166,81310601,1.0976931134999998e-11,16446557,1266028,1789079924
1504500,2051104500,81313886,1.0977374609999998e-11,16553342,1267372,1790347296
1505000,2052533000,81307917,1.0976568794999999e-11,16359352,1267256,1791614552
1505500,2052295083,81637077,1.1021005394999998e-11,16583373,1267356,1792881908
1506000,2052449208,81312702,1.097721477e-11,16514852,1267356,1794149264
1506500,2053182291,81296439,1.0975019264999999e-11,15986310,1266832,1795416096
1507000,2049622625,81296285,1.0974998474999998e-11,15981307,1268168,1796684264
1507500,2050767708,81295440,1.0974884399999997e-11,15953852,1267812,1797952076
1508000,2050727541,81630344,1.1020096439999999e-11,16364547,1267388,1799219464
1508500,2052393084,81309456,1.0976776559999999e-11,16409361,1268192,1800487656
1509000,2306544667,81312015,1.0977122024999999e-11,16492508,1266940,1801754596
1509500,2359514208,81313152,1.0977275519999999e-11,16529484,1266924,1803021520
1510000,2288639375,81636800,1.1020968e-11,16574350,1268640,1804290160
1510500,2234942959,81312275,1.0977157125e-11,16500963,1266136,1805556296
1511000,2154405584,81314450,1.0977450749999999e-11,16571646,1266468,1806822764
1511500,2540131416,81308456,1.0976641559999999e-11,16376846,1267264,1808090028
1512000,2085623334,81631686,1.102027761e-11,16408142,1267388,1809357416
1512500,2054206625,81312206,1.097714781e-11,16498740,1266940,1810624356
1513000,2050715542,81311036,1.097698986e-11,16460690,1267388,1811891744
1513500,2056551125,81296269,1.0974996314999999e-11,15980789,1268516,1813160260
1514000,2059506708,81293486,1.0974620609999998e-11,15890320,1266932,1814427192
1514500,2056928667,81620323,1.1018743605e-11,16038870,1268268,1815695460
1515000,2058472583,81309628,1.0976799779999999e-11,16414957,1267712,1816963172
1515500,2070672083,81312076,1.0977130259999998e-11,16494523,1266908,1818230080
1516000,2051839250,81307343,1.0976491304999999e-11,16340678,1266900,1819496980
1516500,2062998166,81312355,1.0977167924999998e-11,16503568,1266044,1820763024
1517000,2049193042,81636212,1.102088862e-11,16555242,1268192,1822031216
1517500,2056726000,81314689,1.0977483015e-11,16579418,1267388,1823298604
1518000,2051385583,81311891,1.0977105285e-11,16488479,1266940,1824565544
1518500,2063590541,81311773,1.0977089354999999e-11,16484657,1268624,1825834168
1519000,2382012208,81635094,1.102073769e-11,16518906,1267804,1827101972
1519500,2313858833,81321774,1.0978439489999998e-11,16809676,1266044,1828368016
1520000,2241755667,81320534,1.0978272089999999e-11,16769379,1267744,1829635760
1520500,2625279459,81313367,1.0977304544999999e-11,16536466,1267288,1830903048
1521000,2208814208,81636847,1.1020974345e-11,16575905,1266908,1832169956
1521500,2053506334,81312868,1.097723718e-11,16520257,1268168,1833438124
1522000,2051626000,81326711,1.0979105985e-11,16970127,1266492,1834704616
1522500,2050872750,81326309,1.0979051715e-11,16957087,1267828,1835972444
1523000,2067372334,81652863,1.1023136504999999e-11,17096407,1266940,1837239384
1523500,2057426042,81330238,1.097958213e-11,17084780,1268184,1838507568
1524000,2052768125,81329044,1.097942094e-11,17045964,1268284,1839775852
1524500,2059728542,81330051,1.0979556885e-11,17078691,1266932,1841042784
1525000,2063695292,81328930,1.097940555e-11,17042272,1267736,1842310520
1525500,2072872500,81651786,1.1022991109999999e-11,17061395,1266484,1843577004
1526000,2072952458,81332532,1.0979891819999999e-11,17159320,1269040,1844846044
1526500,2053242208,81322605,1.0978551674999999e-11,16836703,1268964,1846115008
1527000,2068550125,81284759,1.0973442464999998e-11,15606693,1266492,1847381500
1527500,2052235834,81286620,1.09736937e-11,15667177,1266940,1848648440
1528000,2139092083,81607841,1.1017058534999998e-11,15633195,1268616,1849917056
1528500,2241237500,81286454,1.0973671289999999e-11,15661780,1267828,1851184884
1529000,2255028834,81284977,1.0973471895e-11,15613804,1266492,1852451376
1529500,2294236292,81287025,1.0973748374999998e-11,15680350,1268184,1853719560
1530000,2358766208,81610096,1.101736296e-11,15706468,1267836,1854987396
1530500,2455305625,81290115,1.0974165524999999e-11,15780780,1267380,1856254776
1531000,2067584542,81302758,1.097587233e-11,16191684,1266908,1857521684
1531500,2077666833,81297196,1.097512146e-11,16010924,1266044,1858787728
1532000,2067145083,81635209,1.1020753215e-11,16522641,1268152,1860055880
1532500,2073220208,81315858,1.097764083e-11,16617426,1267820,1861323700
1533000,2052324250,81314795,1.0977497325e-11,16582875,1267388,1862591088
1533500,2068496750,81314177,1.0977413894999999e-11,16562778,1268640,1863859728
1534000,2056367833,81637961,1.1021124734999998e-11,16612105,1267380,1865127108
1534500,2056774584,81315219,1.0977554564999999e-11,16596647,1266468,1866393576
1535000,22010261750,82087535,1.1081817224999999e-11,16560050,1268184,1867661760
1535500,2070516625,81314524,1.0977460739999999e-11,16574076,1266932,1868928692
1536000,2059810334,81315736,1.097762436e-11,16613472,1268144,1870196836
1536500,2066337792,81312356,1.0977168059999999e-11,16503614,1267372,1871464208
1537000,2066878459,81308816,1.0976690159999997e-11,16388567,1266824,1872731032
1537500,2052417625,81620718,1.1018796929999999e-11,16051685,1267372,1873998404
1538000,2109847750,81298126,1.0975247009999998e-11,16041139,1266940,1875265344
1538500,2374563166,81311122,1.0977001469999998e-11,16463515,1268192,1876533536
1539000,2159612750,81301679,1.0975726664999999e-11,16156613,1267388,1877800924
1539500,2227470458,81638817,1.1021240294999998e-11,16639912,1267812,1879068736
1540000,2278262834,81315337,1.0977570495e-11,16600497,1268184,1880336920
1540500,2291295750,81317372,1.097784522e-11,16666616,1266476,1881603396
1541000,2067062458,81313437,1.0977313995e-11,16538752,1267348,1882870744
1541500,2068360875,81633935,1.1020581224999998e-11,16481246,1267736,1884138480
1542000,2064186459,81310128,1.0976867279999999e-11,16431189,1267380,1885405860
1542500,2058712417,81312820,1.0977230699999998e-11,16518677,1267836,1886673696
1543000,2055552250,81312356,1.0977168059999999e-11,16503621,1266492,1887940188
1543500,2055262459,81308608,1.0976662079999998e-11,16381804,1269436,1889209624
1544000,2072662625,81619591,1.1018644784999998e-11,16015071,1266492,1890476116
1544500,2052815208,81297854,1.097521029e-11,16032303,1266484,1891742600
1545000,2050975667,81295753,1.0974926654999999e-11,15963999,1268632,1893011232
1545500,2051309833,81303809,1.0976014214999998e-11,16225833,1268284,1894279516
1546000,2052398208,81311855,1.0977100424999998e-11,16487326,1266916,1895546432
1546500,2052400708,81634428,1.1020647779999998e-11,16497277,1267720,1896814152
1547000,2054271625,81312162,1.0977141869999998e-11,16497300,1267380,1898081532
1547500,2050826958,81312164,1.097714214e-11,16497375,1267820,1899349352
1548000,2052071625,81311834,1.0977097589999999e-11,16486647,1266924,1900616276
1548500,2058204208,81309740,1.0976814899999999e-11,16418575,1267296,1901883572
1549000,2051886875,81632473,1.1020383854999998e-11,16433726,1266044,1903149616
1549500,2055296292,81310590,1.0976929649999999e-11,16446196,1266940,1904416556
1550000,2613222625,81313962,1.0977384869999999e-11,16555795,1267372,1905683928
1550500,2303852083,81299370,1.0975414949999998e-11,16081564,1268540,1906952468
1551000,2156938458,81636883,1.1020979204999999e-11,16577065,1267364,1908219832
1551500,2299105000,81310368,1.097689968e-11,16438999,1266840,1909486672
1552000,2322936375,81310875,1.0976968124999999e-11,16455484,1266932,1910753604
1552500,2100455791,81636927,1.1020985144999998e-11,16578482,1268284,1912021888
1553000,2066440333,81311280,1.09770228e-11,16468636,1268192,1913290080
1553500,2052730666,81312537,1.0977192494999999e-11,16509487,1266476,1914556556
1554000,2068028209,81312416,1.0977176159999999e-11,16505536,1267388,1915823944
1554500,2058745583,81312874,1.097723799e-11,16520445,1268184,1917092128
1555000,107273443042,422065615,5.6978858024999996e-11,16503207,-123758960,1793333168
1555500,2054316000,81656114,1.1023575389999999e-11,16692992,1266908,1794600076
1556000,2053112250,81314584,1.097746884e-11,16575996,1266468,1795866544
1556500,2055060208,81312632,1.0977205319999999e-11,16512579,1268520,1797135064
1557000,2127172250,81302395,1.0975823324999999e-11,16179861,1267380,1798402444
1557500,2192711583,81312727,1.0977218144999999e-11,16515661,1266908,1799669352
1558000,2231080000,81652711,1.1023115984999997e-11,16582368,1267388,1800936740
1558500,2148519666,81300159,1.0975521465e-11,16107192,1268168,1802204908
1559000,2121078959,81301993,1.0975769054999997e-11,16166808,1266492,1803471400
1559500,2260419875,81313961,1.0977384734999999e-11,16555779,1266012,1804737412
1560000,2212215167,81654272,1.102332672e-11,16633117,1267380,1806004792
1560500,2072219750,81315089,1.0977537015e-11,16592421,1267380,1807272172
1561000,2060454625,81313629,1.0977339915e-11,16544985,1266892,1808539064
1561500,2061549875,81312445,1.0977180074999999e-11,16506494,1267744,1809806808
1562000,2057774542,81311664,1.0977074639999999e-11,16481118,1267388,1811074196
1562500,2085923333,81651356,1.1022933059999998e-11,16538338,1267364,1812341560
1563000,2049397625,81314661,1.0977479234999998e-11,16578533,1267372,1813608932
1563500,2050318292,81314042,1.0977395669999999e-11,16558414,1268988,1814877920
1564000,2056945334,81306126,1.097632701e-11,16301125,1266932,1816144852
1564500,2062326125,81641128,1.1021552279999998e-11,16205926,1266044,1817410896
1565000,2052308625,81296706,1.0975055309999997e-11,15994968,1268192,1818679088
1565500,2063983958,81299271,1.0975401585000001e-11,16078331,1267828,1819946916
1566000,2101505375,81313961,1.0977384734999999e-11,16555758,1266900,1821213816
1566500,2578238417,81313593,1.0977335054999998e-11,16543800,1268168,1822481984
1567000,2442160500,81652920,1.1023144199999999e-11,16589189,1267836,1823749820
1567500,2222383083,81312544,1.0977193439999998e-11,16509699,1266476,1825016296
1568000,2288504958,81311571,1.0977062084999998e-11,16478098,1268612,1826284908
1568500,2272982458,81647922,1.102246947e-11,16426739,1266468,1827551376
1569000,2322881708,81314626,1.097747451e-11,16577383,1267380,1828818756
1569500,2053743292,81314388,1.097744238e-11,16569636,1266940,1830085696
1570000,2059285584,81311415,1.0977041024999998e-11,16473007,1268516,1831354212
1570500,2071557958,81299823,1.0975476105e-11,16096292,1266484,1832620696
1571000,2045518375,81645979,1.1022207165e-11,16363589,1267364,1833888060
1571500,2051165000,81311187,1.0977010244999999e-11,16465605,1268184,1835156244
1572000,2053925208,81310736,1.097694936e-11,16450956,1266008,1836422252
1572500,2065528291,81312256,1.097715456e-11,16500364,1266924,1837689176
1573000,2052475709,81315541,1.0977598035e-11,16607124,1267836,1838957012
1573500,2061816375,81650889,1.1022870015e-11,16523180,1268192,1840225204
1574000,2066014917,81310881,1.0976968935e-11,16455662,1266044,1841491248
1574500,2060029458,81312641,1.0977206535e-11,16512864,1267380,1842758628
1575000,2053673541,81316419,1.0977716565e-11,16635636,1266484,1844025112
1575500,2241543208,81657502,1.1023762769999998e-11,16738086,1267372,1845292484
1576000,2147923375,81314895,1.0977510824999999e-11,16586118,1267364,1846559848
1576500,2414844250,81312391,1.0977172784999999e-11,16504726,1267736,1847827584
1577000,2299606375,81304794,1.097614719e-11,16257850,1267288,1849094872
1577500,2298204250,81635395,1.1020778325e-11,16019628,1267380,1850362252
1578000,2564472917,81307077,1.0976455394999998e-11,16332031,1266940,1851629192
1578500,2122340583,81312851,1.0977234884999998e-11,16519693,1266484,1852895676
1579000,2066437250,81312989,1.0977253515e-11,16524175,1267272,1854162948
1579500,2071608125,81652870,1.1023137449999998e-11,16587546,1268268,1855431216
1580000,2054611417,81315063,1.0977533505e-11,16591593,1266492,1856697708
1580500,2050949416,81317322,1.097783847e-11,16665002,1268160,1857965868
1581000,2065479958,81315866,1.097764191e-11,16617670,1267804,1859233672
1581500,2056609541,81313269,1.0977291314999999e-11,16533273,1268616,1860502288
1582000,2068270750,81652502,1.1023087769999998e-11,16575578,1267380,1861769668
1582500,2056036125,81311932,1.097711082e-11,16489806,1266932,1863036600
1583000,2062026292,81312853,1.0977235155e-11,16519772,1268164,1864304764
1583500,2057364709,81307632,1.0976530319999999e-11,16350088,1268184,1865572948
1584000,2069893917,81300115,1.0975515524999999e-11,16105759,1266932,1866839880
1584500,2060545333,81648098,1.102249323e-11,16432459,1266940,1868106820
1585000,2050627709,81316584,1.0977738840000001e-11,16641014,1268624,1869375444
1585500,2083734250,81317577,1.0977872894999999e-11,16673288,1267828,1870643272
1586000,2235714333,81317572,1.097787222e-11,16673113,1266908,1871910180
1586500,2131155458,81651999,1.1023019864999999e-11,16559264,1266036,1873176216
1587000,2224830667,81315621,1.0977608834999999e-11,16609714,1268152,1874444368
1587500,2272935292,81315876,1.0977643259999998e-11,16618025,1267836,1875712204
1588000,2221687250,81314026,1.097739351e-11,16557888,1268168,1876980372
1588500,2148830000,81650288,1.1022788879999998e-11,16503643,1267380,1878247752
1589000,2052093459,81315455,1.0977586424999997e-11,16604332,1267380,1879515132
1589500,2064137667,81315651,1.0977612885e-11,16610682,1267372,1880782504
1590000,2038603958,81310286,1.0976888609999999e-11,16436325,1268524,1882051028
1590500,2051434500,81302895,1.0975890825e-11,16196125,1267820,1883318848
1591000,2055772708,81645994,1.1022209189999999e-11,16364084,1268260,1884587108
1591500,2055649042,81297259,1.0975129964999998e-11,16012950,1267712,1885854820
1592000,2050236250,81312998,1.097725473e-11,16524466,1267836,1887122656
1592500,2053114500,81314428,1.097744778e-11,16570948,1267828,1888390484
1593000,2051959750,81652884,1.1023139339999998e-11,16588018,1268192,1889658676
1593500,2051752959,81311357,1.0977033194999999e-11,16471128,1266492,1890925168
1594000,2055526167,81312868,1.097723718e-11,16520243,1266932,1892192100
1594500,2053031375,81315005,1.0977525675e-11,16589695,1269080,1893461180
1595000,2050994000,81311928,1.0977110279999999e-11,16489698,1266940,1894728120
1595500,2051211750,81654581,1.1023368435e-11,16643149,1267836,1895995956
1596000,2051612084,81309958,1.097684433e-11,16425660,1267364,1897263320
1596500,2072315083,81325984,1.0979007839999998e-11,16946507,1268996,1898532316
1597000,2106471125,81311442,1.097704467e-11,16473910,1267380,1899799696
1597500,2130687375,81310528,1.0976921279999998e-11,16444214,1266932,1901066628
1598000,2602627458,81650733,1.1022848955e-11,16518095,1267296,1902333924
1598500,2394237042,81313060,1.0977263099999999e-11,16526485,1267388,1903601312
1599000,2281279791,81314443,1.0977449804999998e-11,16571428,1267836,1904869148
1599500,2357852875,81648965,1.1022610275e-11,16460638,1266036,1906135184
1600000,2277657417,81313942,1.097738217e-11,16555157,1266824,1907402008
1600500,2068643959,81313744,1.097735544e-11,16548730,1268284,1908670292
1601000,2061911875,81301748,1.0975735979999999e-11,16158846,1268152,1909938444
1601500,2059534958,81300985,1.0975632974999999e-11,16134058,1266940,1911205384
1602000,2072644375,81638372,1.102118022e-11,16116361,1268284,1912473668
1602500,2042964500,81300262,1.097553537e-11,16110552,1267264,1913740932
1603000,2053280000,81300585,1.0975578974999999e-11,16121054,1266940,1915007872
1603500,2049745500,81302432,1.0975828319999999e-11,16181063,1268240,1916276112
1604000,2049930750,81302115,1.0975785525e-11,16170779,1266492,1917542604
1604500,2055330542,81640788,1.1021506379999997e-11,16194884,1268964,1918811568
1605000,2062438625,81312932,1.0977245819999998e-11,16522331,1267820,1920079388
1605500,2051855458,81319103,1.0978078905e-11,16722870,1266492,1921345880
1606000,2057989000,81316215,1.0977689025e-11,16629034,1268260,1922614140
1606500,2265433000,81652972,1.1023151219999999e-11,16590877,1268152,1923882292
1607000,2153118416,81314262,1.0977425369999998e-11,16565553,1266940,1925149232
1607500,2349370459,81314655,1.0977478424999998e-11,16578324,1266908,1926416140
1608000,2336412792,81311622,1.097706897e-11,16479744,1267744,1927683884
1608500,2295180041,81654519,1.1023360064999998e-11,16641158,1267820,1928951704
1609000,2292376542,81318457,1.0977991695e-11,16701903,1267380,1930219084
1609500,2112908833,81315166,1.097754741e-11,16594921,1267720,1931486804
1610000,2062838375,81311475,1.0977049124999999e-11,16474978,1266912,1932753716
1610500,2052024791,81648901,1.1022601635e-11,16458568,1267736,1934021452
1611000,2052801042,81300965,1.0975630274999999e-11,16133414,1267348,1935288800
1611500,2052860875,81314013,1.0977391755e-11,16557465,1268152,1936556952
1612000,2052948416,81317072,1.0977804719999998e-11,16656884,1268260,1937825212
1612500,2051977917,81316832,1.097777232e-11,16649094,1267380,1939092592
1613000,2051102542,81651407,1.1022939944999999e-11,16539988,1267704,1940360296
1613500,2052824583,81315582,1.097760357e-11,16608465,1267828,1941628124
1614000,2051995667,81316815,1.0977770025e-11,16648522,1267372,1942895496
1614500,2051971083,81315227,1.0977555644999998e-11,16596907,1268192,1944163688
1615000,2047806542,81314031,1.0977394185e-11,16558042,1266904,1945430592
1615500,2052593000,81656003,1.1023560405e-11,16689391,1267828,1946698420
1616000,2047438083,81316147,1.0977679844999999e-11,16626814,1267356,1947965776
1616500,2068736084,81314498,1.097745723e-11,16573212,1268608,1949234384
1617000,2105524209,81307516,1.097651466e-11,16346324,1268640,1950503024
1617500,2232082292,81633242,1.102048767e-11,15949645,1267388,1951770412
1618000,2646566917,81297791,1.0975201784999999e-11,16030237,1267736,1953038148
1618500,2284077042,81299505,1.0975433175e-11,16085953,1267364,1954305512
1619000,2229578750,81316092,1.0977672419999999e-11,16625045,1267348,1955572860
1619500,2203425875,81651867,1.1023002044999999e-11,16554937,1266476,1956839336
1620000,2067747167,81312889,1.0977240015e-11,16520919,1268176,1958107512
1620500,2071668833,81315989,1.0977658514999999e-11,16621686,1266484,1959373996
1621000,2074107583,81317654,1.097788329e-11,16675777,1267364,1960641360
1621500,2073277708,81653854,1.102327029e-11,16619535,1267296,1961908656
1622000,2058546959,81311803,1.0977093405e-11,16485618,1266908,1963175564
1622500,2062851833,81312325,1.0977163874999999e-11,16502608,1266940,1964442504
1623000,2055472542,81317653,1.0977883154999998e-11,16675762,1267388,1965709892
1623500,2061439208,81315590,1.0977604649999999e-11,16608696,1268068,1966977960
1624000,2065804500,81635625,1.1020809374999999e-11,16027076,1267348,1968245308
1624500,107305155833,436973757,5.8991457195e-11,16115275,-94752016,1873493292
1625000,2059385334,81651189,1.1022910514999999e-11,16144580,1266940,1874760232
1625500,2142351750,81315104,1.0977539039999999e-11,16592906,1268156,1876028388
1626000,2378070333,81305438,1.097623413e-11,16278763,1266468,1877294856
1626500,2113185083,81313336,1.0977300359999998e-11,16535454,1267380,1878562236
1627000,2100755792,81665396,1.1024828459999998e-11,16606287,1268604,1879830840
1627500,2263804333,81316235,1.0977691725e-11,16629671,1267388,1881098228
1628000,2243718875,81314512,1.097745912e-11,16573668,1268632,1882366860
1628500,2097352750,81311420,1.09770417e-11,16473190,1267328,1883634188
1629000,2069355916,81664454,1.102470129e-11,16575682,1267364,1884901552
1629500,2064399375,81312801,1.0977228134999999e-11,16518059,1268604,1886170156
1630000,2053514375,81323265,1.0978640774999999e-11,16858162,1267736,1887437892
1630500,2065497458,81322750,1.0978571249999998e-11,16841424,1266932,1888704824
1631000,2059754750,81288674,1.0973970989999999e-11,15733930,1266460,1889971284
1631500,2048484125,81636979,1.1020992164999998e-11,15682737,1266492,1891237776
1632000,2049162542,81301189,1.0975660514999999e-11,16140667,1267708,1892505484
1632500,2050834709,81301167,1.0975657545e-11,16139954,1266940,1893772424
1633000,2077522458,81305024,1.0976178239999998e-11,16265308,1267836,1895040260
1633500,2061129792,81304681,1.0976131934999998e-11,16254161,1268176,1896308436
1634000,2063798333,81652184,1.1023044839999998e-11,16176918,1267388,1897575824
1634500,2523457209,81305004,1.097617554e-11,16264650,1267364,1898843188
1635000,2392406709,81302684,1.097586234e-11,16189284,1268276,1900111464
1635500,2408355875,81302992,1.0975903919999999e-11,16199295,1268632,1901380096
1636000,2291495416,81653940,1.10232819e-11,16233998,1266916,1902647012
1636500,2241318959,81301390,1.097568765e-11,16147200,1267720,1903914732
1637000,2359994583,81300516,1.0975569659999999e-11,16118806,1268156,1905182888
1637500,2064784208,81301417,1.0975691295e-11,16148090,1267372,1906450260
1638000,2061963875,81302174,1.0975793489999998e-11,16172680,1268184,1907718444
1638500,2058311500,81314928,1.0977515279999998e-11,16587213,1266940,1908985384
1639000,2054602792,81317157,1.0977816194999999e-11,16659655,1267388,1910252772
1639500,2055369917,81315879,1.0977643664999998e-11,16618094,1268184,1911520956
1640000,2062741000,81664753,1.1024741655e-11,16585415,1266468,1912787424
1640500,2048052000,81316311,1.0977701984999998e-11,16632146,1267372,1914054796
1641000,2056505666,81319504,1.0978133039999999e-11,16735924,1267364,1915322160
1641500,2059837625,81314265,1.0977425774999998e-11,16565657,1267744,1916589904
1642000,2064054792,81314398,1.0977443729999997e-11,16569958,1267380,1917857284
1642500,2063024375,81663544,1.1024578439999998e-11,16546102,1267388,1919124672
1643000,2057417083,81316144,1.0977679439999999e-11,16626707,1268192,1920392864
1643500,2054742333,81306246,1.0976343209999999e-11,16305032,1268548,1921661412
1644000,2025107583,81288206,1.0973907809999999e-11,15718718,1267388,1922928800
1644500,2436842167,81284723,1.0973437604999999e-11,15605537,1266940,1924195740
1645000,2418975500,81298331,1.0975274685e-11,16047797,1268160,1925463900
1645500,2302666834,81295823,1.0974936104999998e-11,15966291,1266912,1926730812
1646000,2068138417,81302329,1.0975814414999999e-11,16177736,1267356,1927998168
1646500,2385767042,81649637,1.1022700995e-11,16094145,1268176,1929266344
1647000,2052110792,81298283,1.0975268204999999e-11,16046218,1267372,1930533716
1647500,2050753375,81301685,1.0975727475e-11,16156803,1267836,1931801552
1648000,2059811250,81301513,1.0975704255e-11,16151221,1266932,1933068484
1648500,2056072500,81299095,1.0975377825e-11,16072607,1268616,1934337100
1649000,2064212167,81650736,1.102284936e-11,16129844,1266940,1935604040
1649500,2049685584,81301972,1.0975766219999999e-11,16166106,1266940,1936870980
1650000,2051547584,81301713,1.0975731255e-11,16157713,1269420,1938140400
1650500,2050477042,81285943,1.0973602304999999e-11,15645182,1266900,1939407300
1651000,2060425250,81650661,1.1022839235e-11,16127419,1266460,1940673760
1651500,2058250625,81301406,1.097568981e-11,16147737,1269088,1941942848
1652000,2053293000,81300942,1.0975627169999999e-11,16132657,1266492,1943209340
1652500,2058498959,81301334,1.097568009e-11,16145395,1268640,1944477980
1653000,2196658625,81300264,1.0975535639999997e-11,16110609,1267364,1945745344
1653500,2153455500,81651064,1.1022893639999998e-11,16140517,1266940,1947012284
1654000,2311404917,81298757,1.0975332195e-11,16061645,1266036,1948278320
1654500,2324839625,81298611,1.0975312484999998e-11,16056897,1268168,1949546488
1655000,2210766916,81298561,1.0975305734999999e-11,16055267,1266932,1950813420
1655500,2321997959,81647423,1.1022402105e-11,16022184,1266924,1952080344
1656000,2055733042,81301186,1.0975660109999999e-11,16140585,1266900,1953347244
1656500,2064460042,81298716,1.097532666e-11,16060316,1268524,1954615768
1657000,2066204334,81286956,1.0973739059999998e-11,15678089,1266476,1955882244
1657500,2052599125,81650972,1.102288122e-11,16137526,1268284,1957150528
1658000,2053467166,81298548,1.097530398e-11,16054834,1268160,1958418688
1658500,2076695792,81297788,1.0975201379999999e-11,16030131,1266492,1959685180
1659000,2055223542,81300613,1.0975582754999998e-11,16121960,1266940,1960952120
1659500,2051731375,81299782,1.0975470569999999e-11,16094955,1266036,1962218156
1660000,2062728792,81649053,1.1022622154999998e-11,16075148,1267736,1963485892
1660500,2053139125,81304131,1.0976057685e-11,16236289,1267364,1964753256
1661000,2058328792,81304393,1.0976093055e-11,16244820,1267348,1966020604
1661500,2061968750,81299551,1.0975439384999998e-11,16087442,1267264,1967287868
1662000,2061908875,81298894,1.097535069e-11,16066099,1266940,1968554808
1662500,2057931833,81651448,1.1022945479999998e-11,16152977,1266940,1969821748
1663000,2053069333,81299337,1.0975410495e-11,16080482,1266932,1971088680
1663500,2058864208,81287953,1.0973873655e-11,15710499,1268988,1972357668
1664000,2197569042,81301688,1.097572788e-11,16156877,1267372,1973625040
1664500,2465838584,81651730,1.1022983549999998e-11,16162173,1266492,1974891532
1665000,2367995583,81287611,1.0973827484999999e-11,15699395,1268168,1976159700
1665500,2254988000,81288336,1.097392536e-11,15722952,1267828,1977427528
1666000,2240288958,81304222,1.097606997e-11,16239248,1267364,1978694892
1666500,2224702167,81651297,1.1022925095e-11,16148080,1266484,1979961376
1667000,2058741125,81300839,1.0975613265e-11,16129299,1267736,1981229112
1667500,2056099875,81302353,1.0975817654999998e-11,16178516,1268284,1982497396
1668000,2060607459,81301481,1.0975699934999999e-11,16150184,1266484,1983763880
1668500,2068034042,81654348,1.1023336979999999e-11,16247247,1268176,1985032056
1669000,2056717042,81301877,1.0975753394999998e-11,16163039,1267828,1986299884
1669500,2063138917,81301104,1.0975649039999998e-11,16137905,1268548,1987568432
1670000,2050819583,81289188,1.097404038e-11,15750664,1267828,1988836260
1670500,2053614500,81291892,1.097440542e-11,15838518,1267380,1990103640
1671000,2050742041,81644801,1.1022048134999998e-11,15936973,1267364,1991371004
1671500,2051374750,81296942,1.0975087169999999e-11,16002654,1268192,1992639196
1672000,2051889833,81300312,1.0975542119999998e-11,16112180,1267360,1993906556
1672500,2058874833,81301190,1.0975660649999998e-11,16140696,1266932,1995173488
1673000,2067955416,81299848,1.097547948e-11,16097111,1266940,1996440428
1673500,2052059000,81651164,1.1022907139999998e-11,16143771,1267744,1997708172
1674000,2247026000,81302178,1.097579403e-11,16172812,1266940,1998975112
1674500,2268948334,81302996,1.097590446e-11,16199400,1267388,2000242500
1675000,2290592666,81301268,1.0975671179999998e-11,16143252,1266816,2001509316
1675500,2261693333,81650931,1.1022875684999999e-11,16136190,1268724,2002778040
1676000,2277092291,81304166,1.0976062409999999e-11,16237444,1267356,2004045396
1676500,2185210875,81287482,1.097381007e-11,15695199,1268540,2005313936
1677000,2070637167,81286860,1.09737261e-11,15674974,1266940,2006580876
1677500,2074915916,81650542,1.1022823169999998e-11,16123552,1266464,2007847340
1678000,2060883750,81302659,1.0975858965e-11,16188450,1266932,2009114272
1678500,107307503625,448852001,6.0595020135e-11,16187388,-73337248,1935777024
1679000,2055050125,81660213,1.1024128755e-11,16132823,1267356,1937044380
1679500,2052681083,81302052,1.0975777019999998e-11,16168709,1267836,1938312216
1680000,2061213625,81303375,1.0975955625e-11,16211711,1268192,1939580408
1680500,2094380834,81301252,1.0975669019999999e-11,16142745,1266940,1940847348
1681000,2055307542,81303551,1.0975979385e-11,16217431,1266908,1942114256
1681500,2057356958,81660933,1.1024225955e-11,16156222,1266932,1943381188
1682000,2050657042,81302410,1.097582535e-11,16180348,1268184,1944649372
1682500,2107610834,81300978,1.0975632029999998e-11,16133807,1266932,1945916304
1683000,2523289292,81290092,1.0974162419999998e-11,15780042,1269436,1947185740
1683500,2365486542,81646070,1.102221945e-11,15673168,1266468,1948452208
1684000,2382963625,81300394,1.097555319e-11,16114835,1267372,1949719580
1684500,2127436292,81301439,1.0975694265e-11,16148796,1266940,1950986520
1685000,2353770208,81302976,1.097590176e-11,16198753,1267720,1952254240
1685500,2146835708,81305893,1.0976295555e-11,16293564,1266908,1953521148
1686000,2074267542,81304523,1.0976110604999999e-11,16249016,1267356,1954788504
1686500,2075515583,81301154,1.0975655789999999e-11,16139553,1266460,1956054964
1687000,2055357666,81300477,1.0975564395e-11,16117529,1266908,1957321872
1687500,2070688708,81661189,1.1024260515e-11,16164522,1267344,1958589216
1688000,2059334375,81302009,1.0975771215e-11,16167326,1266916,1959856132
1688500,2058185250,81299755,1.0975466924999999e-11,16094083,1266468,1961122600
1689000,2069307750,81301733,1.0975733955e-11,16158363,1267364,1962389964
1689500,2064682333,81302476,1.097583426e-11,16182523,1267332,1963657296
1690000,2061472667,81661963,1.1024365004999999e-11,16189681,1266460,1964923756
1690500,2071865334,81303513,1.0975974254999998e-11,16216202,1269504,1966193260
1691000,2065338125,81285615,1.0973558024999998e-11,15634513,1266460,1967459720
1691500,2057176167,81285925,1.0973599875e-11,15644597,1268192,1968727912
1692000,2230742500,81651108,1.1022899579999999e-11,15836900,1267800,1969995712
1692500,2392430250,81302796,1.0975877459999998e-11,16192918,1266044,1971261756
1693000,2235748917,81301995,1.0975769325e-11,16166876,1266476,1972528232
1693500,2247950709,81302572,1.097584722e-11,16185622,1267744,1973795976
1694000,2235456250,81661649,1.1024322615e-11,16179471,1267808,1975063784
1694500,2508826375,81301570,1.0975711949999999e-11,16153070,1266044,1976329828
1695000,2076217666,81305194,1.0976201189999999e-11,16270827,1269088,1977598916
1695500,2086621083,81302728,1.0975868279999999e-11,16190701,1267380,1978866296
1696000,2049700667,81302597,1.0975850595e-11,16186432,1267364,1980133660
1696500,2041270417,81656781,1.1023665435e-11,16021275,1268168,1981401828
1697000,2052935000,81296403,1.0975014404999998e-11,15985132,1268640,1982670468
1697500,2053118209,81284695,1.0973433825e-11,15604613,1266932,1983937400
1698000,2052625750,81284274,1.0973376989999998e-11,15590928,1268164,1985205564
1698500,2052147750,81645431,1.1022133184999999e-11,15652404,1267388,1986472952
1699000,2051811167,81300142,1.0975519169999998e-11,16106644,1266940,1987739892
1699500,2053401542,81299137,1.0975383495e-11,16073997,1266492,1989006384
1700000,2052595084,81299367,1.0975414544999998e-11,16081473,1268184,1990274568
1700500,2052225291,81301733,1.0975733955e-11,16158355,1267828,1991542396
1701000,2052984750,81645923,1.1022199605e-11,15668389,1267264,1992809660
1701500,2050855833,81284705,1.0973435174999999e-11,15604936,1266036,1994075696
1702000,2059354875,81302030,1.0975774049999999e-11,16168013,1267828,1995343524
1702500,2138402417,81301977,1.0975766894999998e-11,16166289,1267388,1996610912
1703000,2512926667,81303067,1.0975914044999999e-11,16201701,1269056,1997879968
1703500,2368700375,81298670,1.0975320449999999e-11,16058800,1266932,1999146900
1704000,2245931167,81301452,1.0975696019999998e-11,16149208,1267388,2000414288
1704500,2175864583,81302462,1.0975832369999998e-11,16182045,1267388,2001681676
1705000,2242922208,81657414,1.102375089e-11,16041832,1267264,2002948940
1705500,2184702625,81302713,1.0975866254999999e-11,16190198,1267380,2004216320
1706000,2055734500,81301977,1.0975766894999998e-11,16166301,1266916,2005483236
1706500,2055260708,81298546,1.097530371e-11,16054780,1268948,2006752184
1707000,2062694584,81287688,1.097383788e-11,15701893,1266932,2008019116
1707500,2046010834,81645106,1.102208931e-11,15641833,1266940,2009286056
1708000,2052274958,81288326,1.097392401e-11,15722616,1268160,2010554216
1708500,2048176792,81285657,1.0973563695e-11,15635888,1266916,2011821132
1709000,2057329875,81287899,1.0973866364999999e-11,15708736,1266036,2013087168
1709500,2063038125,81286916,1.097373366e-11,15676795,1267380,2014354548
1710000,2061320000,81647063,1.1022353505e-11,15705447,1268168,2015622716
1710500,2050974500,81285885,1.0973594474999998e-11,15643314,1266916,2016889632
1711000,2063728333,81289314,1.0974057389999999e-11,15754738,1267812,2018157444
1711500,2052949750,81287260,1.0973780099999998e-11,15687981,1267728,2019425172
1712000,2057767500,81658186,1.102385511e-11,16066916,1266484,2020691656
1712500,2178591917,81303863,1.0976021505e-11,16227571,1267836,2021959492
1713000,2415157959,81303943,1.0976032304999999e-11,16230176,1266940,2023226432
1713500,2218650625,81301447,1.0975695344999999e-11,16149062,1267720,2024494152
1714000,2205361375,81662111,1.1024384984999998e-11,16194508,1266476,2025760628
1714500,2253711250,81302180,1.0975794299999998e-11,16172868,1266940,2027027568
1715000,2156302417,81303921,1.0976029335e-11,16229475,1267380,2028294948
1715500,2052158750,81302762,1.097587287e-11,16191810,1267712,2029562660
1716000,2060418625,81662247,1.1024403344999999e-11,16198912,1266916,2030829576
1716500,2051230750,81301690,1.0975728149999998e-11,16156973,1268168,2032097744
1717000,2058034250,81301824,1.097574624e-11,16161301,1268632,2033366376
1717500,2051533375,81300537,1.0975572495e-11,16119490,1266932,2034633308
1718000,2051421625,81301294,1.0975674689999998e-11,16144092,1268184,2035901492
1718500,2058374959,81674250,1.102602375e-11,16589033,1267804,2037169296
1719000,2056319000,81308639,1.0976666265e-11,16382800,1266020,2038435316
1719500,2051122250,81317889,1.0977915014999998e-11,16683436,1267380,2039702696
1720000,129497311417,458998999,6.1964864865e-11,16642160,-56063160,1983639536
1720500,2116867916,81319382,1.0978116569999998e-11,16731962,1266932,1984906468
1721000,2150132792,81320458,1.097826183e-11,16766924,1267332,1986173800
1721500,2186482125,81315462,1.097758737e-11,16604555,1267712,1987441512
1722000,2054201541,81681277,1.1026972395e-11,16585449,1266476,1988707988
1722500,2072066208,81318894,1.0978050689999998e-11,16716082,1267388,1989975376
1723000,2054491000,81318133,1.0977947954999998e-11,16691357,1266940,1991242316
1723500,2070440834,81314379,1.0977441164999998e-11,16569354,1269428,1992511744
1724000,2056177333,81668369,1.1025229815e-11,16165940,1267364,1993779108
1724500,2068438042,81298736,1.0975329359999999e-11,16060970,1265596,1995044704
1725000,2056161625,81300800,1.0975607999999998e-11,16128037,1267720,1996312424
1725500,2060927542,81308076,1.097659026e-11,16364487,1267836,1997580260
1726000,2049186542,81317561,1.0977870734999998e-11,16672764,1265572,1998845832
1726500,2049595542,81682912,1.1027193119999999e-11,16638588,1267372,2000113204
1727000,2055858250,81312660,1.09772091e-11,16513505,1266368,2001379572
1727500,2130004834,81317274,1.097783199e-11,16663449,1268268,2002647840
1728000,2275974291,81316971,1.0977791085e-11,16653583,1267388,2003915228
1728500,2194330417,81684294,1.102737969e-11,16683478,1268192,2005183420
1729000,2719423375,81315958,1.097765433e-11,16620664,1267388,2006450808
1729500,2354530667,81317086,1.0977806609999997e-11,16657331,1266932,2007717740
1730000,2184756042,81316976,1.0977791759999998e-11,16653766,1266492,2008984232
1730500,2064516125,81675995,1.1026259325e-11,16413766,1267744,2010251976
1731000,2066631625,81302804,1.097587854e-11,16193164,1266468,2011518444
1731500,2064365167,81313749,1.0977356114999999e-11,16548878,1266932,2012785376
1732000,2066234000,81317285,1.0977833475e-11,16663787,1266832,2014052208
1732500,2063896792,81683586,1.102728411e-11,16660471,1266940,2015319148
1733000,2063016500,81316907,1.0977782445e-11,16651498,1267836,2016586984
1733500,2069483000,81319187,1.0978090244999998e-11,16725611,1268152,2017855136
1734000,2052752625,81316640,1.0977746399999998e-11,16642855,1266932,2019122068
1734500,2051004917,81316540,1.0977732899999999e-11,16639592,1267380,2020389448
1735000,2050119792,81682418,1.1027126429999997e-11,16622526,1266468,2021655916
1735500,2074438625,81320536,1.0978272359999998e-11,16769438,1266476,2022922392
1736000,2055029125,81319608,1.097814708e-11,16739292,1266900,2024189292
1736500,2236028542,81317635,1.0977880725000001e-11,16675174,1266492,2025455784
1737000,2187291250,81315394,1.0977578189999999e-11,16602345,1268192,2026723976
1737500,2478923792,81678526,1.1026601009999999e-11,16496043,1267296,2027991272
1738000,2273405583,81309879,1.0976833665e-11,16423105,1266924,2029258196
1738500,2252827750,81318624,1.097801424e-11,16707317,1266940,2030525136
1739000,2166716500,81683826,1.1027316509999998e-11,16668276,1268608,2031793744
1739500,2122595666,81316677,1.0977751394999998e-11,16644045,1267836,2033061580
1740000,2061437042,81318988,1.0978063379999998e-11,16719144,1267828,2034329408
1740500,2062366042,81320840,1.09783134e-11,16779340,1268616,2035598024
1741000,2053710916,81318547,1.0978003845e-11,16704815,1266916,2036864940
1741500,2069637791,81681826,1.102704651e-11,16603274,1267264,2038132204
1742000,2054993875,81313604,1.0977336539999998e-11,16544154,1266916,2039399120
1742500,2071199834,81316554,1.0977734789999999e-11,16640028,1267364,2040666484
1743000,2064104500,81317980,1.09779273e-11,16686380,1266932,2041933416
1743500,2051288041,81317123,1.0977811604999999e-11,16658544,1268184,2043201600
1744000,2051701667,81677621,1.1026478835e-11,16466613,1267744,2044469344
1744500,2052809459,81306052,1.097631702e-11,16298740,1266492,2045735836
1745000,2059225125,81315924,1.0977649739999998e-11,16619554,1266940,2047002776
1745500,2051249125,81319228,1.0978095779999999e-11,16726930,1267360,2048270136
1746000,2071187625,81669045,1.1025321074999998e-11,16187910,1266900,2049537036
1746500,2272753542,81301345,1.0975681575e-11,16145764,1267264,2050804300
1747000,2357861958,81313434,1.097731359e-11,16538627,1266892,2052071192
1747500,2557586708,81316413,1.0977715755e-11,16635462,1267372,2053338564
1748000,2244041417,81683087,1.1027216745e-11,16644278,1267388,2054605952
1748500,2265186459,81317329,1.0977839414999998e-11,16665226,1268640,2055874592
1749000,2240189083,81316486,1.097772561e-11,16637833,1268284,2057142876
1749500,2080667875,81313908,1.0977377579999998e-11,16554050,1267364,2058410240
1750000,2073592084,81680172,1.1026823219999999e-11,16549516,1267280,2059677520
1750500,2061481250,81316301,1.0977700634999998e-11,16631835,1266932,2060944452
1751000,2053966083,81304868,1.0976157179999998e-11,16260260,1269420,2062213872
1751500,2052226750,81299523,1.0975435604999999e-11,16086521,1267380,2063481252
1752000,129556845875,466154655,6.2930878425e-11,16559151,-42937184,2020544068
1752500,2164504083,81313657,1.0977343694999999e-11,16545902,1266044,2021810112
1753000,2113333167,81313125,1.0977271874999998e-11,16528612,1267736,2023077848
1753500,2273538542,81313813,1.0977364754999998e-11,16550964,1267380,2024345228
1754000,2491525334,81688832,1.1027992319999998e-11,16651554,1269976,2025615204
1754500,2058024125,81313361,1.0977303734999999e-11,16536271,1267380,2026882584
1755000,2063812375,81315252,1.0977559019999998e-11,16597735,1267380,2028149964
1755500,2058713875,81318502,1.0977997769999999e-11,16703350,1268192,2029418156
1756000,2050841125,81688127,1.1027897145e-11,16628635,1266468,2030684624
1756500,2036960458,81314530,1.0977461549999999e-11,16574267,1268184,2031952808
1757000,2049867709,81305160,1.09761966e-11,16269752,1266372,2033219180
1757500,2048832500,81298962,1.0975359869999998e-11,16068292,1266932,2034486112
1758000,2051564458,81306242,1.097634267e-11,16304904,1266492,2035752604
1758500,2055596125,81687182,1.1027769569999999e-11,16597930,1268608,2037021212
1759000,2052044875,81314527,1.0977461144999999e-11,16574161,1266932,2038288144
1759500,2052766125,81315517,1.0977594794999998e-11,16606330,1267828,2039555972
1760000,2047306042,81316360,1.09777086e-11,16633733,1268632,2040824604
1760500,2063680209,81319342,1.0978111169999998e-11,16730656,1267032,2042091636
1761000,2338439917,81317645,1.0977882074999998e-11,16675490,1267356,2043358992
1761500,2344806708,81314754,1.0977491789999999e-11,16581549,1268624,2044627616
1762000,2295090250,81314321,1.0977433334999999e-11,16567457,1266940,2045894556
1762500,2229749750,81686811,1.1027719484999999e-11,16585866,1266940,2047161496
1763000,2209573834,81315984,1.097765784e-11,16621522,1268176,2048429672
1763500,2307932292,81312472,1.097718372e-11,16507382,1267364,2049697036
1764000,2068584459,81308110,1.097659485e-11,16365615,1268192,2050965228
1764500,2064124500,81299743,1.0975465304999998e-11,16093687,1267380,2052232608
1765000,2072682000,81311498,1.097705223e-11,16475734,1268192,2053500800
1765500,2089207334,81317808,1.097790408e-11,16680801,1267364,2054768164
1766000,2053481958,81316036,1.097766486e-11,16623218,1266468,2056034632
1766500,2056428500,81314265,1.0977425774999998e-11,16565654,1267728,2057302360
1767000,2064702542,81681754,1.102703679e-11,16421518,1266044,2058568404
1767500,2064464041,81314270,1.0977426449999998e-11,16565814,1267348,2059835752
1768000,2069631583,81317850,1.0977909749999997e-11,16682174,1267388,2061103140
1768500,2063624333,81315268,1.0977561179999997e-11,16598232,1266940,2062370080
1769000,2051216416,81315936,1.097765136e-11,16619968,1268192,2063638272
1769500,2064037166,81686856,1.102772556e-11,16587317,1267360,2064905632
1770000,2059918041,81315488,1.097759088e-11,16605387,1266940,2066172572
1770500,2167215666,81318685,1.0978022474999999e-11,16709296,1267388,2067439960
1771000,2308268333,81317396,1.0977848459999999e-11,16667389,1268160,2068708120
1771500,2163890875,81670319,1.1025493065e-11,16049871,1266044,2069974164
1772000,2236149208,81297673,1.0975185855e-11,16026397,1267744,2071241908
1772500,2154505667,81304832,1.0976152319999999e-11,16259093,1267820,2072509728
1773000,2156153000,81315900,1.0977646499999999e-11,16618770,1266940,2073776668
1773500,2059063875,81685668,1.1027565179999999e-11,16548727,1268152,2075044820
1774000,2050826375,81315982,1.0977657569999998e-11,16621454,1267380,2076312200
1774500,2065586958,81314673,1.0977480855e-11,16578925,1266476,2077578676
1775000,2053044791,81315100,1.09775385e-11,16592774,1266932,2078845608
1775500,2079928375,81317493,1.0977861555e-11,16670546,1267264,2080112872
1776000,2053654375,81682346,1.1027116709999999e-11,16440740,1267364,2081380236
1776500,2049980041,81314104,1.097740404e-11,16560410,1269088,2082649324
1777000,129583495166,471415359,6.3641073465e-11,16771070,-33271028,2049378296
1777500,2324352875,81320812,1.0978309619999998e-11,16778445,1268632,2050646928
1778000,2090515833,81312496,1.097718696e-11,16508152,1268640,2051915568
1778500,2061369625,81691032,1.1028289319999999e-11,16581174,1266924,2053182492
1779000,2051195125,81316331,1.0977704684999999e-11,16632779,1267380,2054449872
1779500,2063713000,81317688,1.097788788e-11,16676893,1268632,2055718504
1780000,2059138333,81315019,1.0977527565e-11,16590149,1268284,2056986788
1780500,2064509958,81700172,1.1029523219999998e-11,16878237,1267388,2058254176
1781000,2052273042,81302220,1.0975799699999999e-11,16174186,1266916,2059521092
1781500,2054288584,81299250,1.0975398749999999e-11,16077647,1267704,2060788796
1782000,2062422042,81314480,1.0977454799999998e-11,16572649,1266476,2062055272
1782500,2072860708,81315556,1.097760006e-11,16607608,1266908,2063322180
1783000,2053268416,81694144,1.1028709439999998e-11,16682320,1266476,2064588656
1783500,2068269500,81317720,1.0977892199999999e-11,16677945,1268608,2065857264
1784000,2263688875,81313749,1.0977356114999999e-11,16548893,1266020,2067123284
1784500,2344929834,81317543,1.0977868305000001e-11,16672169,1267836,2068391120
1785000,2247279500,81690099,1.1028163365e-11,16550863,1266924,2069658044
1785500,2379757208,81320744,1.097830044e-11,16776219,1266484,2070924528
1786000,2331790542,81316591,1.0977739784999998e-11,16641250,1267364,2072191892
1786500,2170106542,81314671,1.0977480585e-11,16578842,1268192,2073460084
1787000,2168977708,81688298,1.102792023e-11,16492339,1267720,2074727804
1787500,2090374875,81304033,1.0976044455e-11,16233119,1267388,2075995192
1788000,2055269333,81303446,1.0975965209999999e-11,16214037,1267380,2077262572
1788500,2054267708,81305056,1.097618256e-11,16266366,1268160,2078530732
1789000,2058283875,81303374,1.0975955489999999e-11,16211687,1266484,2079797216
1789500,2056584125,81678335,1.1026575225e-11,16168524,1266484,2081063700
1790000,2063190625,81303217,1.0975934294999998e-11,16206584,1266924,2082330624
1790500,2070109291,81303644,1.0975991939999999e-11,16220484,1266940,2083597564
1791000,2056353167,81300980,1.09756323e-11,16133871,1267348,2084864912
1791500,2055607500,81675379,1.1026176164999999e-11,16072454,1268192,2086133104
1792000,2073767250,81313419,1.0977311565e-11,16538155,1266468,2087399572
1792500,2063789792,81315629,1.0977609914999998e-11,16609977,1267828,2088667400
1793000,2048506250,81317115,1.0977810524999999e-11,16658264,1268192,2089935592
1793500,2056037875,81312597,1.0977200594999999e-11,16511431,1267388,2091202980
1794000,2125210666,81692498,1.1028487229999998e-11,16628831,1267828,2092470808
1794500,2543809583,81316284,1.0977698339999999e-11,16631283,1268640,2093739448
1795000,2307197917,81314748,1.0977490979999999e-11,16581357,1267380,2095006828
1795500,2221438083,81315736,1.097762436e-11,16613458,1266484,2096273312
1796000,130075241625,475646526,6.421228100999999e-11,16671547,-24981264,2071292048
1796500,2051553583,81311242,1.0977017669999999e-11,16467391,1268168,2072560216
1797000,2056715709,81690142,1.1028169169999999e-11,16447206,1266824,2073827040
1797500,2054272500,81300194,1.097552619e-11,16108352,1268276,2075095316
1798000,2049866667,81300545,1.0975573575e-11,16119760,1266932,2076362248
1798500,2051093125,81314010,1.097739135e-11,16557363,1268184,2077630432
1799000,2052059875,81684338,1.102738563e-11,16258578,1267804,2078898236
1799500,2049393667,81315280,1.0977562799999999e-11,16598625,1266476,2080164712
1800000,2052103042,81314976,1.097752176e-11,16588750,1267720,2081432432
1800500,2051340541,81319243,1.0978097805e-11,16727439,1267836,2082700268
1801000,2050999458,81312977,1.0977251894999999e-11,16523784,1267720,2083967988
1801500,2074768041,81692973,1.1028551354999998e-11,16539213,1267836,2085235824
1802000,2226667000,81312632,1.0977205319999999e-11,16512562,1266940,2086502764
1802500,2348810500,81313965,1.0977385275e-11,16555894,1266492,2087769256
1803000,2337963917,81312022,1.097712297e-11,16492748,1266816,2089036072
1803500,2152669458,81687400,1.1027799e-11,16358107,1268640,2090304712
1804000,2129030292,81299257,1.0975399695e-11,16077896,1267388,2091572100
1804500,2256031125,81298156,1.0975251059999999e-11,16042099,1266932,2092839032
1805000,2202862208,81298856,1.0975345559999998e-11,16064874,1268608,2094107640
1805500,2052990958,81698764,1.1029333139999998e-11,16727418,1266492,2095374132
1806000,2072248916,81316203,1.0977687404999998e-11,16628621,1267812,2096641944
1806500,2052604125,81311711,1.0977080985e-11,16482632,1266848,2097908792
1807000,2051071250,81311796,1.097709246e-11,16485396,1266932,2099175724
1807500,2051486042,81314000,1.0977389999999998e-11,16557019,1267364,2100443088
1808000,2071716459,81695353,1.1028872654999998e-11,16616574,1267388,2101710476
1808500,2073987333,81315796,1.0977632459999999e-11,16615404,1267712,2102978188
1809000,2050059583,81313168,1.097727768e-11,16530007,1266932,2104245120
1809500,2051777375,81315962,1.097765487e-11,16620788,1266940,2105512060
1810000,2051793208,81695489,1.1028891015e-11,16620993,1267388,2106779448
1810500,2051360625,81304997,1.0976174595e-11,16264453,1268996,2108048444
1811000,129497641042,478859887,6.464608474499999e-11,16656313,-19456284,2088592160
1811500,2126990500,81315316,1.0977567659999998e-11,16599798,1267736,2089859896
1812000,2117565792,81313283,1.0977293204999998e-11,16533717,1266452,2091126348
1812500,2391004917,81697160,1.1029116599999999e-11,16589282,1266932,2092393280
1813000,2138029208,81314372,1.0977440219999999e-11,16569138,1267388,2093660668
1813500,2054926541,81316857,1.0977775695e-11,16649887,1268732,2094929400
1814000,2059505084,81314859,1.0977505964999998e-11,16584954,1266940,2096196340
1814500,2057656167,81697576,1.1029172759999998e-11,16602796,1267716,2097464056
1815000,2052203875,81313384,1.0977306839999999e-11,16537031,1267804,2098731860
1815500,2055775583,81317802,1.097790327e-11,16680591,1267388,2099999248
1816000,2056329417,81318859,1.0978045965e-11,16714947,1267356,2101266604
1816500,2060254500,81316257,1.0977694695e-11,16630395,1267720,2102534324
1817000,2062801000,81689147,1.1028034844999998e-11,16328856,1268944,2103803268
1817500,2063443958,81291869,1.0974402314999998e-11,15837786,1266932,2105070200
1818000,2064467916,81300724,1.0975597739999998e-11,16125572,1267356,2106337556
1818500,2060525000,81297930,1.0975220549999998e-11,16034746,1267720,2107605276
1819000,2065340042,81285241,1.0973507534999998e-11,15622373,1268284,2108873560
1819500,2160293250,81673439,1.1025914265e-11,15818337,1267388,2110140948
1820000,2444640041,81299040,1.0975370399999999e-11,16070838,1266492,2111407440
1820500,2393103292,81301421,1.0975691834999997e-11,16148207,1266848,2112674288
1821000,2281631000,81302889,1.0975890014999999e-11,16195941,1267356,2113941644
1821500,2208826708,81299758,1.0975467329999999e-11,16094170,1268160,2115209804
1822000,2452058459,81299855,1.0975480424999998e-11,16097328,1268284,2116478088
1822500,129512854000,481439451,6.499432588499999e-11,16106862,-14621248,2101856840
1823000,2054525250,81297737,1.0975194495e-11,16028488,1268192,2103125032
1823500,2049331250,81295262,1.0974860369999997e-11,15948056,1268616,2104393648
1824000,2064730167,81678196,1.102655646e-11,15908798,1266484,2105660132
1824500,2056094125,81293056,1.0974562559999997e-11,15876354,1267380,2106927512
1825000,2212903958,81283345,1.0973251575e-11,15560737,1268608,2108196120
1825500,2284818583,81286619,1.0973693565e-11,15667147,1266476,2109462596
1826000,2327128125,81302593,1.0975850054999999e-11,16186324,1267812,2110730408
1826500,2179302333,81683606,1.1027286809999999e-11,16084604,1268160,2111998568
1827000,2082613125,81300980,1.09756323e-11,16133875,1267380,2113265948
1827500,2388222375,81299940,1.09754919e-11,16100075,1266932,2114532880
1828000,2198203375,81301969,1.0975765814999999e-11,16166043,1267372,2115800252
1828500,2200693875,81683673,1.1027295854999998e-11,16086797,1268184,2117068436
1829000,2071513250,81299342,1.0975411169999999e-11,16080651,1266476,2118334912
1829500,2060651334,81300739,1.0975599765e-11,16126058,1266932,2119601844
1830000,2060124500,81303544,1.097597844e-11,16217208,1269412,2120871256
1830500,2061196916,81671628,1.1025669779999998e-11,15695335,1266916,2122138172
1831000,2051828375,81290365,1.0974199275e-11,15788889,1266452,2123404624
1831500,129636013500,483334652,6.525017801999999e-11,16108592,-11167256,2112237368
1832000,2486403334,81299497,1.0975432095e-11,16085702,1268160,2113505528
1832500,2287414834,81300156,1.0975521059999998e-11,16107107,1268244,2114773772
1833000,2246274750,81685480,1.1027539799999998e-11,16094374,1266484,2116040256
1833500,2083004584,81301581,1.0975713434999998e-11,16153412,1267744,2117308000
1834000,2301098916,81299697,1.0975459095e-11,16092187,1267388,2118575388
1834500,2065306792,81299217,1.0975394295e-11,16076589,1267380,2119842768
1835000,2061030292,81685031,1.1027479184999999e-11,16079780,1267380,2121110148
1835500,2067491833,81303226,1.0975935509999998e-11,16206894,1268160,2122378308
1836000,2060697500,81302647,1.0975857345e-11,16188053,1266020,2123644328
1836500,2050377583,81302697,1.0975864095e-11,16189693,1268972,2124913300
1837000,2050367667,81298416,1.0975286159999998e-11,16050554,1266924,2126180224
1837500,2055113292,81690953,1.1028278654999998e-11,16272248,1266940,2127447164
1838000,2055143750,81317991,1.0977928785e-11,16686742,1267380,2128714544
1838500,129530438167,484886097,6.5459623095e-11,16688526,-8403536,2120311008
1839000,2283398417,81316239,1.0977692264999999e-11,16629792,1268192,2121579200
1839500,2174403708,81314571,1.0977467084999998e-11,16575602,1266044,2122845244
1840000,2297107291,81702985,1.1029902974999998e-11,16623767,1267812,2124113056
1840500,2256961625,81320116,1.097821566e-11,16755820,1266940,2125379996
1841000,2071712000,81317128,1.0977812279999998e-11,16658699,1266460,2126646456
1841500,2052117125,81314528,1.097746128e-11,16574199,1266932,2127913388
1842000,2055873000,81700741,1.1029600034999999e-11,16550829,1268184,2129181572
1842500,2050905916,81315538,1.097759763e-11,16607007,1268284,2130449856
1843000,2058638250,81314745,1.0977490574999999e-11,16581259,1266468,2131716324
1843500,129583755208,486054895,6.5617410825e-11,16585694,-5638612,2126077712
1844000,2483357667,81300027,1.0975503644999998e-11,16102924,1267360,2127345072
1844500,2256545458,81309714,1.0976811389999999e-11,16417729,1267380,2128612452
1845000,2203529292,81701249,1.1029668614999999e-11,16541373,1267744,2129880196
1845500,2094481541,81319593,1.0978145054999997e-11,16738823,1267388,2131147584
1846000,2223277333,81318559,1.0978005464999999e-11,16705187,1267804,2132415388
1846500,2272242583,81313378,1.0977306029999999e-11,16536818,1267736,2133683124
1847000,2065637125,81701045,1.1029641074999998e-11,16534741,1266932,2134950056
1847500,129496308000,486816041,6.5720165535e-11,16618448,-4259036,2130691020
1848000,2075137625,81318861,1.0978046234999999e-11,16715030,1266932,2131957952
1848500,2060161125,81315886,1.0977644609999999e-11,16618338,1266484,2133224436
1849000,2056343917,81315991,1.0977658784999998e-11,16621738,1267712,2134492148
1849500,2052124875,81703036,1.1029909859999999e-11,16576191,1266468,2135758616
1850000,2050186000,81312257,1.0977154694999998e-11,16500401,1266484,2137025100
1850500,107294298542,486572367,6.5687269545e-11,16438135,-2874828,2134150272
1851000,2060337625,81312733,1.0977218955e-11,16515863,1268144,2135418416
1851500,2152809792,81698767,1.1029333545e-11,16421156,1266900,2136685316
1852000,2287395791,81316482,1.0977725069999998e-11,16637715,1267348,2137952664
1852500,2100906083,81317015,1.0977797025e-11,16655016,1268192,2139220856
1853000,129995158000,488017903,6.588241690499999e-11,16523541,-2186668,2137034188
1853500,2058557250,81707698,1.1030539229999998e-11,16696295,1266940,2138301128
1854000,2061186958,81317970,1.0977925949999999e-11,16686060,1269088,2139570216
1854500,2054221666,81315982,1.0977657569999998e-11,16621458,1267836,2140838052
1855000,107305101459,487641102,6.583154876999999e-11,16625362,-1496552,2139341500
1855500,2054505583,81321745,1.0978435575e-11,16808757,1266492,2140607992
1856000,2057981792,81690777,1.1028254895e-11,16134723,1266460,2141874452
1856500,107496331042,487758925,6.5847454875e-11,16143856,-803420,2141071032
1857000,2269551417,81705616,1.103025816e-11,16608867,1267828,2142338860
1857500,156539273458,490176123,6.6173776605e-11,16592484,-114336,2142224524
1858000,2064733833,81316983,1.0977792704999998e-11,16653967,1268192,2143492716
1858500,107458265375,488290794,6.591925719e-11,16668033,-114372,2143378344
1859000,130149429625,489530654,6.608663829e-11,16632558,576464,2143954808
1859500,107313025917,488625276,6.596441225999999e-11,16642937,576464,2144531272
1860000,107310835292,488771976,6.598421676e-11,16575351,576980,2145108252
1860500,107335318583,488886341,6.5999656035e-11,16727816,576840,2145685092
