Size,Time,Cycles,Price,Instructions,HeapSize,TotalHeapSize
5000,2747200875,17223777,2.3252098949999996e-12,89818904,584008,584636
10000,2387782792,18826842,2.5416236699999997e-12,100883623,605908,1190544
15000,2217125292,19467286,2.6280836099999996e-12,105646807,605628,1796172
20000,2354200458,20072685,2.7098124749999996e-12,109253338,605764,2401936
25000,2198076292,18250158,2.46377133e-12,114166570,2175632,4577568
30000,2675211875,21213476,2.86381926e-12,114223644,-966304,3611264
35000,2107292167,18263823,2.4656161049999998e-12,114636773,2180260,5791524
40000,2436903542,22347435,3.016903725e-12,118939004,-968868,4822656
45000,2046324250,18383018,2.48170743e-12,118465365,2176924,6999580
50000,2836832917,23332068,3.1498291799999995e-12,118824773,-966940,6032640
55000,2117788125,19436396,2.62391346e-12,127767879,2183276,8215916
60000,3216213875,25361512,3.4238041199999993e-12,127687820,-973244,7242672
65000,2121522583,19402437,2.619328995e-12,126604596,2187268,9429940
70000,2097238333,19407561,2.6200207349999997e-12,126830728,2184436,11614376
75000,2375408750,26799469,3.617928315e-12,126221031,-2555064,9059312
80000,2487105625,19426442,2.6225696699999998e-12,127369260,2184340,11243652
85000,2144394875,19418621,2.6215138349999997e-12,127190205,2185448,13429100
90000,2179336542,28292358,3.819468329999999e-12,126553624,-2553852,10875248
95000,2330831750,19463221,2.627534835e-12,128639703,2186968,13062216
100000,2319278750,19401528,2.61920628e-12,126548903,2183996,15246212
105000,2230580583,29858399,4.030883865e-12,129244264,-2554040,12692172
110000,2451594917,19548067,2.6389890449999995e-12,131397188,2186244,14878416
115000,2185135125,19541445,2.638095075e-12,131181976,2187496,17065912
120000,2307752875,19605787,2.646781245e-12,133176462,2185244,19251156
125000,2130400958,31906861,4.307426235e-12,131528485,-4135588,15115568
130000,2980174500,19596433,2.6455184549999996e-12,132969071,2188332,17303900
135000,2286311083,19609554,2.64728979e-12,133395518,2185288,19489188
140000,2520795625,19560376,2.6406507599999998e-12,131797222,2188840,21678028
145000,2184623375,33900833,4.5766124549999995e-12,132006295,-4136996,17541032
150000,2782034500,19544040,2.6384453999999997e-12,131266323,2185648,19726680
155000,2062441166,19579875,2.643283125e-12,132301005,2188284,21914964
160000,2428745750,19565223,2.6413051049999996e-12,131954772,2185324,24100288
165000,2080477458,19528748,2.6363809799999997e-12,130769316,2188276,26288564
170000,2801621416,36389049,4.912521614999999e-12,132450810,-5714940,20573624
175000,2187328125,19567791,2.641651785e-12,131885801,2186456,22760080
180000,2079590500,19531598,2.6367657299999997e-12,130861938,2186628,24946708
185000,2243291416,19598111,2.6457449849999997e-12,133023621,2188220,27134928
190000,2071012166,19696391,2.6590127849999997e-12,136217735,2185748,29320676
195000,2130955792,19694716,2.6587866599999996e-12,136163273,2180896,31501572
200000,3023488833,39522853,5.335585154999999e-12,137867063,-7292972,24208600
205000,2283647834,19695690,2.65891815e-12,136194928,2186592,26395192
210000,2111790500,19716085,2.661671475e-12,136679171,2186216,28581408
215000,2142740750,19700573,2.6595773549999998e-12,136353634,2183740,30765148
220000,3046230208,19690030,2.65815405e-12,136010966,2183716,32948864
225000,2070377125,19706751,2.660411385e-12,136554411,2182420,35131284
230000,2949836459,19720670,2.66229045e-12,136828191,2187540,37318824
235000,2208570834,42928427,5.795337644999999e-12,136092875,-8872572,28446252
240000,2103506208,19715380,2.6615762999999995e-12,136834853,2185368,30631620
245000,2121445916,19720789,2.662306515e-12,136802238,2182772,32814392
250000,2753176125,19711988,2.6611183799999996e-12,136724632,2186144,35000536
255000,2238687167,19754296,2.66682996e-12,138099638,2187640,37188176
260000,2312022833,19735238,2.6642571299999996e-12,137480252,2180172,39368348
265000,2044467250,19720227,2.6622306449999998e-12,136783952,2189240,41557588
270000,2693686041,19738662,2.6647193699999998e-12,137591521,2181308,43738896
275000,2199842625,46891072,6.33029472e-12,136358075,-10449416,33289480
280000,2071566917,19742078,2.66518053e-12,137702539,2184900,35474380
285000,2262631791,19722626,2.6625545099999997e-12,137070356,2184876,37659256
290000,2306900083,19722494,2.6625366899999997e-12,137066058,2187436,39846692
295000,2276929625,19738611,2.6647124849999998e-12,137589861,2186256,42032948
300000,2269291916,19791834,2.6718975899999997e-12,139077842,2185632,44218580
305000,2241500458,19936878,2.69147853e-12,144033545,2188056,46406636
310000,2665991000,19966471,2.6954735849999998e-12,144995309,2357032,48763668
315000,2118602458,51099325,6.898408875e-12,144520816,-10625984,38137684
320000,2321026292,19971707,2.696180445e-12,144894082,2360988,40498672
325000,2159731791,19943485,2.6923704749999996e-12,144248283,2365192,42863864
330000,2418952250,20006771,2.7009140849999997e-12,146305075,2365016,45228880
335000,2183291500,19935335,2.691270225e-12,143983380,2364496,47593376
340000,2060191542,20005946,2.7008027099999996e-12,146006836,2360880,49954256
345000,2280714459,19980855,2.697415425e-12,145462814,2364820,52319076
350000,2499802667,19996092,2.69947242e-12,145958004,2364132,54683208
355000,2139818917,19992463,2.698982505e-12,145568643,2363508,57046716
360000,2637962208,55608711,7.507175985e-12,146534773,-13462904,43583812
365000,2254799042,19957083,2.6942062049999998e-12,144690210,2361444,45945256
370000,2147445375,20014572,2.70196722e-12,146558600,2367104,48312360
375000,2294846833,19987115,2.6982605249999998e-12,145354137,2366968,50679328
380000,2382138791,19997703,2.699689905e-12,146010348,2363972,53043300
385000,2270610083,20023136,2.7031233599999995e-12,146836942,2363568,55406868
390000,2385778041,19986580,2.6981882999999997e-12,145648859,2364400,57771268
395000,2057595000,20032908,2.70444258e-12,147154519,2364460,60135728
400000,2787941833,19988355,2.698427925e-12,145706559,2365208,62500936
405000,2158291834,19988778,2.6984850299999995e-12,145720286,2365344,64866280
410000,5068488042,60382171,8.151593085e-12,140659876,-15227756,49638524
415000,2205569250,19859053,2.6809721549999995e-12,141504239,2362796,52001320
420000,2227709125,19847361,2.6793937349999998e-12,141124244,2364028,54365348
425000,2762432542,19880301,2.6838406349999996e-12,141841809,2367524,56732872
430000,2151029125,19856721,2.6806573349999998e-12,141428437,2362828,59095700
435000,2516676875,19870422,2.6825069699999997e-12,141873730,2366100,61461800
440000,2290691916,19875773,2.6832293549999995e-12,142047620,2363800,63825600
445000,2567376791,19876560,2.6833355999999996e-12,141720212,2366056,66191656
450000,2120917042,19871108,2.68259958e-12,141896010,2362444,68554100
455000,2538477250,19932435,2.6908787249999996e-12,143889130,2362532,70916632
460000,2319765500,19984668,2.6979301799999995e-12,145233738,2367812,73284444
465000,4375409000,65853413,8.890210755e-12,142092199,-16985480,56298964
470000,2443155083,19832229,2.6773509149999997e-12,140632460,2370028,58668992
475000,2372400917,19857273,2.6807318549999997e-12,141048797,2362512,61031504
480000,2042192375,19836413,2.6779157549999998e-12,140768437,2364724,63396228
485000,2255094292,19848753,2.6795816549999998e-12,141169485,2363588,65759816
490000,2262286125,19844697,2.679034095e-12,140640092,2365300,68125116
495000,2296839083,19853239,2.6801872649999997e-12,141315283,2365468,70490584
500000,2589455291,19851071,2.6798945849999997e-12,141244802,2364620,72855204
505000,2061447791,20892571,2.820497085e-12,150146096,2369364,75224568
510000,2236143583,20866941,2.817037035e-12,148915546,2368216,77592784
515000,2230413917,20945034,2.8275795899999996e-12,151851139,2375560,79968344
520000,2417545500,21076575,2.8453376249999995e-12,156126215,2371892,82340236
525000,2266291875,21006198,2.8358367299999997e-12,153441408,2366708,84706944
530000,4414339333,73463296,9.917544959999999e-12,155563773,-20534600,64172344
535000,2072796125,21035716,2.8398216599999997e-12,154798290,2367768,66540112
540000,2870572875,21017481,2.837359935e-12,154205664,2369728,68909840
545000,2095960333,21070723,2.8445476049999997e-12,155481278,2370888,71280728
550000,2578867250,21005855,2.835790425e-12,153827823,2371240,73651968
555000,2234164375,21077847,2.8455093449999994e-12,156167575,2369752,76021720
560000,2659109083,21050301,2.8417906349999998e-12,154817595,2371668,78393388
565000,2228944583,20979941,2.832292035e-12,152985631,2367680,80761068
570000,2361488167,21048369,2.8415298149999997e-12,155209524,2371268,83132336
575000,2252108917,20986785,2.833215975e-12,153208047,2370332,85502668
580000,2352545583,21059554,2.8430397899999994e-12,155118313,2367420,87870088
585000,2288092333,20982635,2.8326557249999997e-12,153073184,2369112,90239200
590000,2271962167,21046387,2.8412622449999998e-12,155145097,2371776,92610976
595000,2294277500,21014452,2.8369510199999995e-12,153652468,2371608,94982584
600000,3451114583,80355766,1.0848028409999999e-11,154578724,-22330104,72652480
605000,2204534709,21027633,2.8387304549999997e-12,154535611,2368528,75021008
610000,2485170500,21024901,2.838361635e-12,154446826,2371496,77392504
615000,2258609125,21024667,2.8383300449999995e-12,154439220,2369836,79762340
620000,2036897709,20978803,2.832138405e-12,152948633,2370712,82133052
625000,2312906500,21036480,2.8399248e-12,154823140,2365936,84498988
630000,2148120541,21004836,2.83565286e-12,153284540,2372848,86871836
635000,2296264125,20996819,2.8345705649999995e-12,153534144,2372228,89244064
640000,2252937250,20912421,2.823176835e-12,150791227,2372856,91616920
645000,2182465792,20869828,2.8174267799999996e-12,148896779,2371448,93988368
650000,2216555084,20886383,2.819661705e-12,149944979,2369760,96358128
655000,2282267500,20908701,2.8226746349999997e-12,150670312,2372160,98730288
660000,2069628791,20882895,2.8191908249999995e-12,149831630,2366428,101096716
665000,2216761041,20919020,2.8240676999999996e-12,150495538,2372560,103469276
670000,2436968792,21051699,2.841979365e-12,155317763,2368592,105837868
675000,2067377292,20925761,2.8249777349999995e-12,151224764,2371108,108208976
680000,3947054958,88149360,1.1900163599999998e-11,150129933,-25866196,82342780
685000,2407181916,20949454,2.82817629e-12,151994796,2368008,84710788
690000,2324961542,21035715,2.839821525e-12,154798264,2373840,87084628
695000,2183323208,21050056,2.84175756e-12,155264337,2369984,89454612
700000,2591338416,21022852,2.8380850199999998e-12,153802244,2372556,91827168
705000,2126793875,21051702,2.8419797699999996e-12,155317864,2369520,94196688
710000,2247332125,21047145,2.841364575e-12,155169726,2367812,96564500
715000,2157043208,21024605,2.8383216749999997e-12,154437201,2371116,98935616
720000,2427792708,21038625,2.8402143749999998e-12,154314883,2369428,101305044
725000,2143267750,21054616,2.8423731599999996e-12,155412547,2371172,103676216
730000,2454224000,20989739,2.833614765e-12,153304063,2367868,106044084
735000,2126698125,21036951,2.8399883849999994e-12,154838454,2370868,108414952
740000,2364754500,21011100,2.8364985e-12,153420305,2370964,110785916
745000,2363859333,21009591,2.8362947849999994e-12,153949248,2371168,113157084
750000,2301684792,21064498,2.8437072299999997e-12,155733716,2369588,115526672
755000,2265407709,21048053,2.8414871549999997e-12,154621260,2371272,117897944
760000,2415560333,21033529,2.8395264149999996e-12,154727208,2368084,120266028
765000,2243371208,21012914,2.83674339e-12,154057240,2370588,122636616
770000,4942249167,97210528,1.3123421279999997e-11,155357127,-29392372,93244244
775000,2119246000,21003382,2.83545657e-12,153747455,2371832,95616076
780000,2063698000,21024329,2.8382844149999995e-12,154428221,2372076,97988152
785000,2248044208,21043482,2.8408700699999996e-12,155050686,2368468,100356620
790000,3965341125,21034105,2.8396041749999997e-12,154093170,2370208,102726828
795000,2195271458,21039478,2.8403295299999994e-12,154920584,2372876,105099704
800000,2257758167,21016951,2.8372883849999995e-12,154188432,2368064,107467768
805000,2287859292,21059580,2.8430433e-12,154921135,2368964,109836732
810000,2682030709,21046029,2.841213915e-12,155133471,2368264,112204996
815000,2115831833,20998839,2.834843265e-12,153599813,2369304,114574300
820000,2799981959,20986869,2.8332273149999996e-12,153210781,2367328,116941628
825000,2280962333,21073766,2.84495841e-12,155382153,2368152,119309780
830000,2679686416,21087483,2.8468102049999996e-12,156480721,2369560,121679340
835000,2112846792,21210528,2.8634212799999997e-12,160479683,2369904,124049244
840000,2892651292,21154538,2.8558626299999997e-12,158660026,2373004,126422248
845000,2092796459,21214875,2.8640081249999998e-12,159968199,2368400,128790648
850000,2445000292,21196560,2.8615356e-12,160025728,2370324,131160972
855000,2290279750,21173974,2.8584864899999998e-12,159291676,2371676,133532648
860000,2813631209,21200722,2.8620974699999996e-12,159508245,2368608,135901256
865000,2179507042,21152927,2.8556451449999996e-12,158607658,2372424,138273680
870000,2444527791,21188305,2.860421175e-12,159757429,2367884,140641564
875000,6942479041,107714088,1.454140188e-11,159157587,-34681660,105959904
880000,2252811750,21182313,2.8596122549999993e-12,159562689,2369908,108329812
885000,2593358917,21148997,2.855114595e-12,158479924,2367040,110696852
890000,2231168250,21194183,2.8612147049999994e-12,159204815,2367636,113064488
895000,4084986625,21179631,2.8592501849999997e-12,159475549,2365876,115430364
900000,2133932042,21152893,2.855640555e-12,158606549,2370172,117800536
905000,2032886916,21226350,2.86555725e-12,160993915,2369548,120170084
910000,2353493250,21179578,2.85924303e-12,159473829,2370108,122540192
915000,2043787166,21192300,2.8609605e-12,159887272,2369160,124909352
920000,2273426625,21161661,2.856824235e-12,158891521,2370720,127280072
925000,2832172416,21215119,2.8640410649999997e-12,159885231,2371072,129651144
930000,2105782458,21148431,2.855038185e-12,158461547,2369728,132020872
935000,2285546083,21123720,2.8517022e-12,157658418,2368948,134389820
940000,2239425416,21044711,2.8410359849999996e-12,155090634,2367744,136757564
945000,2205708333,21009335,2.836260225e-12,153197243,2373260,139130824
950000,2170576291,21031413,2.8392407549999998e-12,154658462,2368088,141498912
955000,2363386041,21015151,2.8370453849999993e-12,154129929,2372400,143871312
960000,2241976584,21170620,2.8580337000000002e-12,158439025,2369964,146241276
965000,3072220333,21114479,2.8504546649999996e-12,157358100,2367196,148608472
970000,2273337291,21173469,2.858418315e-12,159275265,2370452,150978924
975000,2605546958,21101340,2.8486809e-12,156931085,2369928,153348852
980000,2282393208,21171548,2.8581589799999997e-12,159212855,2371104,155719956
985000,2462617833,21121348,2.8513819799999997e-12,157581351,2367904,158087860
990000,6630340833,119041517,1.6070604795e-11,157804737,-38204104,119883756
995000,2213375041,21183498,2.85977223e-12,159601214,2369012,122252768
1000000,2355059541,21133337,2.853000495e-12,157971001,2369508,124622276
1005000,2255480208,21184327,2.8598841449999995e-12,158791659,2370212,126992488
1010000,4016253000,21194935,2.861316225e-12,159972920,2374188,129366676
1015000,2169153000,21146918,2.8548339299999995e-12,158412382,2371456,131738132
1020000,3070029959,21232510,2.86638885e-12,160357630,2371180,134109312
1025000,2226488333,21198174,2.8617534899999995e-12,160078192,2366328,136475640
1030000,2551004042,21167476,2.85760926e-12,159080512,2370716,138846356
1035000,2265033042,21201392,2.8621879199999997e-12,160182763,2368120,141214476
1040000,2668273333,21189629,2.8605999149999996e-12,158963982,2372024,143586500
1045000,2177163750,21194965,2.861320275e-12,159973913,2367844,145954344
1050000,2039391500,21121222,2.85136497e-12,157577249,2373816,148328160
1055000,2239873541,21185093,2.8599875549999995e-12,159653068,2369788,150697948
1060000,2945548917,21176015,2.8587620249999998e-12,158521516,2371688,153069636
1065000,2289517750,21134783,2.8531957049999998e-12,158017978,2369416,155439052
1070000,2353638375,21169998,2.8579497299999996e-12,159162468,2369312,157808364
1075000,2259134750,21144194,2.8544661899999998e-12,157487342,2369796,160178160
1080000,2297757208,21188469,2.8604433149999993e-12,159762792,2370540,162548700
1085000,2337884125,20997787,2.8347012449999997e-12,153565598,2371612,164920312
1090000,2053617625,21040776,2.8405047599999995e-12,154962741,2371660,167291972
1095000,2732245208,21152494,2.8555866899999996e-12,158593576,2370808,169662780
1100000,2871114709,21148048,2.8549864799999996e-12,158449103,2369076,172031856
1105000,2315193708,21197454,2.8616562899999995e-12,160054786,2366876,174398732
1110000,2476695542,21149108,2.8551295799999994e-12,157647071,2373652,176772384
1115000,2109621166,21170613,2.858032755e-12,159182475,2368736,179141120
1120000,6145483583,131760012,1.778760162e-11,154193341,-43510380,135630740
1125000,2034988417,20997391,2.834647785e-12,153552728,2370040,138000780
1130000,2429945000,21026267,2.8385460449999998e-12,154491218,2373440,140374220
1135000,2246802292,21100889,2.848620015e-12,156916435,2372756,142746976
1140000,2177497834,21195824,2.8614362399999993e-12,160001819,2369460,145116436
1145000,2355773625,21208399,2.863133865e-12,159465302,2370688,147487124
1150000,2118204417,21159414,2.8565208899999997e-12,158818484,2372652,149859776
1155000,2158619834,21162650,2.85695775e-12,158923668,2372556,152232332
1160000,2226923542,21197338,2.86164063e-12,159105806,2368544,154600876
1165000,2828386000,21142919,2.8542940649999998e-12,158282413,2370308,156971184
1170000,2330441084,21188552,2.8604545199999995e-12,159765474,2368552,159339736
1175000,4162726791,21194459,2.861251965e-12,159012237,2370108,161709844
1180000,2045115667,21189808,2.86062408e-12,159806296,2368792,164078636
1185000,2349820042,21182900,2.8596914999999996e-12,159581768,2372100,166450736
1190000,2307165042,21149106,2.8551293099999995e-12,158483487,2369416,168820152
1195000,2176965667,21222960,2.8650996e-12,159938554,2370404,171190556
1200000,2311736875,21143520,2.8543752e-12,158301923,2368848,173559404
1205000,2263006375,21151551,2.8554593849999998e-12,158562943,2370388,175929792
1210000,2275707625,21194486,2.86125561e-12,159013125,2366768,178296560
1215000,2814383917,21122804,2.85157854e-12,157628646,2366844,180663404
1220000,2158122792,21172068,2.8582291799999994e-12,159229743,2372156,183035560
1225000,2257386875,21132250,2.8528537499999996e-12,157935654,2374720,185410280
1230000,2084453250,21190165,2.8606722749999995e-12,158872698,2367372,187777652
1235000,2924355834,21081421,2.8459918349999996e-12,156283701,2367520,190145172
1240000,2299530333,21001674,2.83522599e-12,153691951,2369004,192514176
1245000,2288756958,21046420,2.8412666999999998e-12,155146189,2368208,194882384
1250000,2105054625,21029766,2.83901841e-12,154604945,2371736,197254120
1255000,2591034125,21014543,2.8369633049999998e-12,154110167,2370196,199624316
1260000,2283832583,21032144,2.8393394399999995e-12,154682221,2369448,201993764
1265000,2682122750,21020630,2.83778505e-12,153362820,2368776,204362540
1270000,6488680708,146617687,1.9793387745e-11,155002753,-50562828,153799712
1275000,2552421083,21174460,2.8585520999999998e-12,159307467,2366968,156166680
1280000,2149101084,21178090,2.85904215e-12,159425451,2373648,158540328
1285000,2168721958,21205185,2.862699975e-12,160306026,2369536,160909864
1290000,2232236916,21148347,2.8550268449999998e-12,158458820,2372200,163282064
1295000,3261510417,21229515,2.8659845249999997e-12,160023290,2370632,165652696
1300000,2289501500,21162977,2.8570018949999997e-12,158934277,2370276,168022972
1305000,2087644458,21203560,2.8624806e-12,160253234,2372160,170395132
1310000,2734635875,21182674,2.85966099e-12,159574441,2368104,172763236
1315000,2235466292,21198844,2.8618439399999996e-12,159026487,2370008,175133244
1320000,2444861250,21167001,2.8575451349999998e-12,159065055,2370688,177503932
1325000,2059394584,21154928,2.8559152799999993e-12,158672702,2367648,179871580
1330000,2250932000,21198013,2.861731755e-12,160072966,2370840,182242420
1335000,2273904500,21215753,2.8641266549999994e-12,159576030,2368084,184610504
1340000,2339892083,21140097,2.853913095e-12,158190703,2366332,186976836
1345000,2264786208,21194064,2.8611986399999995e-12,159944607,2373420,189350256
1350000,2328430000,21171697,2.858179095e-12,159217679,2370864,191721120
1355000,2273683125,21198036,2.86173486e-12,160073699,2365480,194086600
1360000,2516724709,21154028,2.85579378e-12,158643447,2369032,196455632
1365000,2046118875,21166959,2.8575394649999996e-12,159063693,2368904,198824536
1370000,2919057500,21188748,2.8604809799999995e-12,158698382,2368700,201193236
1375000,2130305667,21166226,2.85744051e-12,159039870,2368888,203562124
1380000,2294221292,21159224,2.8564952399999998e-12,158812314,2371012,205933136
1385000,2272608791,21166400,2.8574639999999997e-12,159045545,2369504,208302640
1390000,2753056583,21186801,2.8602181349999995e-12,158635076,2369064,210671704
1395000,2178973625,21132009,2.8528212149999998e-12,157927840,2371884,213043588
1400000,2214470459,20985384,2.8330268399999994e-12,153162499,2368732,215412320
1405000,2226811625,21014572,2.83696722e-12,154111122,2368204,217780524
1410000,2292744333,20999750,2.83496625e-12,152555935,2365536,220146060
1415000,2242871584,21040519,2.840470065e-12,154954414,2368640,222514700
1420000,2389985667,21146485,2.8547754749999995e-12,158398286,2368600,224883300
1425000,2291708333,21157751,2.856296385e-12,157690984,2367688,227250988
1430000,2424127500,21197491,2.8616612849999998e-12,160055992,2366532,229617520
1435000,9443613667,163070268,2.201448618e-11,158430491,-55843408,173774112
1440000,2115088125,21212517,2.863689795e-12,160544341,2370316,176144428
1445000,2725161750,21154076,2.85580026e-12,158645004,2369840,178514268
1450000,2243186208,21233833,2.866567455e-12,160029890,2370176,180884444
1455000,2970516792,21227647,2.8657323449999996e-12,161036054,2368052,183252496
1460000,2193343583,21169603,2.857896405e-12,159149618,2366904,185619400
1465000,4851092834,21190250,2.86068375e-12,158613433,2371032,187990432
1470000,2290160750,21119451,2.851125885e-12,157519705,2368068,190358500
1475000,2368730916,21160524,2.8566707399999997e-12,158854562,2365868,192724368
1480000,2059561208,21183257,2.8597396949999997e-12,158386165,2368840,195093208
1485000,2250830333,21136847,2.8534743449999994e-12,158085066,2368948,197462156
1490000,2130993583,21139120,2.8537812e-12,158158943,2368264,199830420
1495000,2162274541,21121269,2.851371315e-12,157578756,2371640,202202060
1500000,2268141084,21193420,2.8611117e-12,158716480,2369404,204571464
1505000,2295114417,21120647,2.851287345e-12,157558562,2372104,206943568
1510000,2257176625,21193318,2.8610979299999994e-12,159920363,2369120,209312688
1515000,2377154583,21166005,2.8574106749999996e-12,159032681,2370132,211682820
1520000,2039601167,21172242,2.85825267e-12,159235389,2372668,214055488
1525000,2871638084,21142860,2.8542860999999993e-12,158280467,2369536,216425024
1530000,2324357334,21170227,2.8579806449999996e-12,159169899,2365272,218790296
1535000,2449948792,21182359,2.859618465e-12,158356986,2368316,221158612
1540000,2265812750,21152917,2.8556437949999997e-12,158607317,2370756,223529368
1545000,2890876791,21118985,2.8510629749999995e-12,157504555,2372416,225901784
1550000,2962353791,21223480,2.8651698e-12,159693432,2367928,228269712
1555000,2441985917,21164830,2.85725205e-12,158994496,2370660,230640372
1560000,2288993791,21124145,2.8517595749999997e-12,157672238,2369996,233010368
1565000,2289143750,21155764,2.8560281399999996e-12,158699855,2368968,235379336
1570000,2277796875,21197029,2.861598915e-12,158833751,2368232,237747568
1575000,2126736000,21165979,2.8574071649999995e-12,159031847,2369004,240116572
1580000,2212103542,21153464,2.85571764e-12,158625113,2368228,242484800
1585000,2056494042,21120211,2.8512284849999994e-12,157544384,2370396,244855196
1590000,2272774750,21155777,2.856029895e-12,158700297,2364208,247219404
1595000,2918593334,21239684,2.8673573399999996e-12,161427257,2368044,249587448
1600000,2079916416,21320805,2.8783086749999997e-12,164063712,2366936,251954384
1605000,2341111750,21295394,2.8748781899999996e-12,162030613,2370976,254325360
1610000,2248986542,21342289,2.8812090149999998e-12,164761916,2367408,256692768
1615000,2210696125,21284194,2.8733661899999996e-12,162873849,2371888,259064656
1620000,2618434334,21377602,2.88597627e-12,164702379,2369620,261434276
1625000,10367699333,181988937,2.4568506495e-11,162739151,-64659560,196774716
1630000,2044038000,21297478,2.8751595299999996e-12,163305582,2370564,199145280
1635000,2733314166,21319144,2.87808444e-12,164009724,2369996,201515276
1640000,2132794834,21296729,2.875058415e-12,163281229,2370932,203886208
1645000,2284691459,21331211,2.8797134849999997e-12,164401878,2371140,206257348
1650000,4721673958,21308160,2.8766015999999998e-12,163652729,2368740,208626088
1655000,2185919917,21396080,2.8884707999999998e-12,165140733,2367388,210993476
1660000,2447689542,21289316,2.8740576599999995e-12,163040290,2366328,213359804
1665000,2235862666,21296254,2.8749942899999996e-12,163265782,2373484,215733288
1670000,2507452916,21326363,2.879059005e-12,164244335,2369628,218102916
1675000,2196337792,21319178,2.87808903e-12,162641417,2371628,220474544
1680000,2523850750,21330529,2.8796214149999993e-12,164379712,2372460,222847004
1685000,2276921375,21257527,2.8697661449999998e-12,162007168,2367212,225214216
1690000,2944978291,21385193,2.887001055e-12,164786933,2372500,227586716
1695000,2302065041,21283187,2.8732302449999994e-12,162841106,2368152,229954868
1700000,2522893500,21341914,2.8811583899999996e-12,164749748,2371660,232326528
1705000,2267039916,21331836,2.8797978599999996e-12,164422187,2369984,234696512
1710000,2758419959,21189853,2.8606301549999996e-12,158438372,2372520,237069032
1715000,2061135459,21328539,2.8793527649999997e-12,164315052,2369848,239438880
1720000,2320459917,21478634,2.89961559e-12,169193137,2369676,241808556
1725000,2249776292,21329334,2.87946009e-12,164340900,2370936,244179492
1730000,2236625334,21347478,2.8819095299999994e-12,163561171,2367628,246547120
1735000,3558590833,21327117,2.879160795e-12,164268851,2374128,248921248
1740000,2227210958,21313789,2.877361515e-12,163835666,2369480,251290728
1745000,2276175792,21382639,2.8866562649999995e-12,164703900,2367720,253658448
1750000,2045373083,21299316,2.8754076599999997e-12,163365301,2373328,256031776
1755000,2082547958,21337165,2.880517275e-12,164595407,2368916,258400692
1760000,2893694542,21190857,2.860765695e-12,158471000,2368476,260769168
1765000,2672290791,21164586,2.85721911e-12,158986567,2371336,263140504
1770000,2065385375,21193131,2.861072685e-12,159914305,2368600,265509104
1775000,2280556666,21175122,2.8586414699999994e-12,159329007,2371164,267880268
1780000,2205783917,21251984,2.86901784e-12,160457618,2369028,270249296
1785000,2242700000,21156379,2.856111165e-12,158719846,2369548,272618844
1790000,2355523541,21164093,2.857152555e-12,158970552,2370240,274989084
1795000,2289495750,21227458,2.8657068299999995e-12,159660540,2369448,277358532
1800000,2335861875,21170745,2.8580505749999994e-12,159186741,2371660,279730192
1805000,2280781375,21232791,2.8664267849999998e-12,161203242,2368996,282099188
1810000,2282104042,21144503,2.854507905e-12,158333882,2367448,284466636
1815000,2273838875,21153389,2.8557075149999995e-12,158622661,2371140,286837776
1820000,2528445375,21152797,2.8556275949999996e-12,158603442,2369900,289207676
1825000,2217601375,21197386,2.86164711e-12,160052587,2370368,291578044
1830000,2270787542,21325363,2.8789240049999997e-12,164211843,2369928,293947972
1835000,12420516375,202753752,2.7371756519999997e-11,162363756,-71736652,222211320
1840000,2253155542,21348258,2.8820148299999996e-12,164955924,2371092,224582412
1845000,2065603583,21300888,2.87561988e-12,163416401,2370348,226952760
1850000,2246220792,21394127,2.8882071449999996e-12,164905948,2369772,229322532
1855000,4715042791,21324134,2.8787580899999998e-12,164171884,2370436,231692968
1860000,2498567333,21285548,2.87354898e-12,162917838,2368216,234061184
1865000,2151563667,21368708,2.88477558e-12,164079856,2370724,236431908
1870000,2588224959,21277393,2.8724480549999995e-12,162652820,2367756,238799664
1875000,2089808958,21340484,2.88096534e-12,164703271,2372556,241172220
1880000,2377079042,21318681,2.878021935e-12,163994647,2372820,243545040
1885000,2288984000,21368196,2.88470646e-12,164063198,2369464,245914504
1890000,2757445584,21302248,2.8758034799999998e-12,163460583,2368468,248282972
1895000,2158268833,21320715,2.8782965249999996e-12,164060773,2371176,250654148
1900000,2297897333,21344315,2.8814825249999998e-12,164827773,2369620,253023768
1905000,3513736792,21374958,2.88561933e-12,164282967,2371612,255395380
1910000,2300741416,21325890,2.8789951499999998e-12,164228962,2370676,257766056
1915000,2274469292,21271888,2.8717048799999994e-12,162473882,2370008,260136064
1920000,2074375500,21366334,2.88445509e-12,164002677,2371280,262507344
1925000,2263783250,21285874,2.8735929899999997e-12,162928445,2369760,264877104
1930000,2794927542,21328547,2.879353845e-12,164315319,2369344,267246448
1935000,2274707584,21326125,2.8790268749999995e-12,164236591,2366348,269612796
1940000,2115665125,21354787,2.8828962449999998e-12,163627431,2372424,271985220
1945000,2253523791,21278937,2.8726564949999998e-12,162702986,2369208,274354428
1950000,2586674625,21179967,2.8592955449999998e-12,159486460,2371720,276726148
1955000,2331419333,21239008,2.8672660799999998e-12,159864596,2373452,279099600
1960000,2652016875,21123686,2.8516976099999996e-12,157657345,2368648,281468248
1965000,2050416625,21134677,2.8531813949999995e-12,158014550,2372116,283840364
1970000,2573013666,21160789,2.856706515e-12,158863162,2370724,286211088
1975000,3342730292,21270439,2.8715092649999996e-12,160886094,2371072,288582160
1980000,2905846167,21300868,2.8756171799999996e-12,163415749,2369072,290951232
1985000,2242282250,21286206,2.87363781e-12,162939217,2372352,293323584
1990000,2280495375,21192687,2.861012745e-12,158359163,2370392,295693976
1995000,2250373750,21210583,2.863428705e-12,160481484,2369304,298063280
2000000,2699007750,21295441,2.874884535e-12,163239370,2367364,300430644
2005000,2114323458,21312424,2.87717724e-12,163791316,2372884,302803528
2010000,3052489292,21365504,2.8843430399999995e-12,163975707,2369984,305173512
2015000,2252719542,21297879,2.875213665e-12,163318591,2370708,307544220
2020000,2280850125,21307937,2.876571495e-12,163645505,2369460,309913680
2025000,2318678709,21354711,2.8828859849999994e-12,163624937,2367340,312281020
2030000,2311550250,21274787,2.872096245e-12,162568113,2370852,314651872
2035000,2091346167,21301248,2.8756684799999998e-12,163428078,2371512,317023384
2040000,2632725625,21283945,2.8733325749999997e-12,162865745,2368652,319392036
2045000,2085667833,21325086,2.87888661e-12,162662121,2366348,321758384
2050000,2160325166,21284286,2.8733786099999997e-12,162876817,2370332,324128716
2055000,2187551750,21293968,2.87468568e-12,163191476,2372092,326500808
2060000,2400341042,21370691,2.8850432849999995e-12,164144297,2369140,328869948
2065000,2078517875,21307535,2.8765172249999996e-12,163632433,2368232,331238180
2070000,2311993542,21342374,2.8812204899999995e-12,164764687,2369488,333607668
2075000,11704182167,226508496,3.0578646959999995e-11,162847012,-82325528,251282140
2080000,2092628209,21339489,2.8808310149999997e-12,164670922,2367828,253649968
2085000,2822314584,21343367,2.881354545e-12,163052984,2372052,256022020
2090000,2229150750,21344819,2.881550565e-12,164844149,2367804,258389824
2095000,4707097292,21313792,2.8773619199999994e-12,163835770,2370324,260760148
2100000,3008493125,21367676,2.8846362599999997e-12,163843013,2369876,263130024
2105000,2228270792,21330647,2.879637345e-12,164383554,2370700,265500724
2110000,2082747250,21297154,2.8751157899999995e-12,163295035,2369596,267870320
2115000,2259018333,21233442,2.8665146699999997e-12,161224412,2370036,270240356
2120000,2296263833,21154999,2.855924865e-12,158675010,2371240,272611596
2125000,2474337459,21116807,2.850768945e-12,157433769,2372216,274983812
2130000,2960371083,21188940,2.8605068999999997e-12,159778090,2370832,277354644
2135000,2267063541,21166918,2.8575339299999995e-12,157318370,2367272,279721916
2140000,2358719792,21196465,2.8615227749999997e-12,160022652,2368708,282090624
2145000,2057338334,21131861,2.8528012349999997e-12,157923001,2375528,284466152
2150000,2604787875,21220920,2.8648241999999995e-12,159073443,2370756,286836908
2155000,2124662542,21335471,2.8802885849999997e-12,164540330,2372108,289209016
2160000,2355997792,21308985,2.8767129749999995e-12,163679530,2371996,291581012
2165000,2271253541,21327290,2.87918415e-12,164274451,2365540,293946552
2170000,2130869292,21345346,2.88162171e-12,163117291,2370784,296317336
2175000,2173637875,21313637,2.877340995e-12,163830718,2373436,298690772
2180000,2577706417,21323653,2.8786931549999998e-12,164156268,2370316,301061088
2185000,2253643500,21284762,2.8734428699999997e-12,162892300,2373344,303434432
2190000,2740375334,21370268,2.88498618e-12,163927260,2371580,305806012
2195000,2189483666,21311602,2.8770662699999996e-12,163764595,2367788,308173800
2200000,2880277750,21323072,2.87861472e-12,164137371,2371760,310545560
2205000,2036129541,21427141,2.8926640349999995e-12,165775644,2373064,312918624
2210000,2461167875,21296020,2.8749626999999996e-12,163258184,2371184,315289808
2215000,2239132750,21271869,2.871702315e-12,162473256,2366028,317655836
2220000,2070243375,21320304,2.87824104e-12,164047400,2373856,320029692
2225000,2303877167,21341849,2.8811496149999994e-12,163003654,2368052,322397744
2230000,2919053208,21314154,2.87741079e-12,163847529,2368396,324766140
2235000,2364725584,21290465,2.8742127749999997e-12,163077653,2366992,327133132
2240000,3571104334,21381831,2.886547185e-12,164303060,2370240,329503372
2245000,2278743459,21313948,2.87738298e-12,163840836,2371304,331874676
2250000,2222426625,21287620,2.8738286999999997e-12,162985179,2374164,334248840
2255000,2294378417,21347555,2.881919925e-12,164933071,2369264,336618104
2260000,2438057958,21339610,2.8808473499999995e-12,162930888,2370284,338988388
2265000,2082129125,21335692,2.88031842e-12,164547512,2368772,341357160
2270000,2150682708,21157777,2.8562998949999996e-12,158765281,2368076,343725236
2275000,2229459833,21241573,2.867612355e-12,159744663,2371664,346096900
2280000,2355346875,21167993,2.8576790549999997e-12,159097317,2368268,348465168
2285000,2144441917,21226227,2.8655406449999997e-12,160989899,2366476,350831644
2290000,2448666583,21381764,2.88653814e-12,164300886,2369888,353201532
2295000,2073175167,21286890,2.8737301499999994e-12,162961457,2373444,355574976
2300000,2472797458,21340521,2.8809703349999995e-12,164704465,2370092,357945068
2305000,2261080250,21310290,2.8768891499999998e-12,163721951,2373320,360318388
2310000,2652912750,21386801,2.8872181349999997e-12,164464569,2369112,362687500
2315000,2142687250,21302477,2.8758343949999997e-12,163468054,2369912,365057412
2320000,2179778208,21315700,2.8776194999999997e-12,163897787,2368640,367426052
2325000,2078148708,21298852,2.8753450199999996e-12,163350226,2368472,369794524
2330000,2464268667,21399896,2.88898596e-12,164890173,2366848,372161372
2335000,2244616875,21294997,2.874824595e-12,163224939,2368044,374529416
2340000,4126261625,21340701,2.8809946349999998e-12,164710317,2370408,376899824
2345000,14058100125,253262117,3.4190385794999994e-11,162791921,-92912024,283987800
2350000,2116140250,21300187,2.8755252449999994e-12,163393615,2369860,286357660
2355000,2907987083,21348138,2.88199863e-12,164952011,2373808,288731468
2360000,2238788375,21355601,2.883006135e-12,163225986,2367304,291098772
2365000,4710139375,21334868,2.8802071799999997e-12,164520734,2369512,293468284
2370000,2604335292,21279754,2.8727667899999998e-12,162729536,2368060,295836344
2375000,2295195250,21407809,2.8900542149999997e-12,164922734,2372152,298208496
2380000,2462783250,21279967,2.872795545e-12,162736452,2369792,300578288
2385000,2064393708,21288555,2.873954925e-12,163015578,2366808,302945096
2390000,2083053458,21318737,2.878029495e-12,163996484,2372188,305317284
2395000,2096888959,21338878,2.8807485299999996e-12,162682485,2370808,307688092
2400000,2954620084,21345809,2.881684215e-12,164876320,2369488,310057580
2405000,2068925000,21325050,2.8788817499999997e-12,164201673,2375072,312432652
2410000,2196772167,21321600,2.8784159999999995e-12,164089528,2368916,314801568
2415000,3696652541,21299567,2.875441545e-12,163373469,2373256,317174824
2420000,2388851208,21164610,2.8572223499999996e-12,158987372,2367320,319542144
2425000,2238771625,21221520,2.8649051999999994e-12,160836917,2370904,321913048
2430000,3101216292,21388590,2.8874596499999993e-12,164298135,2367812,324280860
2435000,2272738125,21303573,2.8759823549999996e-12,163503659,2367736,326648596
2440000,3202787125,21342678,2.8812615299999997e-12,164774584,2367884,329016480
2445000,2296077709,21326804,2.87911854e-12,162290072,2369464,331385944
2450000,2398557750,21338265,2.880665775e-12,164631148,2368176,333754120
2455000,2311393375,21340420,2.8809566999999996e-12,164701170,2371088,336125208
2460000,2161103000,21108231,2.8496111849999996e-12,157155035,2367376,338492584
2465000,2132900667,21161865,2.8568517749999997e-12,158898143,2369096,340861680
2470000,2515867417,21110395,2.8499033249999997e-12,157225374,2369088,343230768
2475000,2133869541,21185531,2.8600466849999995e-12,159667300,2365780,345596548
2480000,2878016792,21363409,2.8840602149999998e-12,163479735,2365972,347962520
2485000,3231793834,21267129,2.8710624149999994e-12,162319228,2372484,350335004
2490000,2211689334,21323427,2.8786626450000002e-12,164148897,2370228,352705232
2495000,2265458833,21337777,2.8805998949999998e-12,162646685,2371560,355076792
2500000,2616012791,21303074,2.87591499e-12,163487427,2370360,357447152
2505000,2157770750,21275970,2.8722559500000002e-12,162606570,2365820,359812972
2510000,2206043417,21295001,2.874825135e-12,163225067,2370152,362183124
2515000,2270647834,21390172,2.88767322e-12,164349544,2367312,364550436
2520000,2373867500,21288249,2.873913615e-12,163005636,2367648,366918084
2525000,2441106000,21328759,2.879382465e-12,164322202,2371944,369290028
2530000,3444000042,21265959,2.870904465e-12,162281208,2371932,371661960
2535000,2271591125,21302077,2.8757803949999997e-12,163455019,2368856,374030816
2540000,2449811458,21303441,2.8759645349999997e-12,163499384,2366920,376397736
2545000,2260159167,21258308,2.8698715799999993e-12,162032550,2366344,378764080
2550000,2169765334,21393446,2.8881152099999998e-12,164455951,2367248,381131328
2555000,3733002833,21279733,2.8727639549999997e-12,162728848,2369692,383501020
2560000,2189044709,21326267,2.8790460449999994e-12,164241201,2369532,385870552
2565000,2245623625,21290120,2.8741662e-12,163066417,2373600,388244152
2570000,2566684541,21305715,2.8762715249999995e-12,163573266,2370596,390614748
2575000,2284822708,21326653,2.879098155e-12,164253751,2367404,392982152
2580000,2362134500,21431842,2.89329867e-12,165703806,2367288,395349440
2585000,2240782500,21484465,2.900402775e-12,169382663,2365892,397715332
2590000,3076324417,21293612,2.8746376199999996e-12,163179915,2369992,400085324
2595000,2288815834,21337953,2.8806236549999994e-12,164621006,2371276,402456600
2600000,2309859458,21345543,2.8816483049999996e-12,162899094,2366380,404822980
2605000,2194870417,21328353,2.8793276549999997e-12,164309020,2371020,407194000
2610000,2040457209,21458282,2.8968680699999994e-12,168531699,2370524,409564524
2615000,2309693250,21512666,2.90420991e-12,168330579,2370468,411934992
2620000,2130224958,21489173,2.9010383549999996e-12,169535659,2371612,414306604
2625000,3694345041,21467773,2.8981493549999996e-12,168840162,2370804,416677408
2630000,2284271958,21437272,2.89403172e-12,167848878,2367704,419045112
2635000,2257663583,21456958,2.89668933e-12,168488680,2369976,421415088
2640000,2317771125,21446387,2.8952622449999998e-12,168145109,2372140,423787228
2645000,2257572916,21478269,2.8995663149999997e-12,169181276,2369920,426157148
2650000,15265711833,283614498,3.828795723e-11,168352666,-105240988,320916160
2655000,2035822000,21503161,2.9029267350000002e-12,169990258,2371572,323287732
2660000,2889778042,21466944,2.8980374399999997e-12,168813222,2371148,325658880
2665000,2207441333,21465727,2.8978731449999996e-12,168773668,2374404,328033284
2670000,4709926334,21467852,2.89816002e-12,168842707,2365628,330398912
2675000,3259750333,21518784,2.90503584e-12,168274403,2371660,332770572
2680000,2104142458,21426970,2.89264095e-12,167514057,2370308,335140880
2685000,2107196000,21527444,2.9062049400000002e-12,168555844,2368252,337509132
2690000,2438400916,21437945,2.894122575e-12,167870746,2368664,339877796
2695000,2063381417,21473921,2.898979335e-12,169039974,2370716,342248512
2700000,2584349417,21446559,2.8952854649999996e-12,168150694,2373252,344621764
2705000,3538116416,21418724,2.8915277399999997e-12,167246048,2372888,346994652
2710000,3010872625,21483901,2.9003266349999998e-12,169364315,2370840,349365492
2715000,2281959541,21455663,2.8965145049999994e-12,168446570,2366252,351731744
2720000,2205763750,21559768,2.9105686799999997e-12,169606373,2369136,354100880
2725000,2232310250,21323901,2.878726635e-12,164164299,2375080,356475960
2730000,2201358375,21295250,2.87485875e-12,163233162,2373288,358849248
2735000,2132291958,21411881,2.890603935e-12,164800057,2369124,361218372
2740000,2321308250,21367330,2.88458955e-12,165575768,2370448,363588820
2745000,2225109625,21499791,2.9024717849999997e-12,169880741,2366120,365954940
2750000,3123760084,21453877,2.8962733949999994e-12,168388522,2369892,368324832
2755000,2070350291,21586024,2.9141132399999998e-12,170459696,2370628,370695460
2760000,2041561000,21458281,2.896867935e-12,168531657,2369940,373065400
2765000,2230970083,21435201,2.8937521349999996e-12,167781546,2373416,375438816
2770000,2171720000,21490663,2.9012395049999994e-12,169584070,2370028,377808844
2775000,2986119250,21411974,2.8906164899999996e-12,167026676,2370576,380179420
2780000,2442506625,21449854,2.89573029e-12,168257800,2369820,382549240
2785000,2262452000,21430395,2.8931033249999994e-12,167625377,2370036,384919276
2790000,2688083875,21458789,2.896936515e-12,168548183,2373064,387292340
2795000,2162246875,21458413,2.8968857549999996e-12,168535947,2371684,389664024
2800000,2364227958,21421919,2.891959065e-12,167349897,2371560,392035584
2805000,2094464500,21559916,2.9105886599999997e-12,169611205,2368080,394403664
2810000,2077599916,21445092,2.89508742e-12,168103017,2369416,396773080
2815000,2051262250,21437087,2.8940067449999996e-12,167842864,2369460,399142540
2820000,2569845334,21455979,2.896557165e-12,168456858,2368640,401511180
2825000,2117099625,21502934,2.9028960899999998e-12,167759260,2363728,403874908
2830000,2387994833,21479764,2.89976814e-12,169229852,2371380,406246288
2835000,2221825666,21422418,2.89202643e-12,167366133,2371492,408617780
2840000,2109913209,21481703,2.900029905e-12,169292891,2370392,410988172
2845000,2918322375,21457541,2.8967680349999997e-12,168507615,2370408,413358580
2850000,2532225041,21481865,2.900051775e-12,169298162,2371176,415729756
2855000,2277105750,21474753,2.899091655e-12,169067023,2371400,418101156
2860000,2656431083,21501993,2.902769055e-12,167728699,2369312,420470468
2865000,2202525167,21428310,2.8928218499999996e-12,167557601,2370152,422840620
2870000,2403815500,21464912,2.8977631199999995e-12,168747161,2371540,425212160
2875000,2095490708,21463212,2.89753362e-12,168691928,2371736,427583896
2880000,3277590458,21492034,2.90142459e-12,167182647,2369820,429953716
2885000,2313230709,21299971,2.875496085e-12,163386603,2369388,432323104
2890000,2210383083,21305157,2.876196195e-12,163555148,2372172,434695276
2895000,2525668750,21348433,2.8820384549999995e-12,164961591,2373328,437068604
2900000,2223773125,21552109,2.909534715e-12,169357464,2367660,439436264
2905000,2777414167,21480127,2.8998171449999998e-12,169241664,2370980,441807244
2910000,2259071959,21445225,2.8951053749999995e-12,168107351,2369736,444176980
2915000,2106795208,21423918,2.8922289299999997e-12,167414872,2371244,446548224
2920000,2179184584,21460865,2.897216775e-12,168615628,2371336,448919560
2925000,3163845667,21427062,2.89265337e-12,167517037,2369836,451289396
2930000,2119148500,21460241,2.8971325349999997e-12,168595372,2366244,453655640
2935000,3077433916,21479214,2.89969389e-12,166988363,2368656,456024296
2940000,2281213166,21471018,2.8985874299999996e-12,168945620,2369428,458393724
2945000,2347365791,21438023,2.894133105e-12,167873286,2369936,460763660
2950000,2347150042,21457684,2.89678734e-12,168512256,2369352,463133012
2955000,2392666042,21416852,2.8912750199999995e-12,167185216,2367156,465500168
2960000,2282370375,21452338,2.8960656299999995e-12,168338533,2368148,467868316
2965000,2094567250,21426934,2.8926360899999994e-12,167512882,2371128,470239444
2970000,2261621084,21527160,2.9061666e-12,168546629,2369776,472609220
2975000,2162010625,21470188,2.89847538e-12,168918629,2371572,474980792
2980000,2285158917,21441736,2.8946343599999995e-12,167993955,2369684,477350476
2985000,2318150333,21474227,2.899020645e-12,169049904,2366928,479717404
2990000,2128665542,21424852,2.8923550199999997e-12,167445216,2371148,482088552
2995000,20078741041,317755158,4.289694633e-11,168751594,-119380600,362707952
3000000,2042625000,21420141,2.8917190349999996e-12,167292122,2368068,365076020
3005000,2362304583,21451203,2.8959124049999995e-12,168301642,2370224,367446244
3010000,2082174750,21424653,2.892328155e-12,167438761,2371668,369817912
3015000,2985557167,21537711,2.9075909849999996e-12,168600603,2368580,372186492
3020000,2257497083,21486120,2.9006262e-12,169436433,2366884,374553376
3025000,4713028084,21340896,2.88102096e-12,164716646,2370712,376924088
3030000,3263149667,21385108,2.88698958e-12,163641001,2369400,379293488
3035000,2144880834,21275195,2.8721513249999996e-12,162581379,2369844,381663332
3040000,2113209917,21305450,2.8762357499999994e-12,163564661,2367544,384030876
3045000,2742033875,21308616,2.87666316e-12,163667556,2370888,386401764
3050000,2155462042,21351973,2.882516355e-12,162564118,2370440,388772204
3055000,2143064584,21355085,2.882936475e-12,165177789,2370440,391142644
3060000,2298691167,21308916,2.87670366e-12,163677287,2371440,393514084
3065000,2139068834,21365683,2.884367205e-12,165522218,2367556,395881640
3070000,3837616792,21484117,2.9003557949999997e-12,169371352,2367872,398249512
3075000,2394087708,21466276,2.89794726e-12,168791511,2369892,400619404
3080000,2267985375,21560050,2.91060675e-12,169326608,2370972,402990376
3085000,2895178917,21474817,2.8991002949999996e-12,169069088,2369324,405359700
3090000,2305704792,21443437,2.8948639949999997e-12,168049239,2370084,407729784
3095000,2111426625,21493767,2.901658545e-12,169684967,2368960,410098744
3100000,2294746375,21454840,2.8964033999999996e-12,168419816,2369496,412468240
3105000,2893646458,21496125,2.901976875e-12,169761592,2374364,414842604
3110000,2153915458,21470600,2.898531e-12,168932038,2367632,417210236
3115000,2772942375,21533674,2.9070459899999994e-12,168469412,2371080,419581316
3120000,2095181250,21446432,2.89526832e-12,168146566,2367784,421949100
3125000,2134769333,21438702,2.89422477e-12,167895357,2368956,424318056
3130000,2291187541,21438577,2.894207895e-12,167891288,2372528,426690584
3135000,2158983875,21554111,2.909804985e-12,169133600,2367696,429058280
3140000,3658271250,21458419,2.8968865649999997e-12,168536146,2368492,431426772
3145000,2223046125,21469531,2.8983866849999995e-12,168897278,2368932,433795704
3150000,2274932958,21548254,2.90901429e-12,168943239,2373000,436168704
3155000,2341878209,21451453,2.895946155e-12,168309765,2372036,438540740
3160000,2047263709,21468305,2.8982211749999996e-12,168857460,2372808,440913548
3165000,2990987375,21611814,2.91759489e-12,171008961,2366932,443280480
3170000,2200519209,21599409,2.915920215e-12,173118336,2366460,445646940
3175000,3172289916,21527669,2.906235315e-12,170786765,2372364,448019304
3180000,2275450916,21483260,2.9002400999999994e-12,169343484,2371020,450390324
3185000,2219789708,21568718,2.9117769299999996e-12,169608344,2367344,452757668
3190000,2326795375,21470224,2.8984802399999996e-12,168919817,2369772,455127440
3195000,2232826208,21456496,2.8966269599999995e-12,168473637,2366460,457493900
3200000,2253593625,21468162,2.8982018699999995e-12,168852802,2372332,459866232
3205000,2644050625,21613105,2.9177691749999995e-12,171050903,2370388,462236620
3210000,3637267500,21363114,2.88402039e-12,165438734,2369556,464606176
3215000,2034705958,21379529,2.886236415e-12,165972207,2367632,466973808
3220000,2257886833,21406196,2.8898364599999998e-12,164326356,2368376,469342184
3225000,2066897916,21376142,2.88577917e-12,165862162,2368880,471711064
3230000,2267696375,21304394,2.87609319e-12,163530337,2371604,474082668
3235000,3029820500,21487834,2.90085759e-12,166979586,2368552,476451220
3240000,2224903125,21297078,2.8751055299999995e-12,163292569,2369124,478820344
3245000,2060055375,21386909,2.887232715e-12,166212061,2369480,481189824
3250000,2288413250,21297368,2.8751446799999995e-12,163302000,2366412,483556236
3255000,2704518709,21447396,2.89539846e-12,165665367,2370248,485926484
3260000,2097003791,21299441,2.8754245349999993e-12,163369364,2369620,488296104
3265000,2643337333,21316460,2.8777220999999996e-12,163922478,2368556,490664660
3270000,2263934458,21314717,2.8774867949999996e-12,163865826,2370756,493035416
3275000,2924293084,21406681,2.8899019349999996e-12,164342120,2372060,495407476
3280000,4096101917,21370819,2.885060565e-12,165689136,2371232,497778708
3285000,4965448041,21341348,2.88108198e-12,164731331,2373080,500151788
3290000,2238827667,21372340,2.8852659e-12,165738573,2370436,502522224
3295000,2042143042,21305153,2.8761956549999996e-12,163554989,2368456,504890680
3300000,2272564542,21389304,2.8875560399999995e-12,163777377,2365968,507256648
3305000,2605969959,21333893,2.880075555e-12,164489040,2371188,509627836
3310000,2045081125,21211249,2.863518615e-12,160503108,2368172,511996008
3315000,2241957333,21190732,2.8607488199999998e-12,159836324,2371048,514367056
3320000,2307415625,21288993,2.874014055e-12,160517271,2369412,516736468
3325000,2545394583,21204347,2.8625868449999998e-12,160278811,2374580,519111048
3330000,2268932709,21276163,2.8722820049999997e-12,162612843,2371248,521482296
3335000,2090219875,21366471,2.884473585e-12,165547854,2365148,523847444
3340000,2136452667,21341598,2.8811157299999995e-12,164739475,2372080,526219524
3345000,2843247666,21374912,2.88561312e-12,165822164,2371152,528590676
3350000,3627021166,21356890,2.8831801499999995e-12,165236465,2373372,530964048
3355000,2071590000,21398332,2.8887748199999997e-12,164070784,2371344,533335392
3360000,2250271709,21323949,2.878733115e-12,164165860,2367668,535703060
3365000,3109588542,21326941,2.879137035e-12,164263098,2370356,538073416
3370000,2323498209,21406097,2.889823095e-12,164323126,2368628,540442044
3375000,2498900917,21315611,2.8776074849999997e-12,163894892,2372480,542814524
3380000,17958516708,355735987,4.802435824499999e-11,165319559,-133480712,409333812
3385000,2610343416,21321783,2.878440705e-12,164095489,2366112,411699924
3390000,2150896417,21362702,2.88396477e-12,165425344,2367920,414067844
3395000,3079286000,21430690,2.8931431499999997e-12,164804988,2370744,416438588
3400000,2186501291,21344967,2.8815705449999995e-12,164848947,2369712,418808300
3405000,2161236084,21368826,2.88479151e-12,165624395,2374284,421182584
3410000,2086366541,21341977,2.881166895e-12,164751790,2369420,423552004
3415000,8853469375,21416504,2.89122804e-12,164060932,2367836,425919840
3420000,3832281084,21324796,2.87884746e-12,164193392,2372100,428291940
3425000,2241736958,21297951,2.875223385e-12,163320954,2370596,430662536
3430000,2241891792,21291704,2.8743800399999997e-12,163117925,2369340,433031876
3435000,2360081208,21294409,2.8747452149999996e-12,163205816,2367988,435399864
3440000,2268518750,21377257,2.8859296949999996e-12,163068413,2368908,437768772
3445000,2764403291,21285299,2.8735153649999997e-12,162909738,2369600,440138372
3450000,2088445084,21290112,2.8741651199999994e-12,163066157,2369484,442507856
3455000,2560763625,21377300,2.8859354999999995e-12,165899787,2374564,444882420
3460000,2253006583,21391074,2.8877949899999997e-12,166347438,2370276,447252696
3465000,2467134500,21439563,2.894341005e-12,167923323,2371488,449624184
3470000,2163580042,21473589,2.8989345149999997e-12,169029168,2369964,451994148
3475000,3081597458,21518441,2.904989535e-12,167656886,2371156,454365304
3480000,2053694375,21450910,2.89587285e-12,168292106,2368804,456734108
3485000,3002958000,21446459,2.895271965e-12,168147463,2369816,459103924
3490000,3645576875,21422561,2.892045735e-12,167370766,2371128,461475052
3495000,2334916958,21552838,2.90963313e-12,168774793,2370832,463845884
3500000,2273545792,21399680,2.8889567999999996e-12,166627134,2368900,466214784
3505000,2127627875,21450697,2.8958440949999996e-12,168285189,2372980,468587764
3510000,2222267833,21533868,2.90707218e-12,168158271,2371148,470958912
3515000,2304676125,21439578,2.89434303e-12,167923820,2369788,473328700
3520000,2290708250,21494174,2.90171349e-12,169698176,2366752,475695452
3525000,2640986917,21422044,2.8919759399999996e-12,167353972,2368988,478064440
3530000,2216552666,21548773,2.9090843549999995e-12,168642698,2370400,480434840
3535000,3106658125,21440374,2.89445049e-12,167949695,2370980,482805820
3540000,2213129250,21451116,2.8959006599999995e-12,168298801,2370656,485176476
3545000,2402097625,21464047,2.8976463449999995e-12,168719062,2363864,487540340
3550000,2097031833,21434600,2.8936709999999995e-12,167762038,2372752,489913092
3555000,2727246583,21500745,2.9026005749999997e-12,169911733,2371328,492284420
3560000,3459587584,21318648,2.8780174799999995e-12,163993589,2371692,494656112
3565000,2318232875,21465826,2.8978865099999996e-12,165946925,2371056,497027168
3570000,2226145333,21500920,2.9026241999999996e-12,169917422,2371696,499398864
3575000,2520250125,21334361,2.8801387349999996e-12,164504276,2372324,501771188
3580000,2234147708,21401765,2.8892382749999997e-12,163864941,2369536,504140724
3585000,2087670167,21330306,2.8795913099999995e-12,164372492,2368864,506509588
3590000,2256923125,21333315,2.879997525e-12,164470282,2368620,508878208
3595000,3004512375,21335031,2.8802291849999997e-12,164526051,2369868,511248076
3600000,2243707334,21402872,2.8893877199999997e-12,163900901,2374936,513623012
3605000,2130109334,21347982,2.8819775699999994e-12,164946940,2371852,515994864
3610000,2139494542,21310510,2.8769188499999996e-12,163729098,2368568,518363432
3615000,2604875167,21309572,2.8767922199999997e-12,163698614,2371148,520734580
3620000,2317454417,21266857,2.871025695e-12,162310390,2369516,523104096
3625000,2694193875,21321663,2.8784245049999998e-12,164091586,2371656,525475752
3630000,4012578042,21277055,2.8724024249999995e-12,162641827,2373336,527849088
3635000,3348133625,21405869,2.8897923149999996e-12,163998324,2368164,530217252
3640000,2237335292,21315957,2.877654195e-12,163906153,2371304,532588556
3645000,2280349500,21307741,2.876545035e-12,163639111,2367524,534956080
3650000,2283134500,21417454,2.8913562899999997e-12,164374820,2369780,537325860
3655000,2496825708,21207728,2.86304328e-12,160388695,2371592,539697452
3660000,2271494625,21211569,2.863561815e-12,160513509,2370360,542067812
3665000,2617859375,21168883,2.8577992049999996e-12,159126228,2371608,544439420
3670000,2271350709,21176616,2.85884316e-12,159377551,2371396,546810816
3675000,3031028125,21206793,2.862917055e-12,160358320,2371620,549182436
3680000,2219029916,21257175,2.869718625e-12,161995717,2368656,551551092
3685000,2196805583,21358012,2.88333162e-12,165272907,2373204,553924296
3690000,2313182708,21298136,2.8752483600000002e-12,163326941,2366792,556291088
3695000,2407488041,21339571,2.8808420849999997e-12,164673592,2372092,558663180
3700000,2262427209,21452761,2.8961227349999996e-12,165522311,2371404,561034584
3705000,2392523542,21334733,2.880188955e-12,164516352,2371120,563405704
3710000,2115130375,21328575,2.8793576249999994e-12,164316223,2372020,565777724
3715000,2397563833,21285859,2.8735909649999993e-12,162927951,2367728,568145452
3720000,2263627625,21430565,2.893126275e-12,164800921,2369620,570515072
3725000,2851309667,21287503,2.8738129049999997e-12,162981371,2373312,572888384
3730000,6651996542,21440666,2.8944899099999997e-12,165129211,2367612,575255996
3735000,2756953542,21289827,2.874126645e-12,163056896,2365676,577621672
3740000,2042389125,21361981,2.8838674349999997e-12,165401904,2369488,579991160
3745000,2250222833,21390489,2.8877160149999998e-12,163498453,2372892,582364052
3750000,2419551667,21313810,2.8773643500000003e-12,163836362,2371156,584735208
3755000,2059116084,21344767,2.8815435449999996e-12,164842456,2369392,587104600
3760000,2768546458,21310502,2.87691777e-12,163728836,2374712,589479312
3765000,2218435125,21435080,2.8937358e-12,164947656,2371328,591850640
3770000,2230312208,21315996,2.87765946e-12,163907399,2369684,594220324
3775000,2318985166,21330324,2.8795937399999995e-12,164373058,2371148,596591472
3780000,2335178125,21422966,2.89210041e-12,164553963,2369620,598961092
3785000,2289212792,21308856,2.8766955599999996e-12,163675345,2370424,601331516
3790000,2104059708,21356406,2.88311481e-12,165220718,2372532,603704048
3795000,2232962791,21316088,2.87767188e-12,163910404,2371616,606075664
3800000,2621929292,21442023,2.894673105e-12,165173302,2372364,608448028
3805000,2099234083,21208949,2.863208115e-12,160428373,2367144,610815172
3810000,3005033375,21212952,2.86374852e-12,160558462,2370184,613185356
3815000,22466742458,398603267,5.3811441045e-11,159287568,-151151400,462033956
3820000,2052370541,21317147,2.8778148449999996e-12,160750912,2369476,464403432
3825000,2336478292,21158176,2.85635376e-12,158778242,2371348,466774780
3830000,2236671875,21182473,2.8596338549999996e-12,159567925,2368608,469143388
3835000,14393623292,21313943,2.877382305e-12,160646789,2372908,471516296
3840000,2179001083,21244002,2.86794027e-12,158373677,2369796,473886092
3845000,2092798875,21221793,2.864942055e-12,160845787,2367852,476253944
3850000,2280711417,21287179,2.873769165e-12,162970860,2368912,478622856
3855000,2089879875,21378741,2.8861300349999996e-12,165946615,2371668,480994524
3860000,2310544042,21321953,2.8784636549999998e-12,164101003,2369696,483364220
3865000,2279770333,21327126,2.8791620099999996e-12,164269141,2370616,485734836
3870000,2262543250,21319573,2.8781423549999997e-12,164023654,2373220,488108056
3875000,2322239208,21430476,2.8931142599999997e-12,164434114,2369496,490477552
3880000,2217902833,21314235,2.877421725e-12,163850182,2370616,492848168
3885000,2381746083,21325269,2.8789113149999998e-12,164208756,2366784,495214952
3890000,2369762375,21426410,2.89256535e-12,164301952,2371184,497586136
3895000,2200014458,21299604,2.87544654e-12,163374674,2368732,499954868
3900000,4258227250,21345165,2.8815972749999994e-12,164855381,2370092,502324960
3905000,2115645041,21397357,2.8886431949999997e-12,163357724,2370512,504695472
3910000,2244214583,21347517,2.8819147949999995e-12,164931846,2369528,507065000
3915000,2778053709,21304426,2.8760975099999997e-12,163531383,2365024,509430024
3920000,2140522917,21317726,2.8778930099999998e-12,163963643,2371552,511801576
3925000,3158735666,21458650,2.8969177499999996e-12,165349747,2370840,514172416
3930000,2237818458,21297391,2.8751477849999995e-12,163302732,2371084,516543500
3935000,2295590792,21357448,2.8832554799999996e-12,165254579,2367252,518910752
3940000,2241789083,21425365,2.8924242749999995e-12,164267998,2370872,521281624
3945000,2088831709,21266923,2.871034605e-12,162312544,2370364,523651988
3950000,2263076708,21224090,2.86525215e-12,160920465,2366460,526018448
3955000,2247820375,21210721,2.8634473349999996e-12,160485952,2371188,528389636
3960000,2259951041,21183579,2.8597831649999995e-12,159603841,2368460,530758096
3965000,3499954375,21187881,2.8603639349999997e-12,159743659,2371468,533129564
3970000,2828393958,21338835,2.8807427249999997e-12,164649679,2368004,535497568
3975000,2487766083,21371946,2.8852127099999996e-12,162531868,2372428,537869996
3980000,2252406084,21327005,2.879145675e-12,164265178,2368668,540238664
3985000,2768068250,21317818,2.87790543e-12,163966619,2371968,542610632
3990000,2162420125,21396639,2.888546265e-12,163334386,2375040,544985672
3995000,2745842125,21335919,2.8803490649999997e-12,164554886,2367752,547353424
4000000,2248793959,21310617,2.8769332949999996e-12,163732594,2369808,549723232
4005000,2806072167,21307815,2.876555025e-12,163641510,2374268,552097500
4010000,2248345875,21383938,2.8868316299999997e-12,162921620,2368456,554465956
4015000,2585020958,21355813,2.8830347549999994e-12,165201442,2373044,556839000
4020000,2235130292,21342291,2.8812092849999997e-12,164762002,2370788,559209788
4025000,2750605708,21380300,2.8863405e-12,165997276,2366460,561576248
4030000,2211655291,21398666,2.88881991e-12,163400259,2372152,563948400
4035000,2665388458,21326425,2.879067375e-12,164246343,2371960,566320360
4040000,4174143875,21336544,2.88043344e-12,164575217,2368668,568689028
4045000,2309150584,21376271,2.8857965850000002e-12,162672435,2368084,571057112
4050000,2183964583,21341261,2.8810702349999998e-12,164728521,2369088,573426200
4055000,2797507833,21304460,2.8761020999999994e-12,163532490,2371584,575797784
4060000,2230224750,21358671,2.883420585e-12,165294326,2368920,578166704
4065000,2657382958,21403263,2.8894405049999996e-12,163549659,2370920,580537624
4070000,2141654208,21346579,2.8817881649999996e-12,164901343,2369436,582907060
4075000,2226748291,21348884,2.8820993399999995e-12,164976258,2371440,585278500
4080000,2258662250,21419319,2.8916080649999996e-12,164071484,2369952,587648452
4085000,2455350792,21356552,2.8831345199999996e-12,165225477,2368224,590016676
4090000,2218687083,21315492,2.87759142e-12,163891028,2374772,592391448
4095000,2469420209,21357554,2.88326979e-12,165258055,2372888,594764336
4100000,2104180625,21464823,2.897751105e-12,165550387,2369304,597133640
4105000,3345565917,21299804,2.87547354e-12,163381172,2371104,599504744
4110000,3463055416,21173860,2.8584711e-12,159287969,2367348,601872092
4115000,2302488917,21303965,2.876035275e-12,160322488,2369780,604241872
4120000,2087747792,21338745,2.8807305749999995e-12,164646761,2372940,606614812
4125000,2786795166,21280907,2.8729224449999998e-12,162766997,2368300,608983112
4130000,2127596292,21368043,2.8846858049999997e-12,165598936,2369640,611352752
4135000,2453099250,21413644,2.8908419399999997e-12,163887068,2371072,613723824
4140000,2190488875,21353634,2.8827405899999997e-12,165130633,2371916,616095740
4145000,2714746708,21153612,2.8557376199999997e-12,158629914,2367656,618463396
4150000,2238331916,21299201,2.875392135e-12,160167659,2365856,620829252
4155000,2085852292,21190997,2.860784595e-12,159844936,2370044,623199296
4160000,2284996292,21203090,2.86241715e-12,160237963,2366864,625566160
4165000,2133230500,21354524,2.88286074e-12,165159566,2371596,627937756
4170000,2343687375,21397927,2.8887201449999997e-12,163376246,2369336,630307092
4175000,2206848125,21362091,2.8838822849999994e-12,165405493,2369136,632676228
4180000,4422681750,21312036,2.8771248599999994e-12,163778697,2370580,635046808
4185000,2241895417,21352971,2.8826510849999995e-12,165109079,2371176,637417984
4190000,2317476750,21373719,2.885452065e-12,165783397,2368692,639786676
4195000,2392121208,21293656,2.8746435599999997e-12,163181356,2369768,642156444
4200000,2266047542,21465407,2.8978299449999997e-12,165569347,2372944,644529388
4205000,7907881375,21325952,2.8790035199999995e-12,164230965,2365952,646895340
4210000,2455452833,21410303,2.8903909049999997e-12,163778493,2369480,649264820
4215000,2176373042,21288115,2.8738955249999995e-12,163001271,2371512,651636332
4220000,2282738875,21346883,2.881829205e-12,164911228,2368780,654005112
4225000,2312649625,21378573,2.8861073549999996e-12,162747239,2373304,656378416
4230000,2058019458,21333831,2.880067185e-12,164487054,2371640,658750056
4235000,2239834667,21294607,2.874771945e-12,163212258,2369936,661119992
4240000,3046895542,21293787,2.8746612449999995e-12,163185606,2368080,663488072
4245000,2113048375,21400877,2.8891183949999998e-12,163472133,2369556,665857628
4250000,2774346667,21297547,2.8751688449999997e-12,163307797,2372656,668230284
4255000,2355650000,21342105,2.8811841749999996e-12,164755957,2371780,670602064
4260000,2183125958,21374911,2.885612985e-12,162628217,2369840,672971904
4265000,2302940000,21184738,2.85993963e-12,159641518,2370408,675342312
4270000,2169123042,21260565,2.870176275e-12,162105876,2371532,677713844
4275000,2295006500,21435263,2.8937605049999997e-12,164589679,2369296,680083140
4280000,2532035333,21172035,2.858224725e-12,159228678,2370292,682453432
4285000,2265286916,21133760,2.8530575999999998e-12,157984738,2372476,684825908
4290000,2747055958,21198129,2.861747415e-12,160076715,2370352,687196260
4295000,2309112375,21262721,2.8704673349999997e-12,158982050,2368612,689564872
4300000,2065244541,21170972,2.85808122e-12,159194122,2371188,691936060
4305000,33684973792,447202412,6.037232561999999e-11,159156038,-170548288,521387772
4310000,2037267750,21341864,2.8811516399999998e-12,164748112,2371124,523758896
4315000,3566598917,21267987,2.871178245e-12,162347100,2370324,526129220
4320000,2076438917,21360985,2.8837329749999996e-12,165369556,2369480,528498700
4325000,2042849292,21292149,2.8744401149999996e-12,163132377,2368040,530866740
4330000,2363582166,21428121,2.892796335e-12,163949257,2372524,533239264
4335000,2233729792,21311998,2.87711973e-12,163777483,2370332,535609596
4340000,2312871625,21317188,2.87782038e-12,163946143,2371584,537981180
4345000,2180908875,21335217,2.8802542949999998e-12,164532076,2367212,540348392
4350000,2075685250,21395830,2.8884370499999997e-12,162899789,2368492,542716884
4355000,2094744500,21324236,2.87877186e-12,164175215,2369884,545086768
4360000,2831741083,21301625,2.8757193749999994e-12,163440333,2369976,547456744
4365000,2231715292,21460240,2.8971324e-12,164993119,2366496,549823240
4370000,2438943458,21298640,2.8753164000000003e-12,163343332,2366916,552190156
4375000,2264266333,21363808,2.8841140799999997e-12,165461301,2370724,554560880
4380000,2458771500,21314268,2.8774261799999994e-12,163851253,2368188,556929068
4385000,2635319417,21451837,2.8959979949999996e-12,164720039,2372380,559301448
4390000,2430661208,21366837,2.8845229949999998e-12,165559748,2370356,561671804
4395000,2220769125,21347379,2.8818961649999994e-12,164927341,2371256,564043060
4400000,2105083084,21484123,2.9003566049999995e-12,165769321,2367140,566410200
4405000,2293357875,21349052,2.8821220199999996e-12,164981712,2373596,568783796
4410000,2395176208,21332521,2.879890335e-12,164444456,2370732,571154528
4415000,2249826625,21199765,2.861968275e-12,160129888,2374068,573528596
4420000,2454987708,21294763,2.8747930049999997e-12,159615140,2369552,575898148
4425000,2292955750,21144580,2.8545182999999997e-12,158336383,2370584,578268732
4430000,2464997083,21215244,2.86405794e-12,160632947,2370472,580639204
4435000,2105220167,21392476,2.8879842599999997e-12,162790798,2369064,583008268
4440000,2306890125,21348375,2.882030625e-12,164959727,2373804,585382072
4445000,2102882208,21304912,2.8761631199999997e-12,163547172,2371800,587753872
4450000,2103375334,21307080,2.8764557999999996e-12,163617634,2372760,590126632
4455000,2721601542,21363772,2.8841092199999996e-12,165460135,2370880,592497512
4460000,2822926291,21283839,2.873318265e-12,162862312,2373704,594871216
4465000,2263856292,21304845,2.8761540749999995e-12,163545012,2369344,597240560
4470000,2163369250,21453620,2.8962387e-12,164777983,2368204,599608764
4475000,2244735084,21284882,2.8734590699999998e-12,162896199,2367152,601975916
4480000,2391809416,21335447,2.8802853449999995e-12,164539553,2370764,604346680
4485000,2338918625,21418637,2.891515995e-12,163641020,2370868,606717548
4490000,3293609208,21350084,2.8822613399999998e-12,165015266,2366956,609084504
4495000,2257909125,21314873,2.877507855e-12,163870920,2368092,611452596
4500000,2057426041,21298897,2.875351095e-12,163351695,2370872,613823468
4505000,2290233708,21294956,2.8748190599999996e-12,163223593,2368244,616191712
4510000,2642832833,21342368,2.8812196799999998e-12,164764500,2368184,618559896
4515000,2195730458,21339743,2.880865305e-12,164679195,2365968,620925864
4520000,5157054208,21460099,2.897113365e-12,164988545,2367772,623293636
4525000,2305091459,21353568,2.8827316799999998e-12,165128493,2372548,625666184
4530000,2662439333,21311991,2.877118785e-12,163777252,2368512,628034696
4535000,2218590333,21439827,2.894376645e-12,164329710,2369420,630404116
4540000,2653742125,21284771,2.8734440849999995e-12,162892603,2366924,632771040
4545000,2164428917,21317193,2.8778210549999996e-12,163946288,2368980,635140020
4550000,2900504667,21278076,2.8725402599999996e-12,162675011,2366440,637506460
4555000,2302439375,21435591,2.893804785e-12,164192045,2372020,639878480
4560000,2311228542,21347588,2.88192438e-12,164934144,2371312,642249792
4565000,2257671541,21304290,2.8760791499999995e-12,163526965,2368020,644617812
4570000,2258620666,21355249,2.882958615e-12,165183113,2369572,646987384
4575000,2245785000,21238704,2.8672250399999996e-12,161395396,2368136,649355520
4580000,2218812000,21205046,2.8626812099999996e-12,160301518,2370712,651726232
4585000,2119650916,21156682,2.8561520699999994e-12,158729696,2368544,654094776
4590000,2375221041,21322047,2.8784763449999997e-12,160501860,2366004,656460780
4595000,2301153958,21291578,2.8743630299999994e-12,163113820,2368080,658828860
4600000,2565743750,21352386,2.88257211e-12,165090067,2370668,661199528
4605000,2117470917,21453214,2.89618389e-12,164764805,2369756,663569284
4610000,2451998000,21142871,2.854287585e-12,158280855,2369860,665939144
4615000,2227877334,21221802,2.8649432699999997e-12,160846098,2369952,668309096
4620000,2931350333,21355751,2.8830263849999997e-12,165199443,2368664,670677760
4625000,2183389834,21405554,2.8897497899999997e-12,163215849,2372000,673049760
4630000,2715952709,21334041,2.8800955349999997e-12,164493884,2372916,675422676
4635000,2228802333,21312553,2.877194655e-12,163795509,2370864,677793540
4640000,2813942875,21307704,2.8765400399999997e-12,163637925,2366320,680159860
4645000,2252992375,21439874,2.8943829899999997e-12,164331253,2370840,682530700
4650000,2321695417,21287530,2.8738165499999996e-12,162982247,2367280,684897980
4655000,2146779958,21364890,2.8842601499999998e-12,165496469,2369124,687267104
4660000,2260690375,21284294,2.8733796899999994e-12,162877077,2372548,689639652
4665000,2114332584,21341744,2.8811354399999997e-12,164744200,2367812,692007464
4670000,2450495666,21303987,2.876038245e-12,163517118,2369312,694376776
4675000,2212946417,21446734,2.8953090899999995e-12,164554173,2372060,696748836
4680000,2342420875,21338541,2.880703035e-12,164640099,2369064,699117900
4685000,2264318209,21306601,2.8763911349999995e-12,163602081,2372856,701490756
4690000,2551239500,21346524,2.88178074e-12,164899554,2369024,703859780
4695000,2279346292,21453421,2.896211835e-12,164771499,2373312,706233092
4700000,2913576584,21339008,2.8807660799999996e-12,164655284,2368940,708602032
4705000,2324510167,21341088,2.8810468799999998e-12,164722879,2370448,710972480
4710000,2345193916,21337643,2.880581805e-12,164610934,2368584,713341064
4715000,2267626375,21306250,2.87634375e-12,163590648,2370612,715711676
4720000,2844965333,21330471,2.879613585e-12,164377833,2368208,718079884
4725000,2190442000,21304863,2.8761565049999996e-12,163545595,2371064,720450948
4730000,2094430625,21398867,2.888847045e-12,162998498,2370200,722821148
4735000,2149401000,21187001,2.8602451349999993e-12,159715046,2368960,725190108
4740000,6824226417,21280942,2.8729271699999997e-12,158805734,2371512,727561620
4745000,2215955083,21194611,2.8612724849999995e-12,159962376,2368664,729930284
4750000,2406740916,21172795,2.8583273249999997e-12,159253373,2371120,732301404
4755000,2304516750,21206829,2.8629219149999995e-12,160359473,2371256,734672660
4760000,2503042666,21439559,2.8943404649999997e-12,164321006,2367332,737039992
4765000,2272818625,21310485,2.8769154749999996e-12,163728313,2371156,739411148
4770000,2795260041,21340691,2.880993285e-12,164709976,2370060,741781208
4775000,2248552792,21436990,2.89399365e-12,164237504,2372052,744153260
4780000,2231698208,21337021,2.8804978349999997e-12,164590699,2367256,746520516
4785000,2326158916,21334526,2.88016101e-12,164509622,2369348,748889864
4790000,2288491625,21329590,2.8794946499999993e-12,164349207,2370888,751260752
4795000,2284957041,21450008,2.89575108e-12,164660580,2371660,753632412
4800000,2174083750,21330545,2.8796235749999994e-12,164380262,2369972,756002384
4805000,2952068500,21330642,2.8796366699999995e-12,164383409,2371244,758373628
4810000,2348582333,21333541,2.880028035e-12,164477602,2368116,760741744
4815000,2202409833,21306410,2.8763653499999995e-12,163595847,2372832,763114576
4820000,2458888084,21361234,2.88376659e-12,165377629,2370816,765485392
4825000,2064662500,21418078,2.8914405299999998e-12,163622877,2372424,767857816
4830000,2886862000,21339848,2.8808794799999997e-12,164682596,2371152,770228968
4835000,2100211625,21369698,2.88490923e-12,165652718,2370692,772599660
4840000,2381449958,21304201,2.876067135e-12,163524053,2368128,774967788
4845000,2240751375,21461510,2.89730385e-12,165034396,2371176,777338964
4850000,14647771250,21428098,2.89279323e-12,163588276,2373532,779712496
4855000,2219632917,21343803,2.8814134049999997e-12,164811124,2368620,782081116
4860000,29698766875,502234019,6.7801592565e-11,160998571,-193473688,588607428
4865000,2298920292,21306736,2.8764093599999996e-12,163606439,2368684,590976112
4870000,2970311167,21330782,2.8796555699999995e-12,164387963,2369000,593345112
4875000,2051261875,21594708,2.9152855799999995e-12,168898059,2370396,595715508
4880000,2294553416,21418647,2.8915173449999996e-12,167243553,2370048,598085556
4885000,2101784667,21333308,2.8799965799999997e-12,164470034,2371288,600456844
4890000,2367964292,21323282,2.87864307e-12,164144195,2371140,602827984
4895000,2060286042,21459102,2.89697877e-12,164490893,2366876,605194860
4900000,2741843083,21321239,2.8783672649999995e-12,164077813,2371560,607566420
4905000,2227211917,21236953,2.8669886549999996e-12,161338522,2368432,609934852
4910000,2290993333,21221483,2.8649002049999996e-12,160835741,2368520,612303372
4915000,2297866667,21179705,2.8592601749999998e-12,159477938,2369332,614672704
4920000,2149831292,21182475,2.8596341249999996e-12,159567971,2368016,617040720
4925000,2275920916,21190200,2.8606769999999998e-12,159819029,2370252,619410972
4930000,2525883709,21303177,2.8759288949999998e-12,159423299,2372880,621783852
4935000,2064757167,21214325,2.8639338749999997e-12,160603108,2369748,624153600
4940000,4093569000,21201641,2.862221535e-12,160190882,2368932,626522532
4945000,2036433791,21309902,2.87683677e-12,159641870,2369068,628891600
4950000,2237710667,21211986,2.8636181099999997e-12,160527068,2369612,631261212
4955000,2089735542,21200089,2.8620120149999997e-12,160140407,2370632,633631844
4960000,2376587917,21141822,2.85414597e-12,158246741,2372860,636004704
4965000,2255010916,21296921,2.8750843349999997e-12,159219987,2370792,638375496
4970000,2303997500,21115568,2.8506016799999996e-12,157393488,2372400,640747896
4975000,2275072500,21171717,2.858181795e-12,159218348,2369536,643117432
4980000,2472554625,21298134,2.8752480899999995e-12,159259398,2368800,645486232
4985000,2288030667,21144377,2.8544908949999998e-12,158329802,2367256,647853488
4990000,2571960208,21167589,2.8576245149999998e-12,159084158,2369172,650222660
4995000,2201547333,21149856,2.8552305599999993e-12,158507854,2371764,652594424
5000000,2405548125,21301955,2.8757639249999997e-12,159383607,2373380,654967804
5005000,2082892542,22274941,3.0071170349999998e-12,169970620,2375504,657343308
5010000,6083018625,22225282,3.00041307e-12,168356684,2371912,659715220
5015000,2103499542,22244429,3.0029979149999996e-12,168978982,2374904,662090124
5020000,2355077583,22227045,3.0006510749999996e-12,168413994,2375624,664465748
5025000,2268952667,22304132,3.01105782e-12,170919309,2376496,666842244
5030000,2713200958,22551625,3.044469375e-12,174895367,2374604,669216848
5035000,2155242417,22392700,3.0230144999999994e-12,173797772,2371824,671588672
5040000,2163501459,22429592,3.0279949199999997e-12,174996747,2372932,673961604
5045000,2160833750,22368492,3.01974642e-12,173011004,2372148,676333752
5050000,2365586625,22551311,3.0444269849999997e-12,174885163,2374016,678707768
5055000,2287328833,22407888,3.02506488e-12,174291401,2377064,681084832
5060000,2513817917,22406848,3.0249244799999996e-12,174257570,2375460,683460292
5065000,2298106083,22522957,3.0405991949999995e-12,173963638,2376596,685836888
5070000,2554431334,22381960,3.0215645999999997e-12,173448734,2371848,688208736
5075000,2513723000,22388732,3.02247882e-12,173668808,2373152,690581888
5080000,2443694041,22361880,3.0188538e-12,172796109,2372712,692954600
5085000,2298678792,22380942,3.02142717e-12,173415653,2376392,695330992
5090000,2215676834,22421124,3.02685174e-12,174721569,2378228,697709220
5095000,2244242208,22390902,3.02277177e-12,173739339,2375780,700085000
5100000,2381237041,22543117,3.043320795e-12,174618847,2374980,702459980
5105000,2255793334,22367336,3.0195903599999995e-12,172973447,2373624,704833604
5110000,2357638500,22414760,3.0259925999999996e-12,174514720,2374552,707208156
5115000,2258281708,22480724,3.0348977399999997e-12,172591093,2373856,709582012
5120000,2892180417,22409803,3.0253234049999997e-12,174353626,2374444,711956456
5125000,2227408208,22383657,3.0217936949999997e-12,173503870,2373252,714329708
5130000,2662478292,22407512,3.02501412e-12,174279161,2374752,716704460
5135000,2217468084,22557584,3.0452738399999997e-12,175089041,2376688,719081148
5140000,3077861666,22407422,3.02500197e-12,174276249,2374296,721455444
5145000,2231110250,22374906,3.02061231e-12,173219476,2374736,723830180
5150000,5459394042,22551619,3.0444685649999993e-12,174895176,2372904,726203084
5155000,2371606042,22403486,3.0244706099999996e-12,174148320,2374308,728577392
5160000,2968555958,22239560,3.0023406e-12,168820736,2374376,730951768
5165000,2312326791,22274698,3.0070842299999996e-12,169962714,2373212,733324980
5170000,2069338500,22354469,3.0178533149999995e-12,168487815,2374816,735699796
5175000,2195965250,22288034,3.0088845899999997e-12,170396129,2371924,738071720
5180000,2282157292,22201192,2.99716092e-12,167573755,2372280,740444000
5185000,2202424417,22407258,3.0249798299999996e-12,170203446,2371088,742815088
5190000,2330538584,22223228,3.0001357799999996e-12,168289945,2375640,745190728
5195000,2313818500,22287983,3.0088777049999997e-12,170394478,2377480,747568208
5200000,2367476000,22407607,3.025026945e-12,174282255,2375588,749943796
5205000,2255344666,22445319,3.0301180649999996e-12,175507883,2376568,752320364
5210000,2790761125,22418212,3.0264586199999994e-12,174626932,2374428,754694792
5215000,2097864459,22396454,3.02352129e-12,173919786,2373036,757067828
5220000,2894255583,22387188,3.02227038e-12,173618632,2374676,759442504
5225000,2043627041,22409844,3.02532894e-12,174354945,2376264,761818768
5230000,2561876083,22401154,3.02415579e-12,174072516,2370912,764189680
5235000,2297757375,22496377,3.0370108949999997e-12,173099786,2371272,766560952
5240000,2621558334,22392622,3.0230039699999996e-12,173795230,2371492,768932444
5245000,2208904667,22418912,3.02655312e-12,174649672,2378000,771310444
5250000,2075129833,22396900,3.0235814999999996e-12,173934265,2373540,773683984
5255000,2081298750,22549826,3.0442265099999995e-12,174836908,2378448,776062432
5260000,2738934416,22404077,3.024550395e-12,174167526,2378420,778440852
5265000,2212048375,22383076,3.0217152599999995e-12,173484985,2378232,780819084
5270000,2077539958,22440588,3.0294793799999996e-12,175354119,2375780,783194864
5275000,2300874500,22379092,3.02117742e-12,173355499,2374328,785569192
5280000,2107523083,22398103,3.023743905e-12,173973374,2375368,787944560
5285000,2078194875,22434293,3.0286295549999994e-12,175149553,2373652,790318212
5290000,2428058209,22506561,3.038385735e-12,173430790,2376136,792694348
5295000,2038165833,22443580,3.0298833e-12,175451359,2372568,795066916
5300000,2313141584,22378161,3.021051735e-12,173325255,2373824,797440740
5305000,2110354583,22525196,3.0409014599999994e-12,174036435,2379680,799820420
5310000,2491147666,22229358,3.0009633299999995e-12,168489152,2373280,802193700
5315000,2115533750,22217458,2.9993568299999995e-12,168102411,2372620,804566320
5320000,2877712667,22233318,3.00149793e-12,168617868,2375600,806941920
5325000,2122980625,22450454,3.03081129e-12,171607319,2376876,809318796
5330000,2836618041,22372972,3.02035122e-12,173156603,2376272,811695068
5335000,2245644750,22381776,3.0215397599999996e-12,173442746,2375816,814070884
5340000,2225455583,22377912,3.0210181199999995e-12,173317151,2373580,816444464
5345000,2131575833,22396848,3.02357448e-12,173932588,2376272,818820736
5350000,2279277750,22368140,3.0196989e-12,172999556,2377456,821198192
5355000,2249105458,22414244,3.02592294e-12,174497959,2376612,823574804
5360000,8359059667,22354023,3.017793105e-12,172540774,2376320,825951124
5365000,2154810625,22537343,3.042541305e-12,174024444,2373712,828324836
5370000,2993555042,22363431,3.0190631849999998e-12,172846531,2374580,830699416
5375000,2166233042,22368181,3.019704435e-12,173000910,2377868,833077284
5380000,2081694334,22420895,3.0268208249999995e-12,174714119,2373748,835451032
5385000,2241039167,22357015,3.0181970249999997e-12,172638012,2377496,837828528
5390000,2423467833,22531647,3.0417723449999998e-12,174246088,2376668,840205196
5395000,2261043125,22377215,3.0209240249999995e-12,173294515,2373932,842579128
5400000,2599965125,22363623,3.019089105e-12,172852775,2375404,844954532
5405000,2182821625,22424932,3.0273658199999996e-12,174845301,2373928,847328460
5410000,2126900958,22549155,3.0441359249999997e-12,174815101,2373632,849702092
5415000,2188503500,22390749,3.0227511149999996e-12,173734382,2374072,852076164
5420000,2983111292,22419391,3.026617785e-12,174665235,2376552,854452716
5425000,2147417958,22501975,3.037766625e-12,173281747,2372560,856825276
5430000,3063316709,22414611,3.0259724849999998e-12,174509872,2371116,859196392
5435000,2103113375,22372759,3.020322465e-12,173149698,2375652,861572044
5440000,14063596834,22358794,3.0184371899999997e-12,172695824,2368716,863940760
5445000,2043470000,22676739,3.0613597649999996e-12,174487341,2375880,866316640
5450000,3657704708,22359939,3.0185917649999997e-12,172733036,2372872,868689512
5455000,2075533458,22442931,3.029795685e-12,175430295,2376108,871065620
5460000,2908978833,22334429,3.015147915e-12,171903979,2377864,873443484
5465000,2244588792,22558081,3.0453409349999994e-12,175105183,2455476,875898960
5470000,2192241625,22414974,3.0260214899999996e-12,174521695,2557508,878456468
5475000,2235678666,22549988,3.0442483799999998e-12,178909640,2556608,881013076
5480000,2299942541,22700330,3.0645445499999996e-12,179728266,2556224,883569300
5485000,34792710416,565435118,7.633374092999999e-11,181447405,-219268304,664300996
5490000,2103589083,22576772,3.0478642199999997e-12,179780109,2552308,666853304
5495000,2413198042,22636770,3.05596395e-12,181730048,2555912,669409216
5500000,2112124834,22761926,3.0728600099999996e-12,181205548,2553660,671962876
5505000,2786036333,22593881,3.050173935e-12,180336169,2558380,674521256
5510000,5524300333,22477940,3.0345218999999998e-12,176568074,2551560,677072816
5515000,2390236250,22593774,3.0501594899999996e-12,175740613,2556316,679629132
5520000,2265444417,22509726,3.03881301e-12,177601123,2551152,682180284
5525000,2072490375,22538118,3.0426459299999997e-12,178523875,2552608,684732892
5530000,2137204250,22760285,3.0726384749999996e-12,181152234,2552300,687285192
5535000,2376515833,22622524,3.0540407399999997e-12,181267047,2554060,689839252
5540000,2276577000,22615009,3.0530262149999997e-12,181022835,2552476,692391728
5545000,2359083416,22661725,3.059332875e-12,182541098,2552652,694944380
5550000,2263473500,22612928,3.05274528e-12,180955200,2555020,697499400
5555000,2078815583,22645194,3.0571011899999998e-12,182003840,2555692,700055092
5560000,2160268875,22624052,3.0542470199999995e-12,181316712,2552040,702607132
5565000,2347095583,22769075,3.073825125e-12,181437900,2557436,705164568
5570000,2224610125,22646820,3.0573206999999993e-12,182056668,2553304,707717872
5575000,4758035584,22585440,3.0490344e-12,180061810,2553816,710271688
5580000,2109874125,22795417,3.0773812949999997e-12,182294007,2551456,712823144
5585000,2808561583,22582888,3.0486898799999998e-12,179978875,2557764,715380908
5590000,2079819250,22646607,3.057291945e-12,182049758,2552920,717933828
5595000,2986627500,22730041,3.0685555349999995e-12,180169315,2556720,720490548
5600000,2059341125,22612895,3.0527408249999994e-12,180954123,2552592,723043140
5605000,2944854083,22635349,3.0557721149999995e-12,181683877,2550108,725593248
5610000,2239814458,22644074,3.0569499899999997e-12,181967435,2554348,728147596
5615000,2826325417,22731804,3.0687935399999994e-12,180226588,2557048,730704644
5620000,2249491292,22651212,3.0579136199999997e-12,182199406,2554100,733258744
5625000,2503726125,22613017,3.0527572949999994e-12,180958070,2554528,735813272
5630000,2048230625,22656098,3.05857323e-12,182358216,2554564,738367836
5635000,2303429125,22625703,3.0544699049999998e-12,176778329,2554772,740922608
5640000,2301855417,22505336,3.0382203599999994e-12,177458458,2553752,743476360
5645000,2102791875,22455112,3.03144012e-12,175826170,2558324,746034684
5650000,2309705208,22447358,3.0303933299999997e-12,175574167,2554064,748588748
5655000,2310626625,22502153,3.0377906549999995e-12,177354991,2555864,751144612
5660000,2183481083,22598752,3.0508315199999997e-12,180494482,2554896,753699508
5665000,2311821542,22543017,3.0433072949999997e-12,178683089,2553644,756253152
5670000,2249259625,22482327,3.035114145e-12,176710642,2555820,758808972
5675000,2745462250,22543444,3.04336494e-12,178696970,2554488,761363460
5680000,2281901500,22781161,3.075456735e-12,181830693,2552792,763916252
5685000,2163432958,22625412,3.0544306199999997e-12,181360930,2554896,766471148
5690000,2178962375,22645084,3.0570863399999997e-12,182000248,2558540,769029688
5695000,2879136625,22635064,3.05573364e-12,181674599,2552828,771582516
5700000,2182827625,22788178,3.0764040299999994e-12,182058755,2557568,774140084
5705000,2186070583,22578699,3.0481243649999998e-12,179842747,2558376,776698460
5710000,2274479292,22656018,3.05856243e-12,182355622,2554920,779253380
5715000,5505903750,22764176,3.0731637599999996e-12,180819480,2558876,781812256
5720000,2220509959,22600694,3.0510936899999997e-12,180557590,2556732,784368988
5725000,2470052083,22599892,3.05098542e-12,180531523,2553012,786922000
5730000,2045210875,22763980,3.0731373e-12,181272330,2553128,789475128
5735000,2666620541,22657749,3.0587961149999995e-12,182411881,2552636,792027764
5740000,2225084000,22599725,3.0509628749999994e-12,180526086,2556948,794584712
5745000,2086230125,22663848,3.0596194799999998e-12,182610080,2554652,797139364
5750000,2188150542,22734577,3.0691678949999997e-12,180316725,2554256,799693620
5755000,3174379041,22641380,3.0565862999999995e-12,181879878,2555820,802249440
5760000,2258906083,22641187,3.0565602449999995e-12,181873598,2553060,804802500
5765000,2174045750,22611204,3.0525125399999997e-12,180899149,2553864,807356364
5770000,2229764000,22622762,3.05407287e-12,181274799,2555184,809911548
5775000,2387044625,22609804,3.05232354e-12,180853657,2557328,812468876
5780000,2280355916,22622909,3.054092715e-12,181279572,2554356,815023232
5785000,2168482958,22764637,3.0732259949999997e-12,181293658,2553976,817577208
5790000,2201189542,22625533,3.054446955e-12,181364863,2552796,820130004
5795000,2891575834,22605657,3.051763695e-12,180718882,2556840,822686844
5800000,2230628208,22605019,3.051677565e-12,176106105,2555888,825242732
5805000,2057916292,22461895,3.0323558249999994e-12,176046607,2556620,827799352
5810000,2310805541,22430780,3.0281552999999996e-12,175035363,2554856,830354208
5815000,2416884041,22541763,3.0431380049999998e-12,178642318,2554240,832908448
5820000,2288231375,22657868,3.05881218e-12,182415741,2554944,835463392
5825000,2218285209,22601176,3.05115876e-12,180573253,2552936,838016328
5830000,2201086750,22611892,3.0526054199999998e-12,180921500,2555276,840571604
5835000,2456633125,22781221,3.075464835e-12,181832642,2554880,843126484
5840000,2265204667,22603655,3.051493425e-12,180653799,2553576,845680060
5845000,2301877917,22667960,3.0601745999999997e-12,182743715,2553136,848233196
5850000,2371769750,22760139,3.072618765e-12,181147490,2554024,850787220
5855000,4572393166,22657909,3.058817715e-12,182417064,2556504,853343724
5860000,2039519209,22647132,3.05736282e-12,182066825,2550736,855894460
5865000,2925027584,22756956,3.07218906e-12,181044045,2554868,858449328
5870000,2135234959,22610379,3.052401165e-12,180872355,2558872,861008200
5875000,2285866958,22613136,3.05277336e-12,180961950,2552328,863560528
5880000,2346241375,22634055,3.0555974249999993e-12,181641812,2551992,866112520
5885000,2284592000,22765895,3.0733958249999994e-12,181334573,2557604,868670124
5890000,2252323875,22630596,3.05513046e-12,181529400,2555528,871225652
5895000,2982839834,22628603,3.054861405e-12,181464628,2557380,873783032
5900000,2225314000,22629061,3.054923235e-12,181479521,2555036,876338068
5905000,2487501166,22762851,3.0729848849999998e-12,181235629,2554940,878893008
5910000,2272028458,22639799,3.0563728649999994e-12,181828488,2554552,881447560
5915000,2380351333,22600672,3.05109072e-12,180556860,2553544,884001104
5920000,2279144167,22787694,3.0763386899999998e-12,182043032,2551572,886552676
5925000,5548990417,22597801,3.0507031349999994e-12,180463552,2552372,889105048
5930000,2302746500,22655316,3.05846766e-12,182332780,2555540,891660588
5935000,2108366250,22749296,3.0711549599999996e-12,180795077,2553668,894214256
5940000,2259150292,22652682,3.0581120699999995e-12,182247190,2554312,896768568
5945000,2056317708,22629818,3.05502543e-12,181504099,2551460,899320028
5950000,2279791292,22806301,3.0788506349999996e-12,182647755,2552676,901872704
5955000,2097767000,22515387,3.039577245e-12,177785091,2556548,904429252
5960000,2252778167,22446833,3.0303224549999996e-12,175557111,2555104,906984356
5965000,2217703042,22488365,3.035929275e-12,176906905,2553156,909537512
5970000,2158141417,22710182,3.0658745699999997e-12,179523879,2554860,912092372
5975000,2588215583,22627147,3.0546648449999996e-12,181417298,2553528,914645900
5980000,2274419709,22654057,3.058297695e-12,182291873,2554940,917200840
5985000,2635036875,22747453,3.0709061549999995e-12,180735198,2555336,919756176
5990000,2117674916,22650880,3.0578687999999995e-12,182188641,2553152,922309328
5995000,2730296833,22588354,3.0494277899999993e-12,180156532,2555448,924864776
6000000,2171315042,22786050,3.0761167499999998e-12,181989589,2556640,927421416
6005000,2304069917,22608646,3.05216721e-12,180816008,2555268,929976684
6010000,2120675667,22609496,3.0522819599999996e-12,180843645,2554476,932531160
6015000,2278542792,22637436,3.0560538599999996e-12,181751685,2557932,935089092
6020000,2180198583,22794519,3.0772600649999997e-12,182264845,2555304,937644396
6025000,2329878500,22657035,3.058699725e-12,182388672,2555032,940199428
6030000,2261707750,22612232,3.0526513199999996e-12,180932579,2555352,942754780
6035000,2307190542,22621200,3.0538619999999996e-12,181224012,2555384,945310164
6040000,2268308125,22729689,3.0685080149999994e-12,180157859,2554164,947864328
6045000,3085033833,22603996,3.0515394599999995e-12,180664899,2553068,950417396
6050000,2297107958,22587862,3.0493613699999996e-12,180140535,2550664,952968060
6055000,2556829167,22627000,3.0546449999999997e-12,181412523,2557164,955525224
6060000,6980759167,22747218,3.0708744299999994e-12,180727566,2556376,958081600
6065000,2072681834,22740760,3.0700026e-12,180517657,2555276,960636876
6070000,2238698250,22641830,3.05664705e-12,181894515,2553296,963190172
6075000,3488982333,22580428,3.04835778e-12,179898928,2555804,965745976
6080000,2811375583,22786602,3.0761912699999997e-12,182007519,2550680,968296656
6085000,2225195042,22595851,3.050439885e-12,180400167,2557428,970854084
6090000,2109714791,22587172,3.0492682199999995e-12,180118110,2557384,973411468
6095000,2277901917,22655103,3.0584389049999997e-12,182325869,2558900,975970368
6100000,2442979208,22621946,3.0539627099999997e-12,181248257,2556096,978526464
6105000,2265260875,22634817,3.0557002949999995e-12,181666592,2559184,981085648
6110000,2590816250,22805762,3.07877787e-12,187222283,2554088,983639736
6115000,2240894041,22885912,3.08959812e-12,185235109,2555660,986195396
6120000,8550172666,22801892,3.0782554199999998e-12,187096511,2551144,988746540
6125000,8549440500,22931014,3.0956868899999994e-12,185782518,2555328,991301868
6130000,2735170291,22808473,3.0791438549999994e-12,187310402,2552764,993854632
6135000,2033665958,22911383,3.093036705e-12,186062909,2555008,996409640
6140000,34570903042,630313841,8.5092368535e-11,186099023,-252792832,743616808
6145000,2119292666,22937155,3.096515925e-12,186332310,2555756,746172564
6150000,2314632208,22766422,3.0734669699999995e-12,185943729,2556212,748728776
6155000,2093389541,23001673,3.105225855e-12,188429164,2553972,751282748
6160000,3107142916,22612861,3.0527362349999997e-12,180953025,2556888,753839636
6165000,2301802375,22727172,3.0681682199999998e-12,184668129,2554936,756394572
6170000,2400296375,22801223,3.078165105e-12,187074756,2554708,758949280
6175000,2308768000,22765467,3.0733380449999993e-12,185912687,2556592,761505872
6180000,2349672458,22764528,3.0732112799999994e-12,185882182,2554436,764060308
6185000,2109814541,22803341,3.078451035e-12,187143598,2554984,766615292
6190000,2215982916,22753767,3.071758545e-12,185532461,2554836,769170128
6195000,2265569792,22776378,3.0748110299999995e-12,186267307,2556992,771727120
6200000,2626085375,22799936,3.0779913599999995e-12,187032955,2552924,774280044
6205000,2251804334,22768245,3.0737130749999996e-12,186002995,2557092,776837136
6210000,2652966250,22760266,3.0726359099999995e-12,180583418,2555232,779392368
6215000,2094600667,22631604,3.0552665399999993e-12,181562143,2550872,781943240
6220000,2932265667,22650026,3.0577535099999997e-12,182160863,2554744,784497984
6225000,2068757833,22614928,3.0530152799999998e-12,181020183,2558320,787056304
6230000,2404583625,22655449,3.058485615e-12,182337123,2557224,789613528
6235000,2235991750,22643499,3.056872365e-12,181948744,2554976,792168504
6240000,2887067333,22777902,3.07501677e-12,181156584,2553764,794722268
6245000,2239682542,22675383,3.061176705e-12,182984981,2554940,797277208
6250000,2333250750,22769575,3.0738926249999994e-12,186046199,2556156,799833364
6255000,2179260416,22758690,3.0724231499999997e-12,185692438,2559796,802393160
6260000,2264340292,22797723,3.0776926049999997e-12,181800770,2557044,804950204
6265000,2202931208,22577803,3.0480034049999997e-12,179813607,2558244,807508448
6270000,2353908625,22651149,3.0579051149999994e-12,182197376,2551916,810060364
6275000,2225713667,22779296,3.0752049599999998e-12,181201892,2556496,812616860
6280000,2553642125,22806169,3.078832815e-12,187235518,2555524,815172384
6285000,2210697000,22769724,3.07391274e-12,186051062,2551308,817723692
6290000,5917334834,22961051,3.099741885e-12,187108922,2552224,820275916
6295000,2175032375,22753705,3.0717501749999994e-12,185530430,2556480,822832396
6300000,2290435541,22817147,3.0803148449999996e-12,187592306,2555352,825387748
6305000,2210961167,22737988,3.06962838e-12,185019649,2554732,827942480
6310000,2460220833,22952056,3.09852756e-12,186816586,2557964,830500444
6315000,2269825667,22758925,3.0724548749999995e-12,185700088,2554284,833054728
6320000,2292405792,22807404,3.0789995399999998e-12,187275669,2555672,835610400
6325000,2223870375,22946419,3.0977665649999996e-12,186633382,2556700,838167100
6330000,2888740875,22775848,3.0747394799999994e-12,186250083,2555608,840722708
6335000,2117182625,22825100,3.0813884999999996e-12,187850779,2554808,843277516
6340000,2594974459,22771529,3.0741564149999998e-12,186109732,2553148,845830664
6345000,2247914334,22939773,3.0968693549999998e-12,186417377,2554032,848384696
6350000,2738520791,22801049,3.078141615e-12,187069126,2558784,850943480
6355000,2079349500,22787668,3.0763351799999997e-12,186634216,2556064,853499544
6360000,3931137667,22753431,3.071713185e-12,185521528,2556172,856055716
6365000,2165088292,22766599,3.0734908649999993e-12,185949492,2558324,858614040
6370000,2305680875,22800177,3.0780238949999994e-12,187040783,2555032,861169072
6375000,2255252250,22942496,3.0972369599999998e-12,186505899,2555872,863724944
6380000,2589832291,22763328,3.07304928e-12,185843191,2556556,866281500
6385000,2173269459,22757220,3.0722247e-12,185644674,2551052,868832552
6390000,2083248584,22741268,3.0700711799999998e-12,185126246,2557888,871390440
6395000,2211361583,22798014,3.0777318899999994e-12,186970483,2556012,873946452
6400000,2993248125,22654722,3.0583874699999998e-12,182313485,2553984,876500436
6405000,2219096500,22671786,3.06069111e-12,182868076,2555512,879055948
6410000,2090644417,22774873,3.0746078549999998e-12,181058152,2554088,881610036
6415000,2317166042,22643633,3.0568904549999996e-12,181953114,2554984,884165020
6420000,2291883875,22770557,3.074025195e-12,186078121,2556296,886721316
6425000,3156181291,22953503,3.098722905e-12,186863614,2557064,889278380
6430000,4461815875,22812072,3.07962972e-12,187427356,2552240,891830620
6435000,2061385625,22782478,3.0756345299999995e-12,186465548,2552784,894383404
6440000,2102844334,22956903,3.0991819049999995e-12,186974110,2557156,896940560
6445000,2280314042,22755961,3.0720547349999996e-12,185603763,2554472,899495032
6450000,2178930125,22803796,3.07851246e-12,187158384,2551800,902046832
6455000,2090877000,22775656,3.07471356e-12,186243863,2559204,904606036
6460000,2872208750,22899921,3.0914893349999995e-12,185122211,2556264,907162300
6465000,2100209917,22767529,3.0736164149999994e-12,185979724,2553804,909716104
6470000,3086516958,22734959,3.0692194649999993e-12,184921179,2554228,912270332
6475000,2251146875,22916012,3.0936616199999994e-12,185645173,2554248,914824580
6480000,2193294000,22777796,3.0750024599999996e-12,186313414,2553612,917378192
6485000,2306332166,22774893,3.0746105549999993e-12,186219045,2557972,919936164
6490000,2739307875,22754787,3.0718962449999995e-12,185565609,2557564,922493728
6495000,2582119042,22935197,3.096251595e-12,186268660,2555328,925049056
6500000,4241958292,22766547,3.0734838449999995e-12,185947799,2556124,927605180
6505000,2073403458,22749260,3.0711500999999995e-12,185385973,2554380,930159560
6510000,2552195375,22930010,3.09555135e-12,186100108,2552332,932711892
6515000,2202427333,22760377,3.0726508949999997e-12,185747284,2550096,935261988
6520000,2744703917,22790482,3.0767150699999996e-12,186725682,2552220,937814208
6525000,2060776750,22922495,3.0945368249999996e-12,185855866,2550476,940364684
6530000,2332197125,22763959,3.073134465e-12,185863690,2554040,942918724
6535000,2270036167,22817204,3.0803225399999993e-12,187594155,2553556,945472280
6540000,2089645958,22761553,3.0728096549999998e-12,185785499,2553564,948025844
6545000,2073086375,22972599,3.1013008649999997e-12,187484226,2552352,950578196
6550000,2711717417,22741393,3.070088055e-12,185130294,2554880,953133076
6555000,2097694584,22811474,3.0795489899999995e-12,187407928,2557160,955690236
6560000,2805492417,22644592,3.05701992e-12,181984251,2558820,958249056
6565000,2321490541,22620525,3.053770875e-12,181202084,2554728,960803784
6570000,2610607958,22635817,3.055835295e-12,181699089,2553736,963357520
6575000,2313873875,22780329,3.0753444149999997e-12,181235470,2554472,965911992
6580000,2218208167,22646430,3.0572680499999996e-12,182043994,2552292,968464284
6585000,2173204167,22608728,3.0521782799999997e-12,180818673,2556124,971020408
6590000,2213226375,22649549,3.057689115e-12,182145360,2556788,973577196
6595000,2251247416,22607444,3.05200494e-12,180776958,2553656,976130852
6600000,2545068708,22644532,3.0570118199999997e-12,181982307,2548848,978679700
6605000,2242896458,22768734,3.07377909e-12,186018888,2551672,981231372
6610000,3018190792,22963233,3.100036455e-12,187179853,2553400,983784772
6615000,2230545125,22750599,3.0713308649999996e-12,185429476,2553656,986338428
6620000,2141570417,22794511,3.077258985e-12,186856619,2553568,988891996
6625000,2239255291,22765095,3.0732878249999997e-12,185900605,2554984,991446980
6630000,2452634167,22962453,3.0999311549999998e-12,187154483,2555892,994002872
6635000,2255337084,22773459,3.074416965e-12,186172451,2553012,996555884
6640000,5351269084,22944903,3.0975619049999997e-12,186584122,2554952,999110836
6645000,2069932958,22768778,3.07378503e-12,186020320,2555628,1001666464
6650000,3043080375,22809017,3.0792172949999997e-12,187328095,2557116,1004223580
6655000,2230039583,22827786,3.0817511099999998e-12,187938060,2553044,1006776624
6660000,2092596208,22918711,3.0940259849999997e-12,185732878,2553068,1009329692
6665000,2242571417,22772588,3.07429938e-12,186144139,2556980,1011886672
6670000,2603996042,22761560,3.0728105999999996e-12,185785706,2554844,1014441516
6675000,2045346458,22781882,3.0755540699999994e-12,186446199,2553144,1016994660
6680000,2175243125,22919417,3.094121295e-12,185755812,2548844,1019543504
6685000,2233977500,22795218,3.0773544299999996e-12,186879625,2555188,1022098692
6690000,2251204041,22773760,3.0744576e-12,186182227,2558868,1024657560
6695000,2292123708,22961924,3.09985974e-12,187137304,2558416,1027215976
6700000,2459159042,22775661,3.074714235e-12,186244013,2556304,1029772280
6705000,2271085500,22750191,3.0712757849999995e-12,185416228,2556132,1032328412
6710000,3029068875,22802883,3.078389205e-12,187128712,2556520,1034884932
6715000,5646329500,22925165,3.0948972749999997e-12,185942650,2554564,1037439496
6720000,2819685084,22803863,3.078521505e-12,187160581,2555576,1039995072
6725000,2275433667,22785704,3.07607004e-12,181410151,2557812,1042552884
6730000,2383595584,22654876,3.05840826e-12,182318498,2554680,1045107564
6735000,2264660083,22597079,3.050605665e-12,180440080,2553540,1047661104
6740000,2037310250,22660774,3.05920449e-12,182510187,2551540,1050212644
6745000,2198821458,22926617,3.095093295e-12,185989831,2553592,1052766236
6750000,2401903417,22766276,3.0734472599999997e-12,185938987,2553928,1055320164
6755000,2271316875,22864100,3.0866534999999996e-12,189118278,2556224,1057876388
6760000,2535579875,22777762,3.07499787e-12,186312290,2555948,1060432336
6765000,2111267667,22924750,3.0948412499999997e-12,185929162,2557356,1062989692
6770000,2195498375,22783846,3.0758192099999997e-12,186510024,2553624,1065543316
6775000,2076990417,22766984,3.0735428399999998e-12,185962014,2558288,1068101604
6780000,3697238959,22955041,3.0989305349999996e-12,186913618,2553120,1070654724
6785000,5196239583,22744017,3.0704422949999995e-12,185215584,2555452,1073210176
6790000,2247418375,22799518,3.07793493e-12,187019355,2552824,1075763000
6795000,2350186000,22750651,3.071337885e-12,185431194,2556488,1078319488
6800000,2323812292,22789345,3.0765615749999997e-12,186688734,2555916,1080875404
6805000,2046164500,22777797,3.0750025949999994e-12,186313434,2554896,1083430300
6810000,2736984750,22972173,3.101243355e-12,187470388,2554116,1085984416
6815000,2142930792,22782801,3.075678135e-12,186476071,2557044,1088541460
6820000,2426018708,22814810,3.07999935e-12,187516360,2555912,1091097372
6825000,2242026666,22772871,3.074337585e-12,186153326,2555324,1093652696
6830000,2679809333,22952672,3.0986107199999996e-12,186836607,2556244,1096208940
6835000,2164120750,22815203,3.0800524049999996e-12,187529124,2553256,1098762196
6840000,2434202292,22760859,3.072715965e-12,185762935,2556580,1101318776
6845000,2244239208,22813063,3.0797635049999996e-12,187459565,2553700,1103872476
6850000,2413870542,22911777,3.0930898950000002e-12,185507533,2554440,1106426916
6855000,4822358709,22833317,3.082497795e-12,188117827,2556664,1108983580
6860000,12100419750,22964405,3.1001946749999994e-12,187217918,2558984,1111542564
6865000,2061876417,22929748,3.0955159799999997e-12,186091567,2555896,1114098460
