Size,Time,Cycles,Price,Instructions,HeapSize,TotalHeapSize
3,9925573926,236716961,3.1956789735e-11,25904,3074552,5271784
6,11780313755,236769408,3.196387008e-11,29390,3074600,8346384
9,15043360721,236774056,3.196449756e-11,30202,3074600,11420984
12,2159653692,236764914,3.196326339e-11,33602,3074600,14495584
15,2150728307,236764874,3.196325799e-11,32276,3074600,17570184
18,2139729858,236765009,3.1963276215000006e-11,36684,3074600,20644784
21,2138522063,236768018,3.1963682430000004e-11,34308,3074600,23719384
24,2132918333,236764930,3.196326555e-11,34098,3074600,26793984
27,2360672819,236765001,3.1963275135e-11,36430,3074600,29868584
30,2137540248,236764930,3.196326555e-11,34098,3074600,32943184
33,2147057781,237808601,3.2104161135e-11,69011,-12302088,20641096
36,2815081356,236718505,3.1956998175e-11,46313,3074748,23715844
39,2474825952,236718585,3.1957008975e-11,48883,3074748,26790592
42,2519424412,236727794,3.195825219e-11,49575,3074748,29865340
45,2562532810,236718618,3.195701343e-11,49963,3074748,32940088
48,3317595460,236719147,3.1957084845000004e-11,66997,3075248,36015336
51,3733544795,236718540,3.19570029e-11,47421,3074748,39090084
54,2212059936,236718524,3.195700074e-11,46909,3074748,42164832
57,3278233724,236727808,3.195825408e-11,50033,3074748,45239580
60,7676597775,236718617,3.1957013295e-11,49919,3074748,48314328
63,5608063162,236729646,3.195850221e-11,50045,3074748,51389076
66,5705192918,236719129,3.1957082415e-11,66585,3075248,54464324
69,5222031812,236728756,3.195838206e-11,50975,3074748,57539072
72,7793113267,238400270,3.218403645e-11,51249,-6153544,51385528
75,14847798626,236745592,3.196065492e-11,51413,3074748,54460276
78,2205978184,236718667,3.1957020045e-11,51549,3074748,57535024
81,2246201454,236718660,3.19570191e-11,51327,3074748,60609772
84,2137605907,236719140,3.1957083900000005e-11,66939,3075248,63685020
87,2141331866,236730924,3.1958674740000005e-11,52093,3074748,66759768
90,2140294924,236718682,3.195702207e-11,51871,3074748,69834516
93,2138608618,236718692,3.195702342e-11,52371,3074748,72909264
96,2143355929,236718626,3.1957014510000004e-11,50225,3074748,75984012
99,2146669563,236731411,3.1958740485e-11,67897,3075248,79059260
102,2135090175,236718556,3.195700506e-11,47959,3074748,82134008
105,2161904330,236718600,3.1957011e-11,49369,3074748,85208756
108,2204380717,236718627,3.1957014645e-11,50255,3074748,88283504
111,2148634881,236718613,3.1957012755000004e-11,49795,3074748,91358252
114,2146601677,236730872,3.195866772e-11,50393,3074748,94433000
117,2142555766,236719137,3.1957083495e-11,66851,3075248,97508248
120,2139393296,236718570,3.1957006950000004e-11,48223,3074748,100582996
123,3370751317,236718658,3.195701883e-11,51281,3074748,103657744
126,2142277115,236730880,3.19586688e-11,50649,3074748,106732492
129,3614367795,236718733,3.1957028955e-11,53721,3074748,109807240
132,3375936000,236718747,3.1957030845000005e-11,54163,3074748,112881988
135,3373672452,236730969,3.1958680815e-11,53527,3074748,115956736
138,3367033596,236718724,3.1957027740000004e-11,53417,3074748,119031484
141,3379370017,236731362,3.195873387e-11,66307,3075240,122106724
144,3376534515,236718740,3.19570299e-11,53937,3074748,125181472
147,2136053083,236718830,3.195704205e-11,56871,3074748,128256220
150,3370605075,236718833,3.1957042455000005e-11,56955,3074748,131330968
153,3396017859,236731095,3.1958697825000006e-11,57421,3074748,134405716
156,3511051346,236718761,3.1957032735000004e-11,54597,3074748,137480464
159,3378365793,236734537,3.1959162495e-11,70281,3075248,140555712
162,3367886590,236718686,3.195702261e-11,52171,3074748,143630460
165,3372237908,236718785,3.1957035975e-11,55379,3074748,146705208
168,3369922158,238326480,3.2174074800000004e-11,54967,27151052,173856260
171,3431393028,238924241,3.2254772535e-11,75519,40974660,214830920
174,3434254722,237921622,3.211941897e-11,75817,-112743372,102087548
177,3596207363,236743661,3.1960394235e-11,69015,3075248,105162796
180,3459663926,236718707,3.1957025445e-11,52861,3074748,108237544
183,4880906800,236718802,3.1957038270000006e-11,55961,3074748,111312292
186,3383034960,236743174,3.1960328490000004e-11,53341,3074748,114387040
189,4827579236,236718733,3.1957028955e-11,53689,3074748,117461788
192,3368545788,236719220,3.1957094700000005e-11,69535,3075248,120537036
195,4851605282,236745619,3.1960658565e-11,53323,3074748,123611784
198,3415205659,236718704,3.195702504e-11,52769,3074748,126686532
201,4891526486,236743182,3.196032957e-11,53621,3074748,129761280
204,3461526196,236718738,3.195702963e-11,53871,3074748,132836028
207,4847991410,236743195,3.1960331325e-11,53871,3074748,135910776
210,3371327773,236719190,3.1957090650000004e-11,68551,3075248,138986024
213,4868335052,236718716,3.195702666e-11,53137,3074748,142060772
216,3340748563,236743132,3.1960322820000003e-11,51993,3074748,145135520
219,4857152441,236718695,3.1957023825e-11,52463,3074748,148210268
222,3365024368,236743134,3.196032309e-11,52059,3074748,151285016
225,4855342714,236718689,3.1957023015e-11,52295,3074748,154359764
228,5029299895,236743581,3.1960383435e-11,66593,3075248,157435012
231,4903029074,236718660,3.19570191e-11,51339,3074748,160509760
234,4857610421,236743151,3.1960325385e-11,52591,3074748,163584508
237,3396392947,236718699,3.1957024365e-11,52425,3074748,166659256
240,4984943260,236718699,3.1957024365e-11,52589,3074748,169734004
243,4879172652,236743654,3.196039329e-11,68937,3075248,172809252
246,4853165718,236718589,3.1957009515000004e-11,49025,3074748,175884000
249,6634144732,236743073,3.1960314855e-11,50047,3074748,178958748
252,4845612002,236718644,3.1957016940000004e-11,50819,3074748,182033496
255,4855629748,236745552,3.196064952e-11,51151,3074748,185108244
258,6634880087,236718653,3.1957018155e-11,51093,3074748,188182992
261,4880984595,236746000,3.196071e-11,65707,3075248,191258240
264,6638983750,236718585,3.1957008975e-11,48901,3074748,194332988
267,4847383804,236718642,3.195701667e-11,50751,3074748,197407736
270,4911127789,236718656,3.1957018560000004e-11,51001,3074748,200482484
273,6640562837,236745553,3.1960649655e-11,51163,3074748,203557232
276,4857847865,236718550,3.195700425e-11,47771,3074748,206631980
279,6619137776,236746052,3.1960717020000005e-11,67389,3075248,209707228
282,4862472340,236718647,3.1957017345e-11,50905,3074748,212781976
285,4852468814,236745583,3.1960653705e-11,52135,3074748,215856724
288,4848057821,236718681,3.1957021935000004e-11,51997,3074748,218931472
291,4869792775,236745579,3.1960653165e-11,51997,3074748,222006220
294,6615695502,236719173,3.1957088355e-11,67987,3075248,225081468
297,4853454161,236745516,3.196064466e-11,49981,3074748,228156216
300,4861789000,236718651,3.1957017885e-11,51031,3074748,231230964
303,6758165792,236698968,3.1954360680000004e-11,58151,3074748,234305712
306,4870875360,236698888,3.1954349880000004e-11,55793,3074748,237380460
309,2234494830,236672036,3.195072486e-11,57277,3074748,240455208
312,2126501007,236672012,3.195072162e-11,56501,3074748,243529956
315,2161527407,236696468,3.195402318e-11,56613,3074748,246604704
318,2176057971,236672611,3.1950802485e-11,75947,3075248,249679952
321,2443347077,236671929,3.1950710415e-11,53777,3074748,252754700
324,2226218459,236696486,3.195402561e-11,57191,3074748,255829448
327,3118010895,236672020,3.1950722700000004e-11,56751,3074748,258904196
330,2840471506,236672015,3.1950722025e-11,56587,3074748,261978944
333,3464565234,236697095,3.1954107825000005e-11,77001,3075248,265054192
336,2510127587,236672012,3.195072162e-11,56211,3074748,268128940
339,4293936541,236699574,3.195444249e-11,58327,3074748,271203688
342,4882079830,237696596,3.208904046e-11,58673,15370664,286574352
345,8389547682,238941680,3.22571268e-11,76617,40974912,327549264
348,7987740891,238932574,3.225589749e-11,76749,40975880,368525144
351,8881533892,238466978,3.219304203e-11,106291,-174247680,194277464
354,2191553528,236711755,3.1956086925e-11,57351,3074748,197352212
357,2167447698,236672059,3.1950727965e-11,58005,3074748,200426960
360,2155556815,236672097,3.1950733095e-11,59107,3074748,203501708
363,2150221750,236672088,3.1950731880000003e-11,58947,3074748,206576456
366,2141426699,236672026,3.1950723510000004e-11,56961,3074748,209651204
369,2144441568,236712371,3.1956170085000005e-11,77371,3075248,212726452
372,2150653107,236671986,3.195071811e-11,55633,3074748,215801200
375,2142782144,236672038,3.1950725130000004e-11,57323,3074748,218875948
378,2086528030,236672032,3.1950724320000004e-11,57127,3074748,221950696
381,2236593244,236711740,3.19560849e-11,56853,3074748,225025444
384,2146855786,236672649,3.1950807615e-11,77181,3075248,228100692
387,2138102783,236671971,3.1950716085e-11,55163,3074748,231175440
390,2134866583,236672022,3.195072297e-11,56637,3074748,234250188
393,2133221632,236672014,3.1950721890000004e-11,56555,3074748,237324936
396,2135068144,236711868,3.195610218e-11,61003,3074748,240399684
399,3372567927,236672225,3.1950750375e-11,63411,3074748,243474432
402,2137084399,236672211,3.1950748485e-11,62951,3074748,246549180
405,2301042053,236672231,3.1950751185e-11,63605,3074748,249623928
408,3356939829,236711943,3.1956112305e-11,63439,3074748,252698676
411,3387670044,236672590,3.1950799650000005e-11,75283,3075240,255773916
414,3373198902,236672136,3.1950738360000004e-11,60531,3074748,258848664
417,2132505948,236711946,3.195611271e-11,63537,3074748,261923412
420,3387070344,236672233,3.1950751455000006e-11,63675,3074748,264998160
423,2139830364,236672252,3.1950754020000005e-11,64115,3074748,268072908
426,3463567406,236711884,3.195610434e-11,61517,3074748,271147656
429,3378545348,236672700,3.19508145e-11,78835,3075248,274222904
432,3484373756,236672112,3.1950735120000004e-11,59739,3074748,277297652
435,3384825215,236715883,3.1956644205000003e-11,62441,3074748,280372400
438,3386572937,236672195,3.1950746325e-11,62443,3074748,283447148
441,3501032852,236672183,3.1950744705e-11,62047,3074748,286521896
444,3378453308,236712465,3.1956182774999996e-11,80419,3075248,289597144
447,4845791505,236672084,3.195073134e-11,58825,3074748,292671892
450,3378153788,236672131,3.1950737685e-11,60363,3074748,295746640
453,4846775958,236715879,3.1956643665e-11,62307,3074748,298821388
456,3415403893,236672151,3.1950740385e-11,60803,3074748,301896136
459,3362388339,236711862,3.1956101370000005e-11,60801,3074748,304970884
462,3365383604,236672668,3.195081018e-11,77801,3075248,308046132
465,4873305139,236672141,3.1950739035e-11,60687,3074748,311120880
468,4875921312,236711790,3.195609165e-11,58469,3074748,314195628
471,3365968653,236672148,3.195073998e-11,60903,3074748,317270376
474,4949309376,236715834,3.195663759e-11,60847,3074748,320345124
477,4892328856,236672150,3.195074025e-11,60959,3074748,323419872
480,4851420191,236712387,3.1956172245e-11,77887,3075248,326495120
483,4844045793,236672124,3.1950736740000004e-11,60125,3074748,329569868
486,3397790546,236672105,3.1950734175e-11,59299,3074748,332644616
489,3387465154,236711819,3.1956095565000005e-11,59411,3074748,335719364
492,3417539730,236672106,3.1950734310000004e-11,59551,3074748,338794112
495,4901696945,236712383,3.1956171705000005e-11,77731,3075248,341869360
498,4847453483,236672025,3.1950723375000005e-11,56895,3074748,344944108
501,4856253432,236672062,3.1950728370000005e-11,58113,3074748,348018856
504,4807491541,236715797,3.1956632595000003e-11,59627,3074748,351093604
507,4847800080,236672098,3.195073323e-11,59291,3074748,354168352
510,4853127464,236715790,3.1956631650000004e-11,59401,3074748,357243100
513,4846663198,236672652,3.1950808020000004e-11,77283,3075248,360318348
516,3377326505,236711693,3.1956078555e-11,55323,3074748,363393096
519,4847289018,236672070,3.195072945e-11,58131,3074748,366467844
522,4868788662,236715745,3.1956625575e-11,57937,3074748,369542592
525,5047717544,236672051,3.1950726885000003e-11,57773,3074748,372617340
528,4896788112,236711768,3.195608868e-11,57773,3074748,375692088
531,4857255268,236672565,3.1950796275000005e-11,74473,3075248,378767336
534,4847067352,236711707,3.1956080445e-11,55769,3074748,381842084
537,4850930635,236672072,3.195072972e-11,58425,3074748,384916832
540,4882815653,236672061,3.1950728235e-11,58067,3074748,387991580
543,4871488678,236715752,3.195662652e-11,58173,3074748,391066328
546,4866218840,236672567,3.1950796545e-11,74537,3075248,394141576
549,4853473087,236711685,3.1956077475000003e-11,55061,3074748,397216324
552,4855654311,236671969,3.1950715815e-11,54807,3074748,400291072
555,4847987982,236711723,3.1956082605e-11,56275,3074748,403365820
558,4875396743,236671999,3.1950719865e-11,56079,3074748,406440568
561,4849998487,236715610,3.195660735e-11,53579,3074748,409515316
564,5051459984,236672569,3.1950796815e-11,74595,3075248,412590564
567,5101131900,236711686,3.195607761e-11,55101,3074748,415665312
570,3651323857,236671932,3.195071082e-11,53903,3074748,418740060
573,2374784831,236672182,3.195074457e-11,62009,3074748,421814808
576,2218497046,236672194,3.195074619e-11,62385,3074748,424889556
579,2726522360,236672203,3.1950747405e-11,62703,3074748,427964304
582,2379135957,236711924,3.1956109740000004e-11,62815,3074748,431039052
585,2358893375,236672226,3.195075051e-11,63093,3074748,434113800
588,2369789500,236673815,3.1950965025e-11,115092,3076632,437190432
591,2309455433,236672284,3.195075834e-11,65314,3074892,440265324
594,3404218291,236672307,3.1950761445000005e-11,66072,3074892,443340216
597,2298496516,236672318,3.195076293e-11,66446,3074892,446415108
600,2965586337,236715088,3.195653688e-11,66420,3074892,449490000
603,2256029437,236672924,3.195084474e-11,86114,3075392,452565392
606,2912650409,236672200,3.1950747e-11,62602,3074892,455640284
609,2823834805,236714898,3.195651123e-11,60246,3074892,458715176
612,2295670505,236672222,3.195074997e-11,63312,3074892,461790068
615,2485398461,236672244,3.195075294e-11,63658,3074892,464864960
618,6021417832,236718053,3.1956937155e-11,63608,3074892,467939852
621,7059490587,236672794,3.195082719e-11,81914,3075392,471015244
624,4839448625,236736305,3.1959401175e-11,61076,3074892,474090136
627,2263765147,236672168,3.195074268e-11,61562,3074892,477165028
630,2143294619,236718057,3.1956937695e-11,63746,3074892,480239920
633,2159345415,236672234,3.195075159e-11,63704,3074892,483314812
636,2145278603,236672182,3.195074457e-11,62000,3074892,486389704
639,2149918987,236672776,3.195082476e-11,81316,3075392,489465096
642,2237704636,236718094,3.195694269e-11,64948,3074892,492539988
645,2163738198,236672291,3.1950759285e-11,65556,3074892,495614880
648,2160169264,236672285,3.1950758475e-11,64984,3074892,498689772
651,3373305093,236672284,3.195075834e-11,65330,3074892,501764664
654,2152073921,236721760,3.19574376e-11,84850,3075392,504840056
657,3475325681,236672082,3.195073107e-11,58768,3074892,507914948
660,2139176962,236672191,3.1950745785e-11,62296,3074892,510989840
663,3371428229,236672197,3.1950746595e-11,62510,3074892,514064732
666,3372507810,236672146,3.195073971e-11,60844,3074892,517139624
669,2136482868,236672134,3.1950738090000007e-11,60456,3074892,520214516
672,3564584643,236672740,3.19508199e-11,80144,3075392,523289908
675,3380169183,236721015,3.1957337025e-11,60638,3074892,526364800
678,2144588503,237140389,3.2013952515e-11,64134,3078996,529443796
681,3372401683,239019262,3.226760037e-11,84984,40974956,570418752
684,3375549438,238973702,3.2261449770000004e-11,84638,40975056,611393808
687,3459470423,238877137,3.2248413495e-11,84638,40975068,652368876
690,4869368075,238854075,3.2245300125e-11,111516,40975452,693344328
693,4869714078,238964597,3.2260220595e-11,84688,40975916,734320244
696,3377201529,239785051,3.2370981885e-11,90980,-361810300,372509944
699,3375662694,236748777,3.1961084895e-11,69942,3074892,375584836
702,3374080184,236672447,3.1950780345000007e-11,70624,3074892,378659728
705,3382373157,236672436,3.195077886e-11,70262,3074892,381734620
708,3426826413,236748789,3.1961086515e-11,70350,3074892,384809512
711,3433909334,236672720,3.1950817200000003e-11,79504,3075392,387884904
714,3418650288,236672167,3.1950742545000004e-11,61532,3074892,390959796
717,3375874528,236748556,3.1961055060000005e-11,62746,3074892,394034688
720,3365691057,236672194,3.195074619e-11,62412,3074892,397109580
723,3369533804,236672375,3.1950770625000005e-11,68288,3074892,400184472
726,3384941404,236756327,3.1962104145000003e-11,66988,3074892,403259364
729,3469685506,236672402,3.195077427e-11,69148,3074892,406334256
732,3373741295,236672394,3.1950773190000004e-11,68898,3074892,409409148
735,4869066456,236748745,3.1961080575e-11,68920,3074892,412484040
738,3369316330,236672901,3.1950841635e-11,85384,3075392,415559432
741,3373244972,236672340,3.19507659e-11,67134,3074892,418634324
744,4845740297,236748718,3.196107693e-11,68032,3074892,421709216
747,3391900773,236672377,3.1950770895e-11,68362,3074892,424784108
750,3372593269,236748749,3.1961081115e-11,69046,3074892,427859000
753,4977642399,236672406,3.1950774810000004e-11,69274,3074892,430933892
756,4871763018,236672847,3.1950834345e-11,83454,3075392,434009284
759,4878227107,236672364,3.1950769140000003e-11,67938,3074892,437084176
762,4854945547,236672335,3.1950765225e-11,67002,3074892,440159068
765,4988120256,236672356,3.195076806e-11,67658,3074892,443233960
768,4845701047,236672349,3.1950767115e-11,67436,3074892,446308852
771,3388004793,236672886,3.195083961e-11,84876,3075392,449384244
774,6631134940,236748667,3.1961070045000004e-11,66362,3074892,452459136
777,3372432348,236672358,3.1950768330000003e-11,67734,3074892,455534028
780,3384425959,236672361,3.1950768735e-11,67840,3074892,458608920
783,6609471862,236748706,3.196107531e-11,67624,3074892,461683812
786,4847610866,236672300,3.19507605e-11,65852,3074892,464758704
789,4838318904,236749186,3.196114011e-11,83070,3075392,467834096
792,3376629026,236672210,3.195074835e-11,62904,3074892,470908988
795,4870493581,236748661,3.1961069235000004e-11,66180,3074892,473983880
798,6642063784,236672330,3.195076455e-11,66822,3074892,477058772
801,2532589178,236672310,3.195076185e-11,66184,3074892,480133664
804,2103108183,236672310,3.195076185e-11,66182,3074892,483208556
807,2484713905,236749129,3.1961132415e-11,81386,3075392,486283948
810,2114196386,236672225,3.1950750375e-11,63406,3074892,489358840
813,2793859002,236672336,3.195076536e-11,67030,3074892,492433732
816,2741877070,236672268,3.195075618e-11,64818,3074892,495508624
819,3135529947,236672251,3.1950753885e-11,64262,3074892,498583516
822,2398718698,236672824,3.1950831240000004e-11,82694,3075392,501658908
825,3754636349,236748566,3.196105641e-11,63078,3074892,504733800
828,2644263979,236672265,3.1950755775e-11,64720,3074892,507808692
831,2686051808,236672269,3.1950756315e-11,64842,3074892,510883584
834,4267033673,236748618,3.1961063430000004e-11,64790,3074892,513958476
837,5440497412,236672278,3.195075753e-11,65150,3074892,517033368
840,4249474677,236672780,3.19508253e-11,81460,3075392,520108760
843,2969144873,236672222,3.195074997e-11,63326,3074892,523183652
846,3569069313,236748584,3.196105884e-11,63658,3074892,526258544
849,5078450709,236763844,3.1963118940000005e-11,63312,3074892,529333436
852,2140072530,236672233,3.1950751455000006e-11,63450,3074892,532408328
855,2140513913,236672230,3.195075105e-11,63590,3074892,535483220
858,2132726572,236672754,3.195082179e-11,80586,3075392,538558612
861,2123179852,236672228,3.195075078e-11,63522,3074892,541633504
864,2137325244,236672233,3.1950751455000006e-11,63660,3074892,544708396
867,2131067382,236672230,3.195075105e-11,63578,3074892,547783288
870,2380353641,236672230,3.195075105e-11,63578,3074892,550858180
873,2355741894,236672761,3.1950822735e-11,80822,3075392,553933572
876,2194553721,236672321,3.1950763335e-11,66536,3074892,557008464
879,2136674273,236672413,3.1950775755000004e-11,69510,3074892,560083356
882,2123261096,236672423,3.1950777105e-11,69860,3074892,563158248
885,3374601156,236672425,3.1950777375000004e-11,69682,3074892,566233140
888,2132361023,236748760,3.1961082600000003e-11,69396,3074892,569308032
891,2128130470,236673537,3.1950927495e-11,106051,3076260,572384292
894,2173757099,236672232,3.195075132e-11,63638,3074892,575459184
897,2138376782,236672334,3.195076509e-11,66962,3074892,578534076
900,2128858366,236748682,3.196107207e-11,66866,3074892,581608968
903,3367732527,236672322,3.195076347e-11,66574,3074892,584683860
906,2131986533,236672230,3.195075105e-11,63560,3074892,587758752
909,2135524786,236672769,3.1950823815000003e-11,81078,3075392,590834144
912,3550384798,236748587,3.1961059245000005e-11,63774,3074892,593909036
915,2137270833,236672204,3.1950747540000004e-11,62734,3074892,596983928
918,2139122500,236672243,3.1950752805e-11,63714,3074892,600058820
921,2140089602,236748588,3.196105938e-11,63794,3074892,603133712
924,3373057891,236672240,3.19507524e-11,63906,3074892,606208604
927,2156059192,236672751,3.1950821385e-11,80518,3075392,609283996
930,3371805193,236672206,3.195074781e-11,62792,3074892,612358888
933,2142296236,236748584,3.196105884e-11,63674,3074892,615433780
936,3378168756,236672202,3.1950747270000006e-11,62666,3074892,618508672
939,3406382910,236672209,3.1950748215e-11,62892,3074892,621583564
942,3378257872,236749125,3.1961131875e-11,81258,3075392,624658956
945,3396748018,236672109,3.1950734715e-11,59626,3074892,627733848
948,4875451015,236748573,3.1961057355e-11,63294,3074892,630808740
951,3575990880,236672202,3.1950747270000006e-11,62380,3074892,633883632
954,3381737576,236672201,3.1950747135e-11,62630,3074892,636958524
957,3385369694,236748563,3.1961056005e-11,62988,3074892,640033416
960,3369425921,236672778,3.195082503e-11,81378,3075392,643108808
963,3370564203,236672263,3.1950755505e-11,64658,3074892,646183700
966,3371347130,236748605,3.1961061675000005e-11,64368,3074892,649258592
969,4880055698,236672249,3.1950753615e-11,64188,3074892,652333484
972,3388314279,236672251,3.1950753885e-11,64244,3074892,655408376
975,3377520851,236748607,3.1961061945e-11,64406,3074892,658483268
978,3373015787,236672767,3.1950823545e-11,81026,3075392,661558660
981,3372480972,236672194,3.195074619e-11,62072,3074892,664633552
984,4856388217,236756261,3.1962095235e-11,65008,3074892,667708444
987,5096220891,236672266,3.1950755910000003e-11,64728,3074892,670783336
990,4868926986,236748605,3.1961061675000005e-11,64370,3074892,673858228
993,4888343526,236672841,3.1950833535e-11,83424,3075392,676933620
996,4865232232,236748461,3.1961042235e-11,59688,3074892,680008512
999,4850753673,236672156,3.195074106e-11,61160,3074892,683083404
1002,4874001744,236748540,3.19610529e-11,62236,3074892,686158296
1005,4892625508,236672110,3.195073485e-11,59678,3074892,689233188
1008,3372533608,236748538,3.196105263e-11,62178,3074892,692308080
1011,3365676980,236672810,3.195082935e-11,82412,3075392,695383472
1014,4849260989,236672168,3.195074268e-11,61212,3074892,698458364
1017,4862403969,236756108,3.196207458e-11,60014,3074892,701533256
1020,6630912921,236672114,3.195073539e-11,59804,3074892,704608148
1023,4850681847,236672568,3.195079668e-11,74548,3074892,707683040
1026,4856744874,236672492,3.195078642e-11,72094,3074892,710757932
1029,4869914296,236748856,3.1961095560000006e-11,72504,3074892,713832824
1032,4851418785,236672769,3.1950823815000003e-11,81100,3075392,716908216
1035,6680967586,236748619,3.1961063565e-11,64816,3074892,719983108
1038,3369810109,236672260,3.19507551e-11,64536,3074892,723058000
1041,6680364802,236748629,3.1961064915e-11,65148,3074892,726132892
1044,4850896749,236672252,3.1950754020000005e-11,64274,3074892,729207784
1047,4976967627,236672806,3.1950828810000003e-11,81942,3075392,732283176
1050,2365227186,236748600,3.1961061e-11,64182,3074892,735358068
1053,2930697520,236672294,3.195075969e-11,65648,3074892,738432960
1056,2267499474,236672212,3.195074862e-11,62976,3074892,741507852
1059,2298541219,236748573,3.1961057355e-11,63308,3074892,744582744
1062,2530574192,236672219,3.1950749565e-11,63212,3074892,747657636
1065,3389856853,236672765,3.1950823275e-11,80954,3075392,750733028
1068,3110859205,236748582,3.1961058570000003e-11,63618,3074892,753807920
1071,2270913561,236672227,3.1950750645000006e-11,63480,3074892,756882812
1074,2293113750,236672233,3.1950751455000006e-11,63674,3074892,759957704
1077,4888968669,236748584,3.196105884e-11,63674,3074892,763032596
1080,5707833033,236672805,3.1950828675e-11,81872,3075392,766107988
1083,5390957065,236748596,3.196106046e-11,64072,3074892,769182880
1086,8017063363,236748653,3.1961068155e-11,65930,3074892,772257772
1089,7432457350,236748761,3.1961082735e-11,69404,3074892,775332664
1092,9016241139,236771662,3.196417437e-11,69268,3074892,778407556
1095,2220703896,236672407,3.1950774945000003e-11,69324,3074892,781482448
1098,2237015042,236672394,3.1950773190000004e-11,68920,3074892,784557340
1101,2137128967,236672880,3.19508388e-11,84688,3075392,787632732
1104,2142617625,236748701,3.1961074635e-11,67486,3074892,790707624
1107,2139723048,236672382,3.1950771570000004e-11,68522,3074892,793782516
1110,2136922037,236672430,3.195077805e-11,69700,3074892,796857408
1113,2138962540,236672412,3.1950775620000005e-11,69490,3074892,799932300
1116,2135717374,236748719,3.1961077065e-11,68048,3074892,803007192
1119,2144507133,236672813,3.1950829755e-11,82528,3075392,806082584
1122,2133261667,236672345,3.1950766575000004e-11,67310,3074892,809157476
1125,2329262142,236672367,3.1950769545e-11,68016,3074892,812232368
1128,2195262114,236672373,3.1950770355e-11,68230,3074892,815307260
1131,2147829349,236748723,3.1961077605000003e-11,68176,3074892,818382152
1134,2137542335,236672876,3.195083826e-11,84556,3075392,821457544
1137,2245796525,236672274,3.195075699e-11,65000,3074892,824532436
1140,2134201745,236672366,3.195076941e-11,67998,3074892,827607328
1143,3373994344,236751794,3.196149219e-11,68254,3074892,830682220
1146,2136127431,236672315,3.1950762525e-11,66324,3074892,833757112
1149,3376703352,236672311,3.1950761985e-11,66200,3074892,836832004
1152,3389673613,236752201,3.1961547135e-11,82008,3075392,839907396
1155,3399154784,236672334,3.195076509e-11,66954,3074892,842982288
1158,2141092316,236672254,3.195075429e-11,64334,3074892,846057180
1161,3372920985,236672331,3.1950764685e-11,66852,3074892,849132072
1164,2134127957,236751715,3.1961481525e-11,66214,3074892,852206964
1167,3378970416,236672326,3.1950764010000005e-11,66674,3074892,855281856
1170,3371458510,236672787,3.1950826245000004e-11,81690,3075392,858357248
1173,2275193546,236751632,3.1961470320000004e-11,63514,3074892,861432140
1176,3365516449,236672291,3.1950759285e-11,64998,3074892,864507032
1179,3521113310,236672274,3.195075699e-11,64998,3074892,867581924
1182,3393682893,236754719,3.1961887065e-11,64632,3074892,870656816
1185,3372592670,236673725,3.1950952875e-11,112169,3076268,873733084
1188,3371058313,236672216,3.195074916e-11,63120,3074892,876807976
1191,3389634165,236754721,3.1961887335e-11,64668,3074892,879882868
1194,3393780664,236672278,3.195075753e-11,65140,3074892,882957760
1197,3382062190,236672271,3.1950756585000004e-11,64912,3074892,886032652
1200,3382462651,236754731,3.1961888685e-11,64994,3074892,889107544
1203,3378051382,236672832,3.195083232e-11,83132,3075392,892182936
1206,3366337918,236672448,3.195078048e-11,70670,3074892,895257828
1209,3372605886,236755019,3.1961927565e-11,73812,3074892,898332720
1212,4921545209,236672554,3.1950794790000004e-11,74116,3074892,901407612
1215,3377147469,236672547,3.1950793845e-11,73868,3074892,904482504
1218,4853871371,236767087,3.1963556745e-11,89440,3075392,907557896
1221,4947542649,236672259,3.1950754965e-11,64504,3074892,910632788
1224,4855780462,236757832,3.196230732e-11,66550,3074892,913707680
1227,4874154464,236672314,3.1950762390000004e-11,66298,3074892,916782572
1230,4845824753,236757826,3.196230651e-11,66356,3074892,919857464
1233,3356090954,236672329,3.1950764415e-11,66792,3074892,922932356
1236,4856759929,236757911,3.1962317985e-11,69128,3074892,926007248
1239,3377176175,236672485,3.1950785475e-11,71288,3074892,929082140
1242,4930565953,236672504,3.195078804e-11,72490,3074892,932157032
1245,3374130755,236761069,3.1962744315e-11,72546,3074892,935231924
1248,4964556015,236672481,3.1950784935e-11,71728,3074892,938306816
1251,4852938682,236761502,3.196280277e-11,86628,3075392,941382208
1254,3577644370,236672405,3.1950774675e-11,69254,3074892,944457100
1257,4813943173,236761061,3.1962743235e-11,72284,3074892,947531992
1260,4865774234,236672508,3.195078858e-11,72616,3074892,950606884
1263,4877451755,236761065,3.1962743775000003e-11,72422,3074892,953681776
1266,4855416236,236672448,3.195078048e-11,70664,3074892,956756668
1269,4823652587,236672970,3.1950850950000005e-11,87606,3075392,959832060
1272,3368621294,236760971,3.1962731085e-11,68774,3074892,962906952
1275,4852138897,236672462,3.1950782370000004e-11,71102,3074892,965981844
1278,6678104582,236773244,3.196438794e-11,71268,3074892,969056736
1281,6793175894,236672454,3.195078129e-11,70846,3074892,972131628
1284,6655970383,236773230,3.196438605e-11,70820,3074892,975206520
1287,6650935539,236773712,3.196445112e-11,86496,3075392,978281912
1290,4861507119,236672439,3.1950779265e-11,70382,3074892,981356804
1293,6615312254,236764079,3.1963150665e-11,71148,3074892,984431696
1296,6612467088,236672408,3.195077508e-11,69352,3074892,987506588
1299,6629947360,236764031,3.1963144185e-11,69576,3074892,990581480
1302,4852627868,236764562,3.196321587e-11,86834,3075392,993656872
1305,6601871684,236672415,3.1950776025e-11,68992,3074892,996731764
1308,6590935105,236766985,3.1963542975e-11,66360,3074892,999806656
1311,4874486572,236672414,3.195077589e-11,69564,3074892,1002881548
1314,6620602559,236786027,3.1966113645e-11,69912,3074892,1005956440
1317,4851201044,236672432,3.195077832e-11,70136,3074892,1009031332
1320,6622394234,237674420,3.2086046700000005e-11,86118,3079496,1012110828
1323,8921874272,239132258,3.228285483e-11,92574,40462680,1052573508
1326,3759365301,239014843,3.2267003805e-11,88908,40974804,1093548312
1329,3466659663,238939963,3.2256895005e-11,88602,40975824,1134524136
1332,5422566901,239041244,3.227056794e-11,89128,40975264,1175499400
1335,5246996528,238907949,3.2252573115e-11,89192,40974804,1216474204
1338,10812065885,239045637,3.2271160995e-11,114028,40975612,1257449816
1341,9516736320,239065240,3.22738074e-11,89710,40975968,1298425784
1344,9676768897,239038596,3.227021046e-11,89284,40974848,1339400632
1347,7582943126,239775381,3.2369676435e-11,88494,-613462168,725938464
1350,3003484212,236803671,3.1968495585e-11,68064,3074892,729013356
1353,5136742005,236804231,3.1968571185e-11,86268,3075392,732088748
1356,2154478359,236672267,3.1950756045e-11,64638,3074892,735163640
1359,2153547248,236672288,3.195075888e-11,65456,3074892,738238532
1362,2345942698,236672336,3.195076536e-11,67018,3074892,741313424
1365,2140574661,236672324,3.195076374e-11,66630,3074892,744388316
1368,2363868351,236803639,3.1968491265e-11,67018,3074892,747463208
1371,2158429089,236672834,3.1950832590000006e-11,83220,3075392,750538600
1374,2137299235,236672238,3.195075213e-11,63842,3074892,753613492
1377,2140082861,236672335,3.1950765225e-11,66980,3074892,756688384
1380,2157354833,236803645,3.1968492075000003e-11,67230,3074892,759763276
1383,2145637443,236672359,3.1950768465e-11,67756,3074892,762838168
1386,2138035141,236672430,3.195077805e-11,70088,3074892,765913060
1389,2285935593,236672516,3.195078966e-11,72714,3074892,768987952
1392,2165808982,236803840,3.1968518400000005e-11,73534,3074892,772062844
1395,2175506944,236672529,3.1950791415e-11,73284,3074892,775137736
1398,3485288119,236672524,3.195079074e-11,73122,3074892,778212628
1401,3369503931,236672836,3.1950832860000004e-11,83254,3075392,781288020
1404,3369809482,236803563,3.1968481005e-11,64556,3074892,784362912
1407,2134343446,236672298,3.195076023e-11,65770,3074892,787437804
1410,2136037810,236672254,3.195075429e-11,64360,3074892,790512696
1413,2143092974,236672460,3.19507821e-11,71060,3074892,793587588
1416,2138385999,236803717,3.1968501795e-11,69540,3074892,796662480
1419,3425917555,236672486,3.1950785610000004e-11,71698,3074892,799737372
1422,2159362996,236672474,3.1950783990000004e-11,71508,3074892,802812264
1425,2138669384,236803776,3.196850976e-11,71482,3074892,805887156
1428,3469258987,236672953,3.1950848655e-11,87054,3075392,808962548
1431,2119984712,236672377,3.1950770895e-11,68338,3074892,812037440
1434,3423069695,236672464,3.195078264e-11,71176,3074892,815112332
1437,3401611428,236803777,3.1968509895e-11,71506,3074892,818187224
1440,3556833127,236672477,3.1950784395e-11,71602,3074892,821262116
1443,3555650785,236803809,3.1968514215000005e-11,72554,3074892,824337008
1446,3431964609,236672894,3.195084069e-11,85146,3075392,827412400
1449,2124478909,236672440,3.19507794e-11,70390,3074892,830487292
1452,2135320594,236672457,3.1950781695e-11,70752,3074892,833562184
1455,2097227635,236803741,3.1968505035e-11,70342,3074892,836637076
1458,2218410411,236672454,3.195078129e-11,70842,3074892,839711968
1461,3366820462,236672934,3.1950846090000004e-11,86450,3075392,842787360
1464,4839000914,236816815,3.1970270025e-11,68464,3074892,845862252
1467,3365060842,236672445,3.1950780075e-11,70572,3074892,848937144
1470,3414481024,236672452,3.195078102e-11,70798,3074892,852012036
1473,3492813126,236803746,3.196850571e-11,70490,3074892,855086928
1476,3365865614,236672392,3.195077292e-11,68840,3074892,858161820
1479,3393391750,236672839,3.1950833265e-11,83372,3075392,861237212
1482,4837068931,236803634,3.196849059e-11,66872,3074892,864312104
1485,3534206569,236672399,3.1950773865e-11,68862,3074892,867386996
1488,4839602623,236672391,3.1950772785e-11,68820,3074892,870461888
1491,3390142770,236816821,3.1970270835000004e-11,68674,3074892,873536780
1494,3364140106,236672402,3.195077427e-11,69170,3074892,876611672
1497,4831082340,236804109,3.1968554715000006e-11,82286,3075392,879687064
1500,3349972377,236672307,3.1950761445000005e-11,66084,3074892,882761956
1503,4846503483,236672405,3.1950774675e-11,69272,3074892,885836848
1506,4837130975,236803597,3.1968485595e-11,65646,3074892,888911740
1509,4947226606,236672302,3.1950760770000004e-11,65900,3074892,891986632
1512,3323289536,236805085,3.1968686475000006e-11,114029,3076268,895062900
1515,3365293796,236672159,3.1950741465000006e-11,61276,3074892,898137792
1518,4836986981,236672234,3.195075159e-11,63460,3074892,901212684
1521,4880607466,236803512,3.196847412e-11,62878,3074892,904287576
1524,3365082820,236672221,3.1950749835000005e-11,63266,3074892,907362468
1527,4841378434,236803519,3.1968475065e-11,63126,3074892,910437360
1530,4855355855,236672830,3.1950832050000004e-11,83060,3075392,913512752
1533,3360005750,236672271,3.1950756585000004e-11,64912,3074892,916587644
1536,3370564105,236816846,3.1970274210000003e-11,69500,3074892,919662536
1539,4839379402,236672506,3.195078831e-11,72558,3074892,922737428
1542,4839622149,236803806,3.196851381e-11,72460,3074892,925812320
1545,5006802863,236672515,3.1950789525000006e-11,72838,3074892,928887212
1548,4824944625,236803816,3.196851516e-11,72510,3074892,931962104
1551,4841314216,236672794,3.195082719e-11,81890,3075384,935037488
1554,4843405950,236803669,3.1968495315000004e-11,68008,3074892,938112380
1557,4846382412,236672432,3.195077832e-11,70140,3074892,941187272
1560,3355724855,236803725,3.1968502875e-11,69806,3074892,944262164
1563,6603223975,236672428,3.195077778e-11,70014,3074892,947337056
1566,4831819851,236803659,3.1968493965e-11,67658,3074892,950411948
1569,4838833738,236672839,3.1950833265e-11,83362,3075392,953487340
1572,4850365536,236803584,3.196848384e-11,65218,3074892,956562232
1575,4840199137,236672379,3.1950771165e-11,68414,3074892,959637124
1578,4834925238,236803682,3.196849707e-11,68416,3074892,962712016
1581,4840115926,236672405,3.1950774675e-11,68964,3074892,965786908
1584,4962009109,236804199,3.1968566865e-11,85230,3075392,968862300
1587,3365998479,236672290,3.195075915e-11,65512,3074892,971937192
1590,3372622630,236672355,3.1950767925e-11,67640,3074892,975012084
1593,4939569640,236803687,3.1968497745000004e-11,68578,3074892,978086976
1596,2360279490,236803645,3.1968492075000003e-11,67224,3074892,981161868
1599,2375757698,236672339,3.1950765765000004e-11,67110,3074892,984236760
1602,2114790020,236672832,3.195083232e-11,83142,3075392,987312152
1605,2155798489,236672346,3.195076671e-11,67324,3074892,990387044
1608,2173413047,236803605,3.1968486675e-11,65926,3074892,993461936
1611,2282643063,236672337,3.1950765495e-11,67044,3074892,996536828
1614,2759488954,236672353,3.1950767655e-11,67238,3074892,999611720
1617,2546977553,236672343,3.1950766305e-11,67236,3074892,1002686612
1620,2218570967,236804193,3.1968566055e-11,85040,3075392,1005762004
1623,2370636770,236672352,3.1950767519999997e-11,67526,3074892,1008836896
1626,2279401563,236672399,3.1950773865e-11,69062,3074892,1011911788
1629,2476719011,236803695,3.1968498825e-11,68840,3074892,1014986680
1632,2436539891,236672395,3.1950773325e-11,68928,3074892,1018061572
1635,2268126336,236672910,3.195084285e-11,85658,3075392,1021136964
1638,2612185073,236672303,3.1950760905e-11,65938,3074892,1024211856
1641,4857091265,236803685,3.1968497475e-11,68524,3074892,1027286748
1644,9502798734,236672398,3.195077373e-11,69026,3074892,1030361640
1647,5007039392,236856232,3.197559132e-11,68966,3074892,1033436532
1650,2176474488,236803705,3.1968500175e-11,69162,3074892,1036511424
1653,2198363192,236672890,3.1950840150000005e-11,85028,3075392,1039586816
1656,2139191800,236672268,3.195075618e-11,64818,3074892,1042661708
1659,2136399449,236672355,3.1950767925e-11,67626,3074892,1045736600
1662,2133998526,236672338,3.1950765630000005e-11,67074,3074892,1048811492
1665,2131450734,236803642,3.196849167e-11,67130,3074892,1051886384
1668,2129401440,236672339,3.1950765765000004e-11,67130,3074892,1054961276
1671,2146105448,236672798,3.195082773e-11,82032,3075392,1058036668
1674,2132952246,236672318,3.195076293e-11,66438,3074892,1061111560
1677,3384664142,236803673,3.1968495855e-11,67752,3074892,1064186452
1680,3351866222,236672343,3.1950766305e-11,67256,3074892,1067261344
1683,2282135370,236672358,3.1950768330000003e-11,67736,3074892,1070336236
1686,2104846131,236804104,3.196855404e-11,82126,3075392,1073411628
1689,2137731392,236672255,3.1950754425e-11,64394,3074892,1076486520
1692,2197191013,236672247,3.1950753345e-11,64140,3074892,1079561412
1695,2138544039,236672249,3.1950753615e-11,64198,3074892,1082636304
1698,2154733906,236672243,3.1950752805e-11,63988,3074892,1085711196
1701,2132423971,236803557,3.1968480195e-11,64336,3074892,1088786088
1704,2113905482,236672814,3.195082989e-11,82568,3075392,1091861480
1707,2239668142,236672220,3.19507497e-11,63248,3074892,1094936372
1710,2155125248,236672310,3.195076185e-11,65792,3074892,1098011264
1713,2144548366,236803798,3.1968512730000004e-11,72202,3074892,1101086156
1716,2159287643,236672477,3.1950784395e-11,71610,3074892,1104161048
1719,2132481022,236672499,3.1950787365000003e-11,72314,3074892,1107235940
1722,3373838008,236672496,3.195078696e-11,72232,3074892,1110310832
1725,3367659684,236816911,3.1970282985e-11,71604,3074892,1113385724
1728,3353364797,236672886,3.195083961e-11,84896,3075392,1116461116
1731,4894181632,236672474,3.1950783990000004e-11,71518,3074892,1119536008
1734,4815316038,236803810,3.196851435e-11,72580,3074892,1122610900
1737,3410119094,236672506,3.195078831e-11,72554,3074892,1125685792
1740,3395675888,236803801,3.1968513135e-11,72282,3074892,1128760684
1743,3373221849,236672992,3.195085392e-11,87942,3075392,1131836076
1746,3340160193,236672357,3.1950768195000004e-11,67700,3074892,1134910968
1749,3385163444,236803755,3.1968506925000004e-11,70782,3074892,1137985860
1752,3455631868,236672460,3.19507821e-11,71038,3074892,1141060752
1755,3365593878,236672465,3.1950782775e-11,71196,3074892,1144135644
1758,3367349615,236816891,3.1970280285e-11,70934,3074892,1147210536
1761,3364624338,236672879,3.1950838665e-11,84678,3075392,1150285928
1764,3448872571,236672391,3.1950772785e-11,68822,3074892,1153360820
1767,3399955621,236803753,3.1968506655000006e-11,70720,3074892,1156435712
1770,3365153409,236672451,3.1950780885e-11,70770,3074892,1159510604
1773,3371991241,236672459,3.1950781965e-11,71012,3074892,1162585496
1776,4841638258,236816850,3.197027475e-11,69110,3074892,1165660388
1779,3386527209,236672854,3.195083529e-11,83844,3075392,1168735780
1782,3389735112,236672379,3.1950771165e-11,68420,3074892,1171810672
1785,3376350005,236803676,3.196849626e-11,68210,3074892,1174885564
1788,4844249192,236672410,3.195077535e-11,69440,3074892,1177960456
1791,6657215195,236803724,3.1968502740000004e-11,69774,3074892,1181035348
1794,4832460313,236672868,3.195083718e-11,84308,3075392,1184110740
1797,4837290882,236803682,3.196849707e-11,68404,3074892,1187185632
1800,4851750021,236672295,3.1950759825000005e-11,65700,3074892,1190260524
1803,4859915072,236803728,3.1968503280000006e-11,69900,3074892,1193335416
1806,2500282934,236672334,3.195076509e-11,66438,3074892,1196410308
1809,2502469478,236803608,3.1968487080000003e-11,66008,3074892,1199485200
1812,2163890709,236673720,3.1950952200000004e-11,112003,3076268,1202561468
1815,2647713671,236672130,3.1950737550000004e-11,60338,3074892,1205636360
1818,2103971113,236672246,3.1950753210000005e-11,64110,3074892,1208711252
1821,2578578994,236803550,3.196847925e-11,64140,3074892,1211786144
1824,2314726326,236672234,3.195075159e-11,63696,3074892,1214861036
1827,3091246468,236672234,3.195075159e-11,63696,3074892,1217935928
1830,3385175453,236804029,3.1968543915e-11,79698,3075392,1221011320
1833,2241053060,236672225,3.1950750375e-11,63422,3074892,1224086212
1836,3229142742,236672337,3.1950765495e-11,67058,3074892,1227161104
1839,5043264523,236816886,3.197027961e-11,70256,3074892,1230235996
1842,9704617869,236672447,3.1950780345000007e-11,70642,3074892,1233310888
1845,11586646514,236830004,3.1972050540000004e-11,70392,3074892,1236385780
1848,9837433219,236987556,3.199332006e-11,70020,3074892,1239460672
1851,2111224376,236672715,3.1950816525e-11,79338,3075392,1242536064
1854,2235158980,236672201,3.1950747135e-11,62642,3074892,1245610956
1857,2134713054,236672156,3.195074106e-11,61160,3074892,1248685848
1860,2136891554,236803492,3.196847142e-11,62250,3074892,1251760740
1863,2132969760,236672471,3.1950783585e-11,71414,3074892,1254835632
1866,2132896770,236672427,3.1950777645e-11,69976,3074892,1257910524
1869,2131683805,236672501,3.1950787635e-11,72386,3074892,1260985416
1872,2131782589,236672498,3.195078723e-11,71724,3074892,1264060308
1875,2281312387,236803793,3.1968512055e-11,72022,3074892,1267135200
1878,2150163877,236672961,3.1950849735e-11,87342,3075392,1270210592
1881,2166486346,236672382,3.1950771570000004e-11,68510,3074892,1273285484
1884,2133237132,236672462,3.1950782370000004e-11,71098,3074892,1276360376
1887,2134421458,236803790,3.1968511650000006e-11,71914,3074892,1279435268
1890,2131053671,236672489,3.1950786015e-11,71974,3074892,1282510160
1893,2129135291,236672516,3.195078966e-11,72880,3074892,1285585052
1896,2131282110,236672890,3.1950840150000005e-11,85008,3075392,1288660444
1899,2133596340,236803759,3.1968507465000006e-11,70926,3074892,1291735336
1902,2128521128,236672446,3.195078021e-11,70596,3074892,1294810228
1905,2122510799,236672470,3.195078345e-11,70784,3074892,1297885120
1908,2133472528,236672427,3.1950777645e-11,69964,3074892,1300960012
1911,2350952266,236672943,3.1950847305e-11,86750,3075392,1304035404
1914,3372843981,236803720,3.19685022e-11,69654,3074892,1307110296
1917,3368459271,236672441,3.1950779535e-11,70416,3074892,1310185188
1920,3365371374,236672458,3.195078183e-11,70966,3074892,1313260080
1923,3370326835,236803752,3.196850652e-11,70696,3074892,1316334972
1926,3374006196,236672387,3.1950772245e-11,68672,3074892,1319409864
1929,3375444088,236672870,3.195083745e-11,84388,3075392,1322485256
1932,3585998099,236803595,3.1968485325000004e-11,65586,3074892,1325560148
1935,3364598914,236672401,3.1950774135000003e-11,68540,3074892,1328635040
1938,3374575097,236672402,3.195077427e-11,69170,3074892,1331709932
1941,2131848411,236803700,3.1968499500000003e-11,69004,3074892,1334784824
1944,3370213888,236672401,3.1950774135000003e-11,69140,3074892,1337859716
1947,3365908092,236672881,3.1950838935e-11,84738,3075392,1340935108
1950,3361283571,236803606,3.196848681e-11,65962,3074892,1344010000
1953,3416903499,236672428,3.195077778e-11,69998,3074892,1347084892
1956,3393494981,236672358,3.1950768330000003e-11,67716,3074892,1350159784
1959,3437954525,236803665,3.1968494775e-11,67868,3074892,1353234676
1962,3364196834,236672854,3.195083529e-11,83840,3075392,1356310068
1965,3365612699,236672288,3.195075888e-11,65456,3074892,1359384960
1968,3364089381,236803686,3.196849761e-11,67942,3074892,1362459852
1971,3386473673,236672364,3.1950769140000003e-11,67940,3074892,1365534744
1974,3390652681,236672379,3.1950771165e-11,68416,3074892,1368609636
1977,3513414801,236816792,3.197026692e-11,67748,3074892,1371684528
1980,4836127424,236672831,3.1950832185e-11,83118,3075392,1374759920
1983,3366279616,236672341,3.1950766035e-11,67192,3074892,1377834812
1986,4841469950,236816749,3.1970261115e-11,66352,3074892,1380909704
1989,3365306268,236672305,3.1950761175e-11,66006,3074892,1383984596
1992,4859833097,236672309,3.1950761715e-11,66146,3074892,1387059488
1995,3369531026,236816743,3.1970260305e-11,66146,3074892,1390134380
1998,4837913338,236672818,3.1950830430000004e-11,82686,3075392,1393209772
2001,4825429378,236803598,3.196848573e-11,65052,3074892,1396284664
2004,3366233987,236672316,3.195076266e-11,66354,3074892,1399359556
2007,4835266096,236803620,3.1968488700000004e-11,66408,3074892,1402434448
2010,3367513073,236672317,3.1950762795e-11,66408,3074892,1405509340
2013,4972191948,236672806,3.1950828810000003e-11,82308,3075392,1408584732
2016,3368831941,236672440,3.19507794e-11,70398,3074892,1411659624
2019,4856628067,236672515,3.1950789525000006e-11,72848,3074892,1414734516
2022,3370995944,236803821,3.1968515835000005e-11,72932,3074892,1417809408
2025,5013377660,236672515,3.1950789525000006e-11,72850,3074892,1420884300
2028,3362257901,236803808,3.196851408e-11,72522,3074892,1423959192
2031,4842427458,236672693,3.1950813555e-11,78624,3075384,1427034576
2034,3338735472,236672445,3.1950780075e-11,69764,3074892,1430109468
2037,4810266419,236806882,3.196892907e-11,73184,3074892,1433184360
2040,4848414810,236672525,3.1950790875e-11,73172,3074892,1436259252
2043,4836680124,236820319,3.1970743065e-11,73224,3074892,1439334144
2046,4851270434,236672449,3.1950780615000004e-11,70688,3074892,1442409036
2049,2539730773,236672883,3.1950839205e-11,84786,3075392,1445484428
2052,2533093258,236672366,3.195076941e-11,67998,3074892,1448559320
2055,2898246512,236672485,3.1950785475e-11,71846,3074892,1451634212
2058,2173900652,236672474,3.1950783990000004e-11,71484,3074892,1454709104
2061,2225685972,236672461,3.1950782235e-11,71076,3074892,1457783996
2064,2395192203,236672486,3.1950785610000004e-11,71090,3074892,1460858888
2067,2214057692,236810252,3.196938402e-11,83502,3075392,1463934280
2070,2286359718,236672379,3.1950771165e-11,68416,3074892,1467009172
2073,2292069766,236672492,3.195078642e-11,72096,3074892,1470084064
2076,2225870224,236672426,3.195077751e-11,69946,3074892,1473158956
2079,5026348443,236823566,3.197118141e-11,69612,3074892,1476233848
2082,9127525325,236672858,3.195083583e-11,83980,3075392,1479309240
2085,11252977417,237002189,3.1995295515000004e-11,69330,3074892,1482384132
2088,2379574959,236672390,3.195077265e-11,68776,3074892,1485459024
2091,2143345815,236672423,3.1950777105e-11,69860,3074892,1488533916
2094,2149157946,236672423,3.1950777105e-11,69836,3074892,1491608808
2097,2154345769,236812916,3.196974366e-11,70014,3074892,1494683700
2100,2133984147,236672825,3.1950831375e-11,82914,3075392,1497759092
2103,2236774925,236672369,3.1950769815000005e-11,68088,3074892,1500833984
2106,2129232337,236672348,3.195076698e-11,67414,3074892,1503908876
2109,2132721981,236672331,3.1950764685e-11,66858,3074892,1506983768
2112,2131060801,236812791,3.1969726785e-11,66800,3074892,1510058660
2115,2141434265,236672329,3.1950764415e-11,66776,3074892,1513133552
2118,2134569314,236673671,3.1950945585000004e-11,110415,3076268,1516209820
2121,2131973278,236672181,3.1950744435e-11,61986,3074892,1519284712
2124,2137356535,236672234,3.195075159e-11,63698,3074892,1522359604
2127,2148862213,236812709,3.1969715715000004e-11,64142,3074892,1525434496
2130,2130714886,236672270,3.1950756450000005e-11,64028,3074892,1528509388
2133,2355667971,236672789,3.1950826515e-11,81728,3075392,1531584780
2136,2145524740,236672106,3.1950734310000004e-11,59526,3074892,1534659672
2139,2131653456,236815697,3.1970119095e-11,62016,3074892,1537734564
2142,2132539172,236672184,3.195074484e-11,62074,3074892,1540809456
2145,2128767312,236672145,3.1950739575e-11,60802,3074892,1543884348
2148,2129829880,236672145,3.1950739575e-11,60802,3074892,1546959240
2151,2130196012,236816271,3.1970196585e-11,80664,3075392,1550034632
2154,2136507495,236672291,3.1950759285e-11,65546,3074892,1553109524
2157,2132798673,236672252,3.1950754020000005e-11,64274,3074892,1556184416
2160,2129261561,236672206,3.195074781e-11,62792,3074892,1559259308
2163,2131852368,236672524,3.195079074e-11,72274,3074892,1562334200
2166,3366094385,236819025,3.1970568375e-11,70948,3074892,1565409092
2169,2131910655,236672497,3.1950787095e-11,72234,3074892,1568483984
2172,4893212194,236672492,3.195078642e-11,72100,3074892,1571558876
2175,4841877571,236819066,3.1970573910000005e-11,72264,3074892,1574633768
2178,3374236251,236672912,3.195084312e-11,85744,3075392,1577709160
2181,3365941677,236819042,3.1970570670000005e-11,71506,3074892,1580784052
2184,3364295347,236672504,3.195078804e-11,72486,3074892,1583858944
2187,3361218547,236672491,3.1950786285e-11,72056,3074892,1586933836
2190,3348424541,236819070,3.197057445e-11,72432,3074892,1590008728
2193,3369870867,236673034,3.195085959e-11,88816,3075392,1593084120
2196,3366670539,236672380,3.19507713e-11,68440,3074892,1596159012
2199,3366764352,236822071,3.1970979585e-11,70726,3074892,1599233904
2202,3522790626,236672460,3.19507821e-11,71062,3074892,1602308796
2205,2230732168,236822088,3.197098188e-11,71276,3074892,1605383688
2208,2604965205,236672462,3.1950782370000004e-11,71108,3074892,1608458580
2211,2125386814,236672914,3.195084339e-11,85820,3075392,1611533972
2214,2217385846,236672387,3.1950772245e-11,68690,3074892,1614608864
2217,2213848945,236822098,3.197098323e-11,71586,3074892,1617683756
2220,2550304920,236672454,3.195078129e-11,70848,3074892,1620758648
2223,2342835567,236672475,3.1950784125e-11,71536,3074892,1623833540
2226,2129864219,236825097,3.1971388095e-11,68996,3074892,1626908432
2229,2204954144,236672870,3.195083745e-11,84356,3075392,1629983824
2232,2198831391,236672351,3.1950767385000004e-11,67506,3074892,1633058716
2235,5137909387,236672381,3.1950771435000005e-11,68486,3074892,1636133608
2238,3708012118,236825089,3.1971387015e-11,69604,3074892,1639208500
2241,5012777499,236672403,3.1950774405e-11,69204,3074892,1642283392
2244,9204529019,236856101,3.1975573635e-11,85124,3075392,1645358784
2247,4908921765,236840279,3.1973437665e-11,67076,3074892,1648433676
2250,2149756063,236672354,3.195076779e-11,67586,3074892,1651508568
2253,2126987745,236672437,3.1950778995000004e-11,70294,3074892,1654583460
2256,2234072172,236672368,3.195076968e-11,68056,3074892,1657658352
2259,2167249795,236828130,3.197179755e-11,68332,3074892,1660733244
2262,2126808466,236672816,3.195083016e-11,82628,3075392,1663808636
2265,2124324284,236672313,3.1950762255e-11,66266,3074892,1666883528
2268,2129067004,236672373,3.1950770355e-11,68204,3074892,1669958420
2271,2122084208,236672380,3.19507713e-11,68454,3074892,1673033312
2274,2329127271,236672373,3.1950770355e-11,68228,3074892,1676108204
2277,2121074996,236672375,3.1950770625000005e-11,68282,3074892,1679183096
2280,2125036368,236672780,3.19508253e-11,81440,3075392,1682258488
2283,2121205985,236672378,3.195077103e-11,68392,3074892,1685333380
2286,2132753989,236828051,3.1971786885000005e-11,66666,3074892,1688408272
2289,2122064998,236672313,3.1950762255e-11,66264,3074892,1691483164
2292,2124060806,236672353,3.1950767655e-11,66654,3074892,1694558056
2295,2223989959,236672809,3.1950829215e-11,82376,3075392,1697633448
2298,2154641429,236831038,3.197219013e-11,64512,3074892,1700708340
2301,2142188026,236672297,3.1950760095e-11,65744,3074892,1703783232
2304,3355834837,236672318,3.195076293e-11,66432,3074892,1706858124
2307,3346962747,236672332,3.1950764820000005e-11,66892,3074892,1709933016
2310,2118810431,236831103,3.1972198905e-11,66642,3074892,1713007908
2313,3356459555,236672841,3.1950833535e-11,83442,3075392,1716083300
2316,3348001954,236672433,3.1950778455e-11,70154,3074892,1719158192
2319,3355096129,236831307,3.1972226445e-11,73256,3074892,1722233084
2322,3389108256,236672559,3.1950795465000005e-11,73336,3074892,1725307976
2325,3409777752,236672526,3.195079101e-11,73202,3074892,1728382868
2328,3378008419,236834366,3.197263941e-11,73452,3074892,1731457760
2331,2129585840,236672729,3.1950818415e-11,79776,3075392,1734533152
2334,3351319349,236672212,3.195074862e-11,63002,3074892,1737608044
2337,3362058222,236834121,3.1972606335e-11,65488,3074892,1740682936
2340,2117678626,236672206,3.195074781e-11,62792,3074892,1743757828
2343,3354823005,236672458,3.195078183e-11,70988,3074892,1746832720
2346,3369566642,236834243,3.1972622805000005e-11,69468,3074892,1749907612
2349,3610278783,236672489,3.1950786015e-11,71974,3074892,1752982504
2352,3329398357,236672476,3.195078426e-11,71562,3074892,1756057396
2355,3397344169,236834340,3.19726359e-11,71662,3074892,1759132288
2358,2116379708,236672890,3.1950840150000005e-11,85006,3075392,1762207680
2361,3357379198,236672429,3.1950777915e-11,70038,3074892,1765282572
2364,3365767477,236837339,3.1973040765e-11,70840,3074892,1768357464
2367,3373156822,236672504,3.195078804e-11,72488,3074892,1771432356
2370,4834468536,236672496,3.195078696e-11,72214,3074892,1774507248
2373,4818278894,236853877,3.1975273395e-11,72454,3074892,1777582140
2376,3351385480,236672808,3.195082908e-11,82366,3075392,1780657532
2379,4871729624,236837326,3.197303901e-11,70442,3074892,1783732424
2382,4825320754,236672417,3.1950776295e-11,69654,3074892,1786807316
2385,3368035106,236672435,3.1950778725e-11,70238,3074892,1789882208
2388,4828880511,236853853,3.1975270155000004e-11,70686,3074892,1792957100
2391,3346321392,236672865,3.1950836775000006e-11,84206,3075392,1796032492
2394,3548937473,236672371,3.1950770085e-11,68172,3074892,1799107384
2397,4849116955,236857173,3.1975718355e-11,70428,3074892,1802182276
2400,4845065975,236672451,3.1950780885e-11,70756,3074892,1805257168
2403,3367494973,236840376,3.1973450760000003e-11,70340,3074892,1808332060
2406,4832019892,236672349,3.1950767115e-11,67448,3074892,1811406952
2409,3368207005,236672754,3.195082179e-11,80612,3075392,1814482344
2412,3367922515,236857053,3.1975702155e-11,66530,3074892,1817557236
2415,4907002927,236672354,3.195076779e-11,67618,3074892,1820632128
2418,3387038697,236857074,3.197570499e-11,67204,3074892,1823707020
2421,4822778367,236672380,3.19507713e-11,67454,3074892,1826781912
2424,3343981798,236672334,3.195076509e-11,66968,3074892,1829856804
2427,4832142441,236861819,3.1976345565000004e-11,112289,3076268,1832933072
2430,4826952594,236672361,3.1950768735e-11,67816,3074892,1836007964
2433,6727034021,236843376,3.1973855760000005e-11,68604,3074892,1839082856
2436,5016393137,236672301,3.1950760635000005e-11,65864,3074892,1842157748
2439,2215941445,236860395,3.1976153325e-11,66000,3074892,1845232640
2442,2310190390,236672846,3.195083421e-11,83580,3075392,1848308032
2445,2090997312,236843283,3.1973843205000006e-11,65600,3074892,1851382924
2448,2766053518,236672314,3.1950762390000004e-11,66310,3074892,1854457816
2451,2394133393,236672336,3.195076536e-11,66004,3074892,1857532708
2454,2207706769,236672308,3.1950761580000004e-11,66114,3074892,1860607600
2457,2221608487,236672308,3.1950761580000004e-11,66114,3074892,1863682492
2460,2085393579,236672828,3.1950831780000006e-11,82994,3075392,1866757884
2463,2298999928,236672227,3.1950750645000006e-11,63478,3074892,1869832776
2466,2114101546,236846451,3.1974270885e-11,69338,3074892,1872907668
2469,5806670867,236672523,3.1950790605e-11,73092,3074892,1875982560
2472,9001654175,236846538,3.197428263e-11,72160,3074892,1879057452
2475,11503668332,236863962,3.197663487e-11,72814,3074892,1882132344
2478,2150383904,236846553,3.1974284655e-11,72624,3074892,1885207236
2481,2136360647,236672743,3.1950820305e-11,80234,3075384,1888282620
2484,2132566277,236672449,3.1950780615000004e-11,69686,3074892,1891357512
2487,2218383048,236672503,3.1950787905000006e-11,72450,3074892,1894432404
2490,2173809644,236849616,3.1974698160000006e-11,72968,3074892,1897507296
2493,2126121988,236672525,3.1950790875e-11,73172,3074892,1900582188
2496,2127667536,236672466,3.195078291e-11,71234,3074892,1903657080
2499,2126723613,236672923,3.1950844605e-11,86098,3075392,1906732472
2502,2118802184,236672494,3.195078669e-11,72160,3074892,1909807364
2505,2130215419,236672560,3.19507956e-11,74288,3074892,1912882256
2508,2128244942,236849656,3.197470356e-11,74268,3074892,1915957148
2511,2266148287,236672555,3.1950794925e-11,74148,3074892,1919032040
2514,3386371081,236672547,3.1950793845e-11,73886,3074892,1922106932
2517,2117250576,236673000,3.1950855e-11,87562,3075392,1925182324
2520,2122593689,236852625,3.1975104375e-11,71572,3074892,1928257216
2523,2124387606,236672578,3.195079803e-11,74892,3074892,1931332108
2526,2122577077,236672513,3.1950789255e-11,72768,3074892,1934407000
2529,2118785045,236672519,3.1950790065e-11,72976,3074892,1937481892
2532,2125426682,236853127,3.1975172145e-11,87886,3075392,1940557284
2535,2130674438,236672492,3.195078642e-11,72098,3074892,1943632176
2538,3379123657,236672483,3.1950785205e-11,71806,3074892,1946707068
2541,3466235589,236852677,3.1975111395e-11,73268,3074892,1949781960
2544,2129715273,236672511,3.1950788985000004e-11,72700,3074892,1952856852
2547,3365968713,236672525,3.1950790875e-11,73158,3074892,1955931744
2550,2125537334,236672970,3.1950850950000005e-11,86592,3075392,1959007136
2553,2125087268,236855691,3.1975518285e-11,71994,3074892,1962082028
2556,2164032202,236672482,3.195078507e-11,71754,3074892,1965156920
2559,2151752267,236672475,3.1950784125e-11,71532,3074892,1968231812
2562,3544093243,236672482,3.195078507e-11,71782,3074892,1971306704
2565,3351220453,236855685,3.1975517475e-11,71808,3074892,1974381596
2568,3356696993,236672877,3.1950838395e-11,84610,3075392,1977456988
2571,3350507786,236672467,3.1950783045e-11,71292,3074892,1980531880
2574,3363761497,236855682,3.1975517070000004e-11,71712,3074892,1983606772
2577,3406061293,236672476,3.195078426e-11,71570,3074892,1986681664
2580,3356666301,236672520,3.19507902e-11,71934,3074892,1989756556
2583,3354778725,236859215,3.1975994025e-11,87292,3075392,1992831948
2586,3347587736,238456611,3.2191642485000006e-11,68200,3078996,1995910944
2589,3359739379,239176470,3.2288823450000003e-11,91596,40462472,2036373416
2592,3351062703,239105987,3.2279308245e-11,90936,40975264,2077348680
2595,3358274146,238913025,3.2253258375e-11,90306,40975616,2118324296
2598,3345315693,238938079,3.2256640665e-11,90714,40974804,2159299100
2601,3353329609,239121906,3.228145731e-11,112042,40975764,2200274864
2604,4812803019,238912887,3.2253239745e-11,88186,40975264,2241250128
2607,3866521577,239123289,3.2281644015e-11,90264,40975156,2282225284
2610,2483194827,238942120,3.22571862e-11,91070,40975056,2323200340
2613,2110550510,238864034,3.224664459e-11,90478,40974748,2364175088
2616,3420737755,239117952,3.228092352e-11,86876,40975416,2405150504
2619,2259241681,238873384,3.2247906840000004e-11,110106,40975624,2446126128
2622,3617499351,238905709,3.2252270715e-11,88374,40975156,2487101284
2625,3475707547,238942089,3.2257182015e-11,87036,40975264,2528076548
2628,3475160564,238913401,3.2253309135e-11,85488,40975056,2569051604
2631,6570625336,239181091,3.2289447285e-11,88186,40975012,2610026616
2634,7561988745,238913634,3.225334059e-11,109874,40976260,2651002876
2637,7499791720,238939798,3.225687273e-11,88500,40975264,2691978140
2640,6583108171,243627920,3.2889769200000005e-11,87162,-1283808316,1408169824
2643,6762711919,236961389,3.1989787515000004e-11,74120,3074892,1411244716
2646,2137986023,236672561,3.1950795735e-11,74318,3074892,1414319608
2649,2131629594,236672584,3.195079884e-11,75078,3074892,1417394500
2652,2195377234,236672581,3.1950798435e-11,74986,3074892,1420469392
2655,2158832798,236935150,3.198624525e-11,74712,3074892,1423544284
2658,2109897815,236672940,3.1950846900000004e-11,86638,3075392,1426619676
2661,2117703907,236672516,3.195078966e-11,72864,3074892,1429694568
2664,2250396131,236672594,3.195080019e-11,75396,3074892,1432769460
2667,2116235981,236935181,3.1986249435e-11,75578,3074892,1435844352
2670,2150079946,236672591,3.1950799785000004e-11,75306,3074892,1438919244
2673,2122615193,236673010,3.195085635e-11,88920,3075392,1441994636
2676,2116930677,236672445,3.1950780075e-11,70556,3074892,1445069528
2679,2126204809,236672529,3.1950791415e-11,73294,3074892,1448144420
2682,2127346064,236935109,3.1986239715000004e-11,73402,3074892,1451219312
2685,2123637203,236672528,3.195079128e-11,73246,3074892,1454294204
2688,2314899925,236672537,3.1950792495e-11,73556,3074892,1457369096
2691,3414321915,236672908,3.195084258e-11,85614,3075392,1460444488
2694,3362132240,236935036,3.1986229860000004e-11,71016,3074892,1463519380
2697,3489607008,236672562,3.195079587e-11,74186,3074892,1466594272
2700,3399136711,236672539,3.1950792765e-11,73626,3074892,1469669164
2703,3351814053,236961393,3.1989788055e-11,74234,3074892,1472744056
2706,3365458448,236672449,3.1950780615000004e-11,70678,3074892,1475818948
2709,3372611553,236672865,3.1950836775000006e-11,84202,3075392,1478894340
2712,3444700698,236961389,3.1989787515000004e-11,74096,3074892,1481969232
2715,3347833124,236672550,3.195079425e-11,73988,3074892,1485044124
2718,3355526375,236672562,3.195079587e-11,74346,3074892,1488119016
2721,3357875177,236935124,3.198624174e-11,73872,3074892,1491193908
2724,3356804908,236673975,3.1950986625e-11,120275,3076268,1494270176
2727,3355302556,236672410,3.195077535e-11,69222,3074892,1497345068
2730,3352067012,236935028,3.1986228780000006e-11,70770,3074892,1500419960
2733,3346613499,236672481,3.1950784935e-11,71720,3074892,1503494852
2736,3353700563,236672399,3.1950773865e-11,69078,3074892,1506569744
2739,3352428615,236934976,3.198622176e-11,69078,3074892,1509644636
2742,3342435122,236672879,3.1950838665e-11,84676,3075392,1512720028
2745,3355558134,236672314,3.1950762390000004e-11,66308,3074892,1515794920
2748,3371866431,236935000,3.1986225e-11,69860,3074892,1518869812
2751,3383728864,236672419,3.1950776565000004e-11,69722,3074892,1521944704
2754,3353483110,236672403,3.1950774405e-11,69206,3074892,1525019596
2757,3365427326,236935002,3.198622527e-11,69916,3074892,1528094488
2760,4824805196,236672860,3.19508361e-11,83846,3075392,1531169880
2763,4836262693,236672469,3.1950783315e-11,71324,3074892,1534244772
2766,3334164864,236672587,3.1950799245e-11,75180,3074892,1537319664
2769,4844419476,236672590,3.1950799650000005e-11,75280,3074892,1540394556
2772,3378469703,236935181,3.1986249435e-11,75738,3074892,1543469448
2775,3355692831,236672891,3.1950840285e-11,85058,3075392,1546544840
2778,4820079265,236672465,3.1950782775e-11,71198,3074892,1549619732
2781,4834348759,236935038,3.198623013e-11,71090,3074892,1552694624
2784,3428287127,236672461,3.1950782235e-11,71086,3074892,1555769516
2787,4843388082,236935039,3.1986230265e-11,71112,3074892,1558844408
2790,4823617383,236672945,3.1950847575e-11,86816,3075392,1561919800
2793,3349473943,236934988,3.198622338e-11,69236,3074892,1564994692
2796,4819703041,236672375,3.1950770625000005e-11,68282,3074892,1568069584
2799,4840079186,236934998,3.198622473e-11,69790,3074892,1571144476
2802,3356002482,236672399,3.1950773865e-11,69080,3074892,1574219368
2805,4878910313,236672407,3.1950774945000003e-11,69330,3074892,1577294260
2808,4830173918,236935438,3.198628413e-11,84072,3075392,1580369652
2811,3353008438,236672352,3.1950767519999997e-11,67536,3074892,1583444544
2814,4836774820,236934992,3.198622392e-11,69584,3074892,1586519436
2817,4837920669,236672431,3.1950778185000004e-11,70110,3074892,1589594328
2820,4844260595,236672422,3.195077697e-11,69804,3074892,1592669220
2823,4839277152,236935038,3.198623013e-11,71070,3074892,1595744112
2826,6615214412,236672415,3.1950776025e-11,69350,3074892,1598819004
2829,4836832414,236672521,3.1950790335000006e-11,73034,3074892,1601893896
2832,4826354660,236672518,3.195078993e-11,72922,3074892,1604968788
2835,4841651363,236961354,3.198978279e-11,72976,3074892,1608043680
2838,6623308811,236672524,3.195079074e-11,73120,3074892,1611118572
2841,4839202566,236961673,3.1989825855e-11,83314,3075392,1614193964
2844,4830737350,236672431,3.1950778185000004e-11,70100,3074892,1617268856
2847,4818672091,236961364,3.1989784140000004e-11,73298,3074892,1620343748
2850,4820069111,236672543,3.1950793305e-11,73740,3074892,1623418640
2853,4824277655,236961369,3.1989784815e-11,73448,3074892,1626493532
2856,6588540100,236672487,3.1950785745e-11,71648,3074892,1629568424
2859,4838654330,236961707,3.1989830445e-11,84438,3075392,1632643816
2862,4841405290,236672381,3.1950771435000005e-11,68472,3074892,1635718708
2865,6670502702,236961318,3.198977793e-11,71802,3074892,1638793600
2868,4807601726,236672479,3.1950784665e-11,71670,3074892,1641868492
2871,4836516443,236961317,3.1989777795e-11,71776,3074892,1644943384
2874,6625630820,236672478,3.1950784530000006e-11,71636,3074892,1648018276
2877,4890447862,236961678,3.1989826529999997e-11,83496,3075392,1651093668
2880,4827281139,236672404,3.195077454e-11,69216,3074892,1654168560
2883,4822599840,236961329,3.1989779415e-11,72168,3074892,1657243452
2886,4835916802,236672439,3.1950779265e-11,70366,3074892,1660318344
2889,4852857293,236672444,3.195077994e-11,70254,3074892,1663393236
2892,6588083615,236987963,3.1993375005000004e-11,84382,3075392,1666468628
2895,6597615897,236961236,3.198976686e-11,69142,3074892,1669543520
2898,6624760944,236672359,3.1950768465e-11,67754,3074892,1672618412
2901,6610461033,236961268,3.198977118e-11,70174,3074892,1675693304
2904,6650019167,236672453,3.1950781155e-11,70812,3074892,1678768196
2907,6582110910,236961272,3.198977172e-11,70286,3074892,1681843088
2910,6601305985,236961656,3.198982356e-11,82790,3075392,1684918480
2913,6613465936,236672442,3.195077967e-11,70476,3074892,1687993372
2916,4887963348,236961225,3.1989765375e-11,68764,3074892,1691068264
2919,4816766986,236672391,3.1950772785e-11,68796,3074892,1694143156
2922,6595295007,236961239,3.1989767265e-11,68908,3074892,1697218048
2925,6584739670,236672386,3.195077211e-11,68638,3074892,1700292940
2928,6687113890,236961637,3.1989820995e-11,82164,3075392,1703368332
2931,6586486144,236961224,3.198976524e-11,68724,3074892,1706443224
2934,2536818847,236672387,3.1950772245e-11,68672,3074892,1709518116
2937,2076541299,236934978,3.198622203e-11,69116,3074892,1712593008
2940,2395147834,236672404,3.195077454e-11,69228,3074892,1715667900
2943,2153796286,236672849,3.1950834615000003e-11,83700,3075392,1718743292
2946,2430847044,236672286,3.195075861e-11,65382,3074892,1721818184
2949,2108177706,236672322,3.195076347e-11,66558,3074892,1724893076
2952,2204967280,236672362,3.195076887e-11,67844,3074892,1727967968
2955,2122768771,236672361,3.1950768735e-11,67484,3074892,1731042860
2958,2375821527,236672354,3.195076779e-11,67622,3074892,1734117752
2961,2260839745,236935339,3.1986270765e-11,80862,3075392,1737193144
2964,3492804676,236672290,3.195075915e-11,65508,3074892,1740268036
2967,2091818269,236672359,3.1950768465e-11,67776,3074892,1743342928
2970,2141818487,236934934,3.198621609e-11,67692,3074892,1746417820
2973,2184945476,236672365,3.1950769275e-11,67952,3074892,1749492712
2976,2139322039,236672255,3.1950754425e-11,64378,3074892,1752567604
2979,2620635486,236672770,3.195082395e-11,81130,3075392,1755642996
2982,2434973251,236934839,3.1986203265000004e-11,64604,3074892,1758717888
2985,2183278896,236672273,3.1950756855e-11,64604,3074892,1761792780
2988,3661764466,236672293,3.1950759555e-11,65622,3074892,1764867672
2991,2291683186,236934826,3.1986201510000005e-11,64198,3074892,1767942564
2994,2131032722,236672716,3.195081666e-11,79374,3075392,1771017956
2997,2203451435,236672263,3.1950755505e-11,64656,3074892,1774092848
3000,2276828283,236934835,3.1986202725e-11,64476,3074892,1777167740
3003,2164698953,236720262,3.195723537e-11,73302,3074896,1780242636
3006,2122970185,236720106,3.195721431e-11,68210,3074896,1783317532
3009,2111118163,236720116,3.1957215660000005e-11,68560,3074896,1786392428
3012,2124806230,236720118,3.195721593e-11,68618,3074896,1789467324
3015,2117738107,236982708,3.199266558e-11,69032,3074896,1792542220
3018,2326840750,236720700,3.19572945e-11,87146,3075396,1795617616
3021,2123362143,236720130,3.1957217550000003e-11,69010,3074896,1798692512
3024,2114365923,236720118,3.195721593e-11,68602,3074896,1801767408
3027,2137339076,236982713,3.1992666255e-11,69174,3074896,1804842304
3030,2113989502,236720128,3.1957217280000005e-11,68924,3074896,1807917200
3033,2120803883,236720760,3.1957302600000005e-11,89484,3075396,1810992596
3036,2118926258,236720144,3.195721944e-11,69462,3074896,1814067492
3039,2117400352,236720188,3.195722538e-11,70888,3074896,1817142388
3042,2276998176,236982752,3.1992671520000004e-11,70444,3074896,1820217284
3045,2281895856,236720178,3.1957224030000004e-11,70554,3074896,1823292180
3048,2101146353,236720182,3.195722457e-11,70692,3074896,1826367076
3051,2155476579,236720826,3.195731151e-11,91214,3075396,1829442472
3054,3386709758,236982713,3.1992666255e-11,69204,3074896,1832517368
3057,3343376877,236720185,3.1957224975000003e-11,70798,3074896,1835592264
3060,2216023475,236720178,3.1957224030000004e-11,70546,3074896,1838667160
3063,3359289965,236982745,3.1992670575e-11,70230,3074896,1841742056
3066,2190028670,236720283,3.1957238205000004e-11,73976,3074896,1844816952
3069,2120147773,236720387,3.1957252245e-11,77356,3074896,1847891848
3072,2130799824,236720370,3.195724995e-11,76786,3074896,1850966744
3075,2125058448,236982948,3.1992697980000005e-11,76816,3074896,1854041640
3078,3346452986,236720380,3.19572513e-11,77136,3074896,1857116536
3081,3357262722,236720725,3.1957297875000004e-11,88334,3075388,1860191924
3084,3349222148,236720303,3.1957240905e-11,74096,3074896,1863266820
3087,3345463082,237009202,3.199624227e-11,76710,3074896,1866341716
3090,3565815670,236720392,3.1957252920000005e-11,77504,3074896,1869416612
3093,3346407075,236982978,3.199270203e-11,77820,3074896,1872491508
3096,3369268966,236720348,3.195724698e-11,76092,3074896,1875566404
3099,3350043459,236720876,3.195731826e-11,93250,3075396,1878641800
3102,3347973968,236982807,3.1992678945e-11,72252,3074896,1881716696
3105,3387704116,236720344,3.1957246440000004e-11,75962,3074896,1884791592
3108,3394057748,236720329,3.1957244415e-11,75462,3074896,1887866488
3111,3351806940,236982922,3.199269447e-11,75988,3074896,1890941384
3114,3356387420,236720348,3.195724698e-11,75542,3074896,1894016280
3117,3514883794,236720844,3.195731394e-11,92190,3075396,1897091676
3120,3352001678,236982814,3.1992679890000004e-11,72490,3074896,1900166572
3123,3396546773,236720359,3.1957248465e-11,76432,3074896,1903241468
3126,3390685704,236720292,3.195723942e-11,74272,3074896,1906316364
3129,3337862152,236982861,3.1992686235000006e-11,74020,3074896,1909391260
3132,3392512341,236720867,3.1957317045e-11,92938,3075396,1912466656
3135,3445253992,236720261,3.1957235235e-11,73268,3074896,1915541552
3138,3349344050,236982836,3.199268286e-11,73186,3074896,1918616448
3141,3368398720,236720292,3.195723942e-11,74260,3074896,1921691344
3144,3396035255,236720303,3.1957240905e-11,74622,3074896,1924766240
3147,4822189110,236982889,3.1992690015e-11,74372,3074896,1927841136
3150,4834478599,236720831,3.1957312185e-11,91776,3075396,1930916532
3153,3353933588,236982869,3.1992687315e-11,74256,3074896,1933991428
3156,4839824913,236720239,3.1957232265000005e-11,72544,3074896,1937066324
3159,4867561609,236982821,3.1992680835e-11,72714,3074896,1940141220
3162,4853139092,236720248,3.195723348e-11,72826,3074896,1943216116
3165,4825147305,237009063,3.1996223505000003e-11,72194,3074896,1946291012
3168,4861428905,236720758,3.195730233e-11,89420,3075396,1949366408
3171,4837275531,236720243,3.1957232805e-11,72672,3074896,1952441304
3174,4857002185,237009106,3.1996229310000003e-11,73564,3074896,1955516200
3177,3391493423,236720251,3.1957233885e-11,72926,3074896,1958591096
3180,3468673308,236982853,3.1992685155e-11,73176,3074896,1961665992
3183,4853005640,236720837,3.1957312995e-11,91988,3075396,1964741388
3186,4870538701,236720138,3.195721863e-11,69246,3074896,1967816284
3189,4852664074,237009002,3.199621527e-11,70184,3074896,1970891180
3192,3351900601,236720223,3.1957230105e-11,72012,3074896,1973966076
3195,4837270283,237009036,3.1996219860000006e-11,71294,3074896,1977040972
3198,4830232169,236720206,3.195722781e-11,71456,3074896,1980115868
3201,4835543092,237009586,3.199629411e-11,89190,3075396,1983191264
3204,4825039971,236720130,3.1957217550000003e-11,68988,3074896,1986266160
3207,2274075377,236982775,3.1992674625e-11,71198,3074896,1989341056
3210,2296794133,236720204,3.195722754e-11,71394,3074896,1992415952
3213,2182803085,236720229,3.1957230915e-11,71654,3074896,1995490848
3216,2056644642,236720054,3.1957207290000006e-11,66530,3074896,1998565744
3219,2148277382,236983337,3.1992750495e-11,89482,3075396,2001641140
3222,2108087833,236720106,3.195721431e-11,68222,3074896,2004716036
3225,2091067277,236720106,3.195721431e-11,68222,3074896,2007790932
3228,2099501744,236720100,3.19572135e-11,68026,3074896,2010865828
3231,2143949720,236982671,3.1992660585e-11,67816,3074896,2013940724
3234,2092657115,236720751,3.1957301385e-11,89176,3075396,2017016120
3237,2230328437,236720075,3.1957210125e-11,67202,3074896,2020091016
3240,2676489033,236720107,3.1957214445e-11,68262,3074896,2023165912
3243,2146047503,236982951,3.1992698385e-11,76348,3074896,2026240808
3246,3184971275,236720338,3.1957245630000004e-11,75756,3074896,2029315704
3249,2580711618,236720359,3.1957248465e-11,76450,3074896,2032390600
3252,2481567749,236720354,3.195724779e-11,76270,3074896,2035465496
3255,2490236178,236720349,3.1957247115e-11,76116,3074896,2038540392
3258,2408362833,236720814,3.195730989e-11,91218,3075396,2041615788
3261,2239923136,236982907,3.1992692445e-11,75508,3074896,2044690684
3264,2228276637,236720357,3.1957248195000003e-11,76392,3074896,2047765580
3267,3497557955,236720348,3.195724698e-11,76088,3074896,2050840476
3270,2132769565,236982932,3.199269582e-11,76302,3074896,2053915372
3273,2229083877,236720830,3.195731205e-11,91734,3075388,2056990760
3276,3393725302,236720228,3.1957230780000003e-11,71582,3074896,2060065656
3279,3342650546,236982903,3.1992691905e-11,75358,3074896,2063140552
3282,2100579361,236720323,3.1957243605e-11,75268,3074896,2066215448
3285,2121380563,236720316,3.195724266e-11,75050,3074896,2069290344
3288,2104541731,236720315,3.1957242525e-11,75008,3074896,2072365240
3291,3350461198,236984311,3.1992881985000004e-11,121127,3076272,2075441512
3294,2121610738,236720161,3.1957221735e-11,69998,3074896,2078516408
3297,3382074147,236720228,3.1957230780000003e-11,72200,3074896,2081591304
3300,3363365743,236720209,3.1957228215000004e-11,71568,3074896,2084666200
3303,2122531300,236982810,3.199267935e-11,72338,3074896,2087741096
3306,2124941182,236720137,3.1957218495e-11,69238,3074896,2090815992
3309,2128594988,236720704,3.195729504e-11,87050,3075396,2093891388
3312,2114304042,236720147,3.1957219845000005e-11,69542,3074896,2096966284
3315,2121648535,236982721,3.1992667335000005e-11,69458,3074896,2100041180
3318,2225873995,236720151,3.1957220385e-11,69678,3074896,2103116076
3321,3425734053,236720140,3.19572189e-11,69342,3074896,2106190972
3324,3361931051,236720742,3.1957300170000005e-11,88890,3075396,2109266368
3327,2122103859,236982657,3.1992658695e-11,67386,3074896,2112341264
3330,2119116630,236720154,3.195722079e-11,69790,3074896,2115416160
3333,2127540384,236720150,3.195722025e-11,69656,3074896,2118491056
3336,3362242315,236720076,3.195721026e-11,67226,3074896,2121565952
3339,3363872039,236982660,3.1992659100000004e-11,67476,3074896,2124640848
3342,3350387318,236720720,3.19572972e-11,87536,3075396,2127716244
3345,3329458114,236720095,3.1957212825e-11,67868,3074896,2130791140
3348,3378420388,237009035,3.1996219725e-11,71270,3074896,2133866036
3351,2261484935,236720193,3.1957226055e-11,71060,3074896,2136940932
3354,3357700238,236720210,3.1957228349999997e-11,71602,3074896,2140015828
3357,3378277602,236982775,3.1992674625e-11,71214,3074896,2143090724
3360,3355921666,236720676,3.1957291260000003e-11,86724,3075396,2146166120
3363,3351441440,236720094,3.195721269e-11,67816,3074896,2149241016
3366,3365621445,236982773,3.1992674355e-11,71132,3074896,2152315912
3369,3360718616,236720284,3.195723834e-11,74022,3074896,2155390808
3372,3365939433,236720334,3.195724509e-11,74842,3074896,2158465704
3375,4820643376,236982875,3.1992688125e-11,74456,3074896,2161540600
3378,3449724840,236720310,3.195724185e-11,74844,3074896,2164615496
3381,3370908540,236983268,3.199274118e-11,87242,3075396,2167690892
3384,3368365533,236720154,3.195722079e-11,69780,3074896,2170765788
3387,3351073032,236720075,3.1957210125e-11,67196,3074896,2173840684
3390,3359597993,236982693,3.1992663555e-11,68524,3074896,2176915580
3393,3358916095,236720322,3.195724347e-11,75242,3074896,2179990476
3396,3353453696,236720296,3.195723996e-11,74398,3074896,2183065372
3399,3343870602,236982946,3.199269771e-11,76754,3074896,2186140268
3402,4833197996,236720352,3.195724752e-11,76230,3074896,2189215164
3405,3383101052,236720382,3.195725157e-11,76390,3074896,2192290060
3408,4826207635,236983465,3.1992767775e-11,93634,3075396,2195365456
3411,4843516530,236720293,3.1957239555e-11,74304,3074896,2198440352
3414,3354764820,236982903,3.1992691905e-11,75382,3074896,2201515248
3417,4823434186,236720338,3.1957245630000004e-11,75754,3074896,2204590144
3420,3364403566,236982919,3.1992694065e-11,75892,3074896,2207665040
3423,4861075337,236720378,3.195725103e-11,77068,3074896,2210739936
3426,4837348886,236720808,3.195730908e-11,91050,3075396,2213815332
3429,3342828516,236982891,3.1992690285e-11,74984,3074896,2216890228
3432,4989982430,236720323,3.1957243605e-11,75264,3074896,2219965124
3435,4980583564,236982883,3.1992689205e-11,74704,3074896,2223040020
3438,4839381003,236720346,3.195724671e-11,75204,3074896,2226114916
3441,4843464811,236983446,3.1992765210000004e-11,93016,3075396,2229190312
3444,3349067643,236720268,3.195723618e-11,73466,3074896,2232265208
3447,4827715390,236982890,3.199269015e-11,74962,3074896,2235340104
3450,4828766093,236720318,3.195724293e-11,75094,3074896,2238415000
3453,4853635017,236720315,3.1957242525e-11,75022,3074896,2241489896
3456,3369896565,236720257,3.1957234695e-11,73136,3074896,2244564792
3459,4891513188,236720790,3.195730665e-11,90456,3075396,2247640188
3462,4822626782,236982740,3.1992669900000004e-11,70062,3074896,2250715084
3465,4841782091,236720222,3.1957229970000003e-11,71982,3074896,2253789980
3468,4840543922,236982845,3.1992684075000003e-11,73496,3074896,2256864876
3471,4838579505,236720293,3.1957239555e-11,73468,3074896,2259939772
3474,6589203311,237009093,3.1996227555e-11,73166,3074896,2263014668
3477,4832123786,236720794,3.195730719e-11,90574,3075396,2266090064
3480,4837233317,236982769,3.1992673815e-11,71004,3074896,2269164960
3483,6612199994,236720302,3.195724077e-11,74592,3074896,2272239856
3486,4852758208,236982800,3.1992678e-11,72018,3074896,2275314752
3489,5024036900,236720214,3.195722889e-11,71738,3074896,2278389648
3492,4840620918,237009609,3.1996297215000004e-11,89918,3075396,2281465044
3495,6626224678,236720163,3.1957222005e-11,70056,3074896,2284539940
3498,4840521066,237009068,3.199622418e-11,72354,3074896,2287614836
3501,4820948019,236720251,3.1957233885e-11,72074,3074896,2290689732
3504,6616515957,237009066,3.199622391e-11,72270,3074896,2293764628
3507,4844432200,236720218,3.195722943e-11,71864,3074896,2296839524
3510,4836470397,237009583,3.1996293705e-11,89096,3075396,2299914920
3513,4818283310,236720205,3.1957227675e-11,71452,3074896,2302989816
3516,3342298657,236982759,3.1992672465000003e-11,70680,3074896,2306064712
3519,2845856369,236720175,3.1957223625e-11,70446,3074896,2309139608
3522,2351006572,236720183,3.1957224705e-11,70724,3074896,2312214504
3525,3029407560,236720183,3.1957224705e-11,70724,3074896,2315289400
3528,2412291718,236720745,3.1957300575e-11,89000,3075396,2318364796
3531,2302064131,236720158,3.195722133e-11,69910,3074896,2321439692
3534,2154211410,236982793,3.1992677055000006e-11,70932,3074896,2324514588
3537,2159155084,236720187,3.1957225245e-11,70848,3074896,2327589484
3540,2473514291,236720187,3.1957225245e-11,70850,3074896,2330664380
3543,2234750704,236720745,3.1957300575e-11,88984,3075396,2333739776
3546,2604216882,236720310,3.195724185e-11,74836,3074896,2336814672
3549,2142584169,236720365,3.1957249275e-11,76632,3074896,2339889568
3552,3492390761,236720358,3.195724833e-11,76396,3074896,2342964464
3555,2494044989,236982963,3.1992700005e-11,77314,3074896,2346039360
3558,2154386254,236720376,3.195725076e-11,76986,3074896,2349114256
3561,3602785777,236720726,3.195729801e-11,88382,3075388,2352189644
3564,2601692624,236720333,3.1957244955e-11,75610,3074896,2355264540
3567,3458654067,236720410,3.1957255350000006e-11,77240,3074896,2358339436
3570,3509012516,236982956,3.199269906e-11,77092,3074896,2361414332
3573,8863184139,236982965,3.1992700275e-11,77384,3074896,2364489228
3576,2261601566,236720824,3.195731124e-11,91572,3075396,2367564624
3579,2103877181,236720223,3.1957230105e-11,72030,3074896,2370639520
3582,2098536807,236720276,3.195723726e-11,73734,3074896,2373714416
3585,2110041606,236982903,3.1992691905e-11,75382,3074896,2376789312
3588,2111251351,236720332,3.1957244820000004e-11,75546,3074896,2379864208
3591,2112983397,236720332,3.1957244820000004e-11,75554,3074896,2382939104
3594,2120081650,236721789,3.1957441515e-11,122923,3076272,2386015376
3597,2120595081,236720268,3.195723618e-11,73468,3074896,2389090272
3600,3490457209,236982942,3.1992697170000005e-11,75754,3074896,2392165168
3603,2148867933,236720352,3.195724752e-11,76222,3074896,2395240064
3606,2120563445,236720251,3.1957233885e-11,72922,3074896,2398314960
3609,2107967713,236720245,3.1957233075e-11,72724,3074896,2401389856
3612,2113513021,236983342,3.1992751170000003e-11,89628,3075396,2404465252
3615,2111551569,236720184,3.1957224840000005e-11,70746,3074896,2407540148
3618,3387161286,236720238,3.195723213e-11,72494,3074896,2410615044
3621,3448553871,236720248,3.195723348e-11,72824,3074896,2413689940
3624,2150781624,236720252,3.1957234020000004e-11,72964,3074896,2416764836
3627,2122466578,236720836,3.1957312859999997e-11,91928,3075396,2419840232
3630,2128346031,236720192,3.195722592e-11,70102,3074896,2422915128
3633,3352751196,236982843,3.1992683805e-11,73410,3074896,2425990024
3636,3478696716,236720199,3.1957226865e-11,71236,3074896,2429064920
3639,2151082880,236720202,3.1957227270000005e-11,71336,3074896,2432139816
3642,2125555581,236720211,3.1957228485e-11,71636,3074896,2435214712
3645,2118093223,236983332,3.199274982e-11,89306,3075396,2438290108
3648,2121781950,236720089,3.1957212015e-11,67682,3074896,2441365004
3651,2113334511,236720215,3.1957229025000004e-11,71766,3074896,2444439900
3654,2118517873,236720215,3.1957229025000004e-11,71764,3074896,2447514796
3657,2212884018,236720210,3.1957228349999997e-11,71600,3074896,2450589692
3660,3368408492,236982791,3.1992676785e-11,71738,3074896,2453664588
3663,3382544671,236720831,3.1957312185e-11,90852,3075396,2456739984
3666,3340960654,236982788,3.199267638e-11,71618,3074896,2459814880
3669,3348605198,236720204,3.195722754e-11,71406,3074896,2462889776
3672,3343039102,236720208,3.195722808e-11,71548,3074896,2465964672
3675,3356362098,236720208,3.195722808e-11,71548,3074896,2469039568
3678,3364658342,237009633,3.1996300455000004e-11,90712,3075396,2472114964
3681,3350294707,236720259,3.1957234965e-11,73184,3074896,2475189860
3684,3370710578,236720218,3.195722943e-11,71870,3074896,2478264756
3687,3423889579,236982834,3.199268259e-11,73126,3074896,2481339652
3690,4860709555,236720216,3.195722916e-11,71812,3074896,2484414548
3693,3359144139,236983217,3.1992734295000006e-11,85572,3074896,2487489444
3696,3346738092,236720601,3.1957281135e-11,83384,3074896,2490564340
3699,3362997488,236720920,3.19573242e-11,94658,3075396,2493639736
3702,3351376230,236982902,3.199269177e-11,75332,3074896,2496714632
3705,3358622020,236720351,3.1957247385e-11,76164,3074896,2499789528
3708,3466684562,236720345,3.1957246575e-11,75998,3074896,2502864424
3711,3365823198,236982917,3.1992693795000005e-11,75814,3074896,2505939320
3714,4824426653,236720908,3.195732258e-11,94278,3075396,2509014716
3717,3360970937,236982851,3.1992684885000003e-11,73668,3074896,2512089612
3720,3491659067,236720355,3.1957247925e-11,76316,3074896,2515164508
3723,4978833842,236720350,3.195724725e-11,76156,3074896,2518239404
3726,3368857951,236982879,3.1992688665e-11,74598,3074896,2521314300
3729,4822938609,236720325,3.1957243875e-11,74378,3074896,2524389196
3732,3355381110,236983422,3.199276197e-11,92240,3075396,2527464592
3735,4835343422,236720284,3.195723834e-11,73996,3074896,2530539488
3738,4837127367,236720299,3.1957240365e-11,74492,3074896,2533614384
3741,3354331774,236982895,3.1992690825e-11,75100,3074896,2536689280
3744,4838672822,236720313,3.1957242255e-11,74960,3074896,2539764176
3747,4817792266,236982890,3.199269015e-11,74936,3074896,2542839072
3750,3525222848,236720804,3.1957308540000004e-11,90896,3075396,2545914468
3753,4841584903,236982830,3.1992682050000006e-11,72998,3074896,2548989364
3756,4875979902,236720202,3.1957227270000005e-11,71328,3074896,2552064260
3759,4874198762,236982814,3.1992679890000004e-11,71524,3074896,2555139156
3762,4825140613,236720239,3.1957232265000005e-11,72546,3074896,2558214052
3765,3349332424,236720808,3.195730908e-11,91044,3075396,2561289448
3768,4816886596,236982798,3.199267773e-11,71948,3074896,2564364344
3771,4852947809,236720221,3.1957229835000004e-11,71948,3074896,2567439240
3774,2371236979,236982792,3.199267692e-11,71752,3074896,2570514136
3777,2270904253,236720174,3.195722349e-11,70424,3074896,2573589032
3780,2189716751,236720219,3.1957229565e-11,71890,3074896,2576663928
3783,2418708801,236982996,3.199270446e-11,78374,3074896,2579738824
3786,2233044797,236720377,3.1957250895e-11,77034,3074896,2582813720
3789,2099525554,236720434,3.195725859e-11,78888,3074896,2585888616
3792,2205118216,236720466,3.1957262910000005e-11,78948,3074896,2588963512
3795,2537312878,236983027,3.1992708645e-11,79384,3074896,2592038408
3798,2592679716,236720926,3.195732501e-11,94876,3075396,2595113804
3801,2381547929,236720337,3.1957245495e-11,75734,3074896,2598188700
3804,2376137937,236982982,3.199270257e-11,77946,3074896,2601263596
3807,2139716882,236720431,3.1957258185e-11,78778,3074896,2604338492
3810,2673499958,236720440,3.19572594e-11,79054,3074896,2607413388
3813,2072598055,236720480,3.19572648e-11,80366,3074896,2610488284
3816,3502249485,236983441,3.1992764535e-11,92844,3075396,2613563680
3819,2672629513,236720402,3.195725427e-11,77830,3074896,2616638576
3822,2186697982,236720417,3.1957256295000005e-11,78330,3074896,2619713472
3825,2173185505,236983026,3.199270851e-11,78380,3074896,2622788368
3828,3412673573,236720420,3.19572567e-11,78408,3074896,2625863264
3831,2132498922,236720920,3.19573242e-11,94656,3075396,2628938660
3834,2110985518,236982945,3.1992697575e-11,76736,3074896,2632013556
3837,2118054069,236720418,3.195725643e-11,78370,3074896,2635088452
3840,2129775151,236720409,3.1957255215e-11,78058,3074896,2638163348
3843,2125725411,236720408,3.195725508e-11,78040,3074896,2641238244
3846,2163646422,236982935,3.1992696225000005e-11,76406,3074896,2644313140
3849,2122841899,236720835,3.1957312725000004e-11,91896,3075396,2647388536
3852,2146399995,236720255,3.1957234425e-11,73068,3074896,2650463432
3855,2174019197,236720368,3.195724968e-11,76734,3074896,2653538328
3858,2151371124,236720392,3.1957252920000005e-11,76512,3074896,2656613224
3861,2149920238,236982933,3.1992695955e-11,76324,3074896,2659688120
3864,2108840828,236720368,3.195724968e-11,76736,3074896,2662763016
3867,3362898274,236720801,3.1957308135e-11,90812,3075396,2665838412
3870,2129194789,236720268,3.195723618e-11,73486,3074896,2668913308
3873,2125853429,236982975,3.1992701625e-11,77694,3074896,2671988204
3876,2120767399,236720320,3.1957243200000004e-11,75186,3074896,2675063100
3879,2114998721,236720314,3.1957242390000003e-11,74978,3074896,2678137996
3882,2113095328,236720824,3.195731124e-11,91536,3075396,2681213392
3885,3347119674,236982826,3.1992681510000004e-11,72864,3074896,2684288288
3888,3361210381,236720336,3.1957245360000006e-11,74686,3074896,2687363184
3891,2185012604,236720324,3.195724374e-11,75312,3074896,2690438080
3894,2148993498,236720315,3.1957242525e-11,74994,3074896,2693512976
3897,3354088592,236720302,3.195724077e-11,74588,3074896,2696587872
3900,2128273480,236721751,3.1957436385e-11,121671,3076272,2699664144
3903,2136961002,236720166,3.1957222410000004e-11,70160,3074896,2702739040
3906,3364083704,236982913,3.1992693255e-11,75694,3074896,2705813936
3909,3367224608,236720397,3.1957253595e-11,77688,3074896,2708888832
3912,2128434222,236720394,3.195725319e-11,77576,3074896,2711963728
3915,2111647409,236720392,3.1957252920000005e-11,77520,3074896,2715038624
3918,2123790480,236983456,3.1992766560000006e-11,93352,3075396,2718114020
3921,3348423248,236720105,3.1957214175e-11,67154,3074896,2721188916
3924,3350478545,236720154,3.195722079e-11,69782,3074896,2724263812
3927,3348741885,236982685,3.1992662475000004e-11,68272,3074896,2727338708
3930,3358435100,236720067,3.1957209045e-11,66944,3074896,2730413604
3933,3382852974,236720412,3.1957255620000004e-11,78182,3074896,2733488500
3936,3464226323,236982948,3.1992697980000005e-11,76842,3074896,2736563396
3939,3356324422,236720451,3.1957260885e-11,79440,3074896,2739638292
3942,3361227858,236720443,3.1957259805000003e-11,79170,3074896,2742713188
3945,3387886255,236983028,3.1992708780000004e-11,79414,3074896,2745788084
3948,3349617120,236720969,3.1957330815e-11,96256,3075396,2748863480
3951,4833967800,236720383,3.1957251705e-11,77208,3074896,2751938376
3954,3328605693,236983012,3.199270662e-11,77826,3074896,2755013272
3957,3351590464,236720442,3.195725967e-11,79130,3074896,2758088168
3960,3361257228,236720448,3.1957260480000004e-11,79342,3074896,2761163064
3963,3358308192,236983049,3.1992711615e-11,80108,3074896,2764237960
3966,3355021692,236720904,3.195732204e-11,94142,3075396,2767313356
3969,3352257523,236720392,3.1957252920000005e-11,77530,3074896,2770388252
3972,4821283551,237009237,3.1996246995e-11,77832,3074896,2773463148
3975,3370443354,236720406,3.1957254810000003e-11,77966,3074896,2776538044
3978,3549267111,236720403,3.1957254405e-11,77858,3074896,2779612940
3981,3413521990,236983518,3.1992774930000006e-11,95364,3075396,2782688336
3984,3379767214,236720356,3.195724806e-11,76330,3074896,2785763232
3987,4863301190,237009271,3.1996251585000004e-11,77880,3074896,2788838128
3990,3362957160,236720418,3.195725643e-11,78370,3074896,2791913024
3993,4823998801,236720408,3.195725508e-11,78046,3074896,2794987920
3996,4841123037,237009197,3.1996241595000005e-11,76550,3074896,2798062816
3999,4826800840,236720882,3.195731907e-11,93444,3075396,2801138212
4002,4825520145,237009090,3.199622715e-11,73062,3074896,2804213108
4005,4825257767,236720337,3.1957245495e-11,75718,3074896,2807288004
4008,2273895121,236982946,3.199269771e-11,76772,3074896,2810362900
4011,2207981150,236720364,3.195724914e-11,76606,3074896,2813437796
4014,2244638622,236720363,3.1957249005000003e-11,76580,3074896,2816512692
4017,2572092896,236983501,3.1992772635e-11,93648,3075396,2819588088
4020,2141790245,236720287,3.1957238745e-11,74100,3074896,2822662984
4023,2262361310,236720390,3.195725265e-11,77452,3074896,2825737880
4026,2112665117,236720328,3.195724428e-11,75432,3074896,2828812776
4029,2521401083,236982910,3.199269285e-11,75584,3074896,2831887672
4032,2168378233,236720872,3.1957317720000004e-11,93110,3075396,2834963068
4035,3372846133,236720255,3.1957234425e-11,73058,3074896,2838037964
4038,6597001770,236982914,3.199269339e-11,75714,3074896,2841112860
4041,11580132676,236720338,3.1957245630000004e-11,75768,3074896,2844187756
4044,11230884337,237403045,3.2049411075e-11,75964,3074896,2847262652
4047,2119802392,236720336,3.1957245360000006e-11,75710,3074896,2850337548
4050,2125373203,236720876,3.195731826e-11,91786,3075396,2853412944
4053,2283865431,236720221,3.1957229835000004e-11,71952,3074896,2856487840
4056,2240816870,236720267,3.1957236045e-11,73446,3074896,2859562736
4059,2128669946,236720268,3.195723618e-11,73486,3074896,2862637632
4062,2126937864,236720272,3.195723672e-11,73626,3074896,2865712528
4065,2116294365,236720272,3.195723672e-11,73626,3074896,2868787424
4068,2123683164,236720802,3.195730827e-11,90852,3075396,2871862820
4071,2119637541,236985863,3.1993091505000005e-11,72354,3074896,2874937716
4074,2129187725,236720287,3.1957238745e-11,74086,3074896,2878012612
4077,2127741481,236720276,3.195723726e-11,73754,3074896,2881087508
4080,2149808142,236720276,3.195723726e-11,73754,3074896,2884162404
4083,2167051062,236989534,3.1993587090000004e-11,90950,3075396,2887237800
4086,2122349507,236720375,3.1957250625000004e-11,76958,3074896,2890312696
4089,2118794023,236720477,3.1957264395e-11,80282,3074896,2893387592
4092,2116729732,236720480,3.19572648e-11,80366,3074896,2896462488
4095,2116460997,236720473,3.1957263855000004e-11,80146,3074896,2899537384
4098,2128036318,236989150,3.199353525e-11,79956,3074896,2902612280
4101,2122414470,236720752,3.195730152e-11,89202,3075388,2905687668
4104,2118773525,236720409,3.1957255215e-11,78070,3074896,2908762564
4107,2119183511,236720470,3.195726345e-11,80058,3074896,2911837460
4110,2320151509,236989159,3.1993536465000005e-11,80228,3074896,2914912356
4113,2155774971,236720478,3.1957264530000005e-11,80312,3074896,2917987252
4116,3372058029,236720455,3.1957261425e-11,78080,3074896,2921062148
4119,3348193152,236720865,3.1957316775000005e-11,92902,3075396,2924137544
4122,3356891580,236992072,3.199392972e-11,75682,3074896,2927212440
4125,3352661027,236720452,3.195726102e-11,79476,3074896,2930287336
4128,3388078221,236720424,3.195725724e-11,78556,3074896,2933362232
4131,3386823298,236992166,3.199394241e-11,78734,3074896,2936437128
4134,3363779959,236720917,3.1957323795e-11,94570,3075396,2939512524
4137,3398799703,236720335,3.1957245225e-11,75670,3074896,2942587420
4140,3360433057,236992125,3.1993936875e-11,77422,3074896,2945662316
4143,3352899411,236720446,3.195726021e-11,79276,3074896,2948737212
4146,3349911801,236720442,3.195725967e-11,77658,3074896,2951812108
4149,3354030080,236995177,3.1994348895e-11,77396,3074896,2954887004
4152,3383323113,236720833,3.1957312455e-11,91850,3075396,2957962400
4155,3444003789,236720395,3.1957253325e-11,77608,3074896,2961037296
4158,3349113974,236995113,3.1994340255000004e-11,75294,3074896,2964112192
4161,3358297786,236720387,3.1957252245e-11,77340,3074896,2967187088
4164,3344737309,236720390,3.195725265e-11,77438,3074896,2970261984
4167,3355543338,236995181,3.1994349435e-11,77520,3074896,2973336880
4170,2133812585,236720818,3.195731043e-11,91356,3075396,2976412276
4173,3354715938,236720329,3.1957244415e-11,75458,3074896,2979487172
4176,3351817234,236995132,3.199434282e-11,75906,3074896,2982562068
4179,3356099393,236720387,3.1957252245e-11,75848,3074896,2985636964
4182,4840394318,236720344,3.1957246440000004e-11,75946,3074896,2988711860
4185,3443467957,237026459,3.1998571965e-11,91848,3075396,2991787256
4188,4841211597,236720242,3.195723267e-11,72628,3074896,2994862152
4191,3363370266,236998138,3.1994748630000004e-11,74382,3074896,2997937048
4194,4837556845,236720337,3.1957245495e-11,75728,3074896,3001011944
4197,3356958970,236720336,3.1957245360000006e-11,75704,3074896,3004086840
4200,4833167263,236998168,3.1994752680000005e-11,75364,3074896,3007161736
4203,4983659214,236721770,3.195743895e-11,122299,3076272,3010238008
4206,4973858866,236997905,3.1994717175000004e-11,66824,3074896,3013312904
4209,2206121245,236720096,3.195721296e-11,67884,3074896,3016387800
4212,2305599468,237000999,3.1995134865e-11,66614,3074896,3019462696
4215,2111815589,236720132,3.195721782e-11,69060,3074896,3022537592
4218,2206717288,236720057,3.1957207695e-11,66614,3074896,3025612488
4221,2137663082,236720788,3.195730638e-11,90382,3075396,3028687884
4224,2142308362,237001103,3.1995148905000003e-11,71540,3074896,3031762780
4227,2076071275,236720241,3.1957232535e-11,72600,3074896,3034837676
4230,2569217496,236720161,3.1957221735e-11,70016,3074896,3037912572
4233,2361949126,236720429,3.1957257915000005e-11,78722,3074896,3040987468
4236,2322449621,236720434,3.195725859e-11,78866,3074896,3044062364
4239,3314428720,236720452,3.195726102e-11,79446,3074896,3047137260
4242,6581076532,236720456,3.195726156e-11,79588,3074896,3050212156
4245,11151168193,237057572,3.200277222e-11,79404,3074896,3053287052
4248,6631484043,237033198,3.199948173e-11,92610,3075396,3056362448
4251,2156056443,236720328,3.195724428e-11,75448,3074896,3059437344
4254,2127279193,236720360,3.19572486e-11,76470,3074896,3062512240
4257,2128121380,236720370,3.195724995e-11,76802,3074896,3065587136
4260,2122810609,236720363,3.1957249005000003e-11,76554,3074896,3068662032
4263,2137920425,236720843,3.1957313805e-11,92172,3075388,3071737420
4266,2178871745,237004183,3.1995564705e-11,72430,3074896,3074812316
4269,2149641029,236720323,3.1957243605e-11,75272,3074896,3077887212
4272,2118042557,236720327,3.1957244145e-11,75412,3074896,3080962108
4275,2115622166,236720388,3.195725238e-11,75822,3074896,3084037004
4278,2125600058,237007320,3.1995988200000003e-11,75182,3074896,3087111900
4281,2119698546,236720803,3.1957308405e-11,90856,3075396,3090187296
4284,2126942485,236720263,3.1957235505e-11,73322,3074896,3093262192
4287,2229978857,236720333,3.1957244955e-11,75596,3074896,3096337088
4290,2128650670,236720328,3.195724428e-11,75426,3074896,3099411984
4293,2132074164,237007343,3.1995991305e-11,75916,3074896,3102486880
4296,2126877361,236720276,3.195723726e-11,73724,3074896,3105561776
4299,2118019077,236720769,3.1957303815e-11,89776,3075396,3108637172
4302,2135113665,236720216,3.195722916e-11,71802,3074896,3111712068
4305,2105812959,237007259,3.1995979964999997e-11,73182,3074896,3114786964
4308,3354186423,236720331,3.1957244685e-11,73958,3074896,3117861860
4311,3344743464,236720282,3.195723807e-11,73932,3074896,3120936756
4314,3334816781,237010850,3.199646475e-11,90690,3075396,3124012152
4317,3366442074,236720352,3.195724752e-11,76204,3074896,3127087048
4320,2148317580,236720281,3.1957237935e-11,73902,3074896,3130161944
4323,3354695723,236720396,3.195725346e-11,77650,3074896,3133236840
4326,3360867003,237010372,3.199640022e-11,75140,3074896,3136311736
4329,3356675577,236720337,3.1957245495e-11,75740,3074896,3139386632
4332,3356319392,236720833,3.1957312455e-11,91844,3075396,3142462028
4335,3367218255,237010377,3.1996400895e-11,75292,3074896,3145536924
4338,3632721172,236720343,3.1957246305e-11,75926,3074896,3148611820
4341,3360117139,237013488,3.1996820880000003e-11,75604,3074896,3151686716
4344,3351386106,236720345,3.1957246575e-11,75978,3074896,3154761612
4347,3358587442,236720345,3.1957246575e-11,75976,3074896,3157836508
4350,2116360811,236720801,3.1957308135e-11,90810,3075396,3160911904
4353,3333838580,237013454,3.199681629e-11,76072,3074896,3163986800
4356,3422611779,236720295,3.1957239825000004e-11,74346,3074896,3167061696
4359,3360469399,236720300,3.19572405e-11,74542,3074896,3170136592
4362,2117015173,236720294,3.195723969e-11,74334,3074896,3173211488
4365,3351917069,236720814,3.195730989e-11,91236,3075396,3176286884
4368,4829271614,236720191,3.1957225785000004e-11,70976,3074896,3179361780
4371,3356409811,237042673,3.2000760855e-11,73106,3074896,3182436676
4374,3455578396,236720347,3.1957246845e-11,74434,3074896,3185511572
4377,3344393465,236720294,3.195723969e-11,74322,3074896,3188586468
4380,4812127059,237016465,3.1997222775e-11,74710,3074896,3191661364
4383,3348873294,236720895,3.1957320825e-11,93870,3075396,3194736760
4386,4844981615,237016562,3.1997235870000004e-11,77860,3074896,3197811656
4389,4825146074,236720493,3.1957266555e-11,80786,3074896,3200886552
4392,3515700439,236720482,3.195726507e-11,80424,3074896,3203961448
4395,4829587204,237016635,3.1997245725000005e-11,80260,3074896,3207036344
4398,4786789233,236720477,3.1957264395e-11,80274,3074896,3210111240
4401,3425711821,237016895,3.1997280825e-11,88676,3075396,3213186636
4404,3366879608,236720302,3.195724077e-11,72972,3074896,3216261532
4407,4869492876,236720254,3.195723429e-11,73030,3074896,3219336428
4410,3407060039,236720207,3.1957227945e-11,71506,3074896,3222411324
4413,3380312299,236720416,3.195725616e-11,78296,3074896,3225486220
4416,2945752932,236720366,3.195724941e-11,76680,3074896,3228561116
4419,2399582064,236720432,3.195725832e-11,78810,3074896,3231636012
4422,2485197606,236720442,3.195725967e-11,79146,3074896,3234710908
4425,2229745018,236720437,3.1957258995e-11,78982,3074896,3237785804
4428,2259069270,236720887,3.1957319745e-11,93592,3075396,3240861200
4431,2145318768,236720381,3.1957251435e-11,77168,3074896,3243936096
4434,2314187869,236720422,3.195725697e-11,78496,3074896,3247010992
4437,2167309776,237019710,3.199766085e-11,79340,3074896,3250085888
4440,3528244275,236720441,3.1957259535000005e-11,79102,3074896,3253160784
4443,2245372892,236720458,3.195726183e-11,79654,3074896,3256235680
4446,3426648012,237023098,3.1998118230000004e-11,91862,3075396,3259311076
4449,3878072876,236720421,3.1957256835e-11,78444,3074896,3262385972
4452,3375285857,236720397,3.1957253595e-11,77664,3074896,3265460868
4455,2690143542,236720408,3.195725508e-11,78038,3074896,3268535764
4458,2321035693,236720395,3.1957253325e-11,77606,3074896,3271610660
4461,4236450028,237023140,3.19981239e-11,93208,3075396,3274686056
4464,3802557365,236720380,3.19572513e-11,77130,3074896,3277760952
4467,3567131697,236720409,3.1957255215e-11,78072,3074896,3280835848
4470,3346086638,236720454,3.1957261290000005e-11,77896,3074896,3283910744
4473,9198113280,237178386,3.201908211e-11,78072,3074896,3286985640
4476,2205552232,236720348,3.195724698e-11,76064,3074896,3290060536
4479,2183895529,236720800,3.1957308e-11,90786,3075396,3293135932
4482,2120753423,236720248,3.195723348e-11,72822,3074896,3296210828
4485,2121155199,237025646,3.199846221e-11,75424,3074896,3299285724
4488,2117180091,236720367,3.1957249545000006e-11,76696,3074896,3302360620
4491,2125172491,236720361,3.1957248735000006e-11,76516,3074896,3305435516
4494,2121677360,236720357,3.1957248195000003e-11,76370,3074896,3308510412
4497,2113896707,236720804,3.1957308540000004e-11,90896,3075396,3311585808
4500,2116141343,237025569,3.1998451815e-11,72928,3074896,3314660704
4503,2123257824,236720425,3.1957257375e-11,76916,3074896,3317735600
4506,2153065060,236720266,3.195723591e-11,73428,3074896,3320810496
4509,2146565881,236720270,3.1957236450000004e-11,73542,3074896,3323885392
4512,2141664835,236721799,3.1957442865000004e-11,123253,3076272,3326961664
4515,2126740641,236720141,3.1957219035000005e-11,69348,3074896,3330036560
4518,2121184914,236720157,3.1957221195e-11,69884,3074896,3333111456
4521,2117273067,236720173,3.1957223354999997e-11,70400,3074896,3336186352
4524,3346355059,236720169,3.1957222815e-11,70262,3074896,3339261248
4527,2133041137,236720177,3.1957223895e-11,70538,3074896,3342336144
4530,2117895814,236720734,3.195729909e-11,88636,3075396,3345411540
4533,2329954326,236720143,3.1957219305e-11,67758,3074896,3348486436
4536,2132532240,236720268,3.195723618e-11,73496,3074896,3351561332
4539,2123154421,237031795,3.1999292325000004e-11,76872,3074896,3354636228
4542,2107457196,236720359,3.1957248465e-11,76444,3074896,3357711124
4545,2118295118,236720379,3.1957251165000006e-11,77098,3074896,3360786020
4548,2123473076,236720374,3.195725049e-11,76932,3074896,3363860916
4551,2115608526,237032120,3.1999336200000004e-11,87440,3075388,3366936304
4554,2112744825,236720404,3.1957254540000006e-11,77922,3074896,3370011200
4557,2120603310,236720487,3.1957265745e-11,80610,3074896,3373086096
4560,3347005535,236720463,3.1957262505e-11,79816,3074896,3376160992
4563,3346099341,237031911,3.1999307985000004e-11,80622,3074896,3379235888
4566,3403537755,236720491,3.1957266285000004e-11,79028,3074896,3382310784
4569,3421414725,236720855,3.1957315425e-11,92546,3075396,3385386180
4572,3481419492,237034808,3.1999699080000004e-11,75562,3074896,3388461076
4575,3342803308,236720434,3.195725859e-11,78884,3074896,3391535972
4578,3331280454,236720439,3.1957259265e-11,79024,3074896,3394610868
4581,3357171083,237034903,3.1999711905e-11,78656,3074896,3397685764
4584,3353225543,236720935,3.1957326225e-11,95170,3075396,3400761160
4587,3385099909,236720325,3.1957243875e-11,75346,3074896,3403836056
4590,3428768887,237034855,3.1999705425000006e-11,77098,3074896,3406910952
4593,3388953902,236720432,3.195725832e-11,78814,3074896,3409985848
4596,3343890894,236720364,3.195724914e-11,76612,3074896,3413060744
4599,3349517566,237066355,3.2003957925e-11,77072,3074896,3416135640
4602,3341181000,236720856,3.195731556e-11,92594,3075396,3419211036
4605,3424742542,236720378,3.195725103e-11,77064,3074896,3422285932
4608,3480551191,237069600,3.2004396000000004e-11,75096,3074896,3425360828
4611,3503023174,236720385,3.1957251975e-11,77280,3074896,3428435724
4614,3393593898,236720379,3.1957251165000006e-11,77086,3074896,3431510620
4617,3381132554,237037911,3.2000117985e-11,77198,3074896,3434585516
4620,3393848840,236720813,3.1957309755e-11,91200,3075396,3437660912
4623,3351596759,236720290,3.195723915e-11,74210,3074896,3440735808
4626,4821346538,237069606,3.2004396810000004e-11,75320,3074896,3443810704
4629,3362492275,236720335,3.1957245225e-11,75650,3074896,3446885600
4632,4835478965,236720399,3.1957253865e-11,76014,3074896,3449960496
4635,4831609817,237073481,3.2004919935e-11,92094,3075396,3453035892
4638,3357892297,236720237,3.1957231995e-11,72484,3074896,3456110788
4641,4839300988,237040883,3.2000519205000005e-11,74556,3074896,3459185684
4644,3397365095,236720356,3.195724806e-11,76332,3074896,3462260580
4647,4853582401,237040920,3.2000524200000005e-11,75752,3074896,3465335476
4650,4953618110,236720349,3.1957247115e-11,76110,3074896,3468410372
4653,4825078259,237041410,3.2000590350000006e-11,91676,3075396,3471485768
4656,3334542905,236720268,3.195723618e-11,73486,3074896,3474560664
4659,4818619640,236720302,3.195724077e-11,74592,3074896,3477635560
4662,3460250558,237072993,3.2004854055e-11,74508,3074896,3480710456
4665,4784583430,236720293,3.1957239555e-11,74288,3074896,3483785352
4668,4806595936,237076300,3.2005300500000006e-11,74564,3074896,3486860248
4671,4829849940,239821200,3.2375862000000005e-11,88962,3079500,3489939748
4674,6595370259,239796276,3.237249726e-11,94841,39438964,3529378712
4677,3325851566,238967097,3.2260558095e-11,95714,40975312,3570354024
4680,4817569851,238962450,3.225993075e-11,95010,40975412,3611329436
4683,4862363054,239008828,3.226619178e-11,95154,40975312,3652304748
4686,4823767909,238963422,3.226006197e-11,117476,40976328,3693281076
4689,6578472231,239351730,3.2312483550000003e-11,91326,40975060,3734256136
4692,2614758445,239332068,3.230982918e-11,91326,40975872,3775232008
4695,7190021282,248786996,3.3586244460000005e-11,92714,-565314456,3209917552
4698,2560916907,237083515,3.2006274525e-11,71056,3074896,3212992448
4701,3008623655,236720200,3.1957227e-11,71056,3074896,3216067344
4704,3060350579,236720788,3.195730638e-11,90386,3075396,3219142740
4707,2186437238,237083532,3.2006276819999997e-11,71588,3074896,3222217636
4710,2158293095,236720202,3.1957227270000005e-11,71334,3074896,3225292532
4713,2302020954,236720417,3.1957256295000005e-11,78332,3074896,3228367428
4716,2898366726,237083745,3.2006305575000005e-11,78518,3074896,3231442324
4719,2445568666,236720457,3.1957261695e-11,79622,3074896,3234517220
4722,2417663153,236720449,3.1957260615000003e-11,79378,3074896,3237592116
4725,2365828206,236720442,3.195725967e-11,79152,3074896,3240667012
4728,5457931409,237084160,3.20063616e-11,92002,3075396,3243742408
4731,8869178945,236720389,3.1957252515e-11,77052,3074896,3246817304
4734,8832414042,237592432,3.207497832e-11,79668,3074896,3249892200
4737,2152279133,236720460,3.1957262100000005e-11,79724,3074896,3252967096
4740,2306808921,236720456,3.195726156e-11,79590,3074896,3256041992
4743,2137585731,236720856,3.195731556e-11,92574,3075388,3259117380
4746,2143946664,236720332,3.1957244820000004e-11,75556,3074896,3262192276
4749,2129703781,237083725,3.2006302875e-11,77872,3074896,3265267172
4752,2120139809,236720418,3.195725643e-11,78346,3074896,3268342068
4755,2151045539,236720402,3.195725427e-11,77824,3074896,3271416964
4758,2154968975,236720410,3.1957255350000006e-11,78104,3074896,3274491860
4761,2265972371,237084153,3.2006360655e-11,91792,3075396,3277567256
4764,2126944791,236720357,3.1957248195000003e-11,75836,3074896,3280642152
4767,2123488461,236720419,3.1957256565e-11,78386,3074896,3283717048
4770,2119066966,236720416,3.195725616e-11,78288,3074896,3286791944
4773,2124555322,237083746,3.200630571e-11,78556,3074896,3289866840
4776,2118065675,236720358,3.195724833e-11,76418,3074896,3292941736
4779,2113375574,236720789,3.1957306515e-11,90424,3075396,3296017132
4782,2124394153,236720253,3.1957234155e-11,73012,3074896,3299092028
4785,2262174835,236720336,3.1957245360000006e-11,75696,3074896,3302166924
4788,2139188068,237083686,3.200629761e-11,76610,3074896,3305241820
4791,2340229567,236720379,3.1957251165000006e-11,77082,3074896,3308316716
4794,2168531247,236720805,3.1957308675e-11,90932,3075396,3311392112
4797,2111770931,236720295,3.1957239825000004e-11,73820,3074896,3314467008
4800,2111157174,237083608,3.200628708e-11,74054,3074896,3317541904
4803,2114486603,236720377,3.1957250895e-11,77022,3074896,3320616800
4806,2111690409,236720249,3.1957233615e-11,72866,3074896,3323691696
4809,2110539473,236720272,3.195723672e-11,73632,3074896,3326766592
4812,3348257432,236721701,3.1957429635000003e-11,120057,3076272,3329842864
4815,3463653544,236720076,3.195721026e-11,67250,3074896,3332917760
4818,3364427667,236720181,3.1957224435e-11,70652,3074896,3335992656
4821,3348375005,236720167,3.1957222545e-11,70192,3074896,3339067552
4824,3348862609,237083487,3.2006270745000005e-11,70136,3074896,3342142448
4827,3348630269,236720179,3.1957224165e-11,70596,3074896,3345217344
4830,3355469129,236720668,3.195729018e-11,85910,3075396,3348292740
4833,3482446244,236720181,3.1957224435e-11,70654,3074896,3351367636
4836,3357535729,236720304,3.195724104e-11,74644,3074896,3354442532
4839,3375616234,237083694,3.200629869e-11,76860,3074896,3357517428
4842,3336894262,236720393,3.1957253055e-11,77542,3074896,3360592324
4845,3346323472,236720385,3.1957251975e-11,77292,3074896,3363667220
4848,3351482210,237083715,3.2006301525e-11,77544,3074896,3366742116
4851,3346841569,236720747,3.1957300845e-11,89062,3075396,3369817512
4854,3366345563,236720197,3.1957226595000004e-11,71166,3074896,3372892408
4857,3523791981,237083520,3.20062752e-11,71210,3074896,3375967304
4860,2154931542,236720221,3.1957229835000004e-11,71362,3074896,3379042200
4863,3159960259,236720414,3.195725589e-11,78218,3074896,3382117096
4866,2088391873,237083697,3.2006299095000004e-11,76960,3074896,3385191992
4869,2404098447,236720444,3.195725994e-11,79204,3074896,3388266888
4872,2786670122,236720431,3.1957258185e-11,78792,3074896,3391341784
4875,2414002468,237083759,3.2006307465000003e-11,78976,3074896,3394416680
4878,2692780610,236720885,3.1957319475e-11,93540,3075396,3397492076
4881,3588192390,236720385,3.1957251975e-11,77298,3074896,3400566972
4884,5918463704,237083741,3.2006305035e-11,78376,3074896,3403641868
4887,4447053246,236720444,3.195725994e-11,79220,3074896,3406716764
4890,3554288468,237083761,3.2006307735e-11,79024,3074896,3409791660
4893,4057216204,236720483,3.1957265205e-11,79660,3074896,3412866556
4896,5003068193,236720848,3.1957314480000003e-11,92348,3075396,3415941952
4899,4980889147,237083729,3.2006303415e-11,78002,3074896,3419016848
4902,4990203661,236720395,3.1957253325e-11,77622,3074896,3422091744
4905,5035738869,237083736,3.200630436e-11,78218,3074896,3425166640
4908,5020049740,236720410,3.1957255350000006e-11,78108,3074896,3428241536
4911,4407045938,237120534,3.201127209e-11,93330,3075396,3431316932
4914,8742011937,237192693,3.2021013555e-11,76920,3074896,3434391828
4917,2277931389,236720405,3.1957254675e-11,77944,3074896,3437466724
4920,2199735027,236720406,3.1957254810000003e-11,77968,3074896,3440541620
4923,2205934872,236720411,3.1957255485e-11,78130,3074896,3443616516
4926,2202489529,237083706,3.200630031e-11,76406,3074896,3446691412
4929,2132145956,236720816,3.1957310160000005e-11,91296,3075396,3449766808
4932,2133809950,236720258,3.1957234830000004e-11,73170,3074896,3452841704
4935,2116162585,236720359,3.1957248465e-11,76434,3074896,3455916600
4938,2118526308,237083701,3.2006299635000006e-11,77076,3074896,3458991496
4941,2123189527,236720350,3.195724725e-11,76162,3074896,3462066392
4944,2121194818,236720362,3.195724887e-11,76550,3074896,3465141288
4947,2130852645,236720768,3.195730368e-11,89736,3075396,3468216684
4950,3504866304,236720278,3.195723753e-11,73818,3074896,3471291580
4953,3428713033,236720392,3.1957252920000005e-11,77532,3074896,3474366476
4956,2131756198,236720319,3.1957243065e-11,75150,3074896,3477441372
4959,2122668005,236720346,3.195724671e-11,75026,3074896,3480516268
4962,2140035106,237084126,3.2006357010000005e-11,90912,3075396,3483591664
4965,2124728764,236720247,3.1957233345e-11,72792,3074896,3486666560
4968,3374250181,239820675,3.2375791125e-11,74432,3079000,3489745560
4971,4933163056,239811633,3.2374570455000004e-11,98267,39439056,3529184616
4974,3375838925,238967186,3.226057011e-11,95662,40975520,3570160136
4977,3620341146,238991537,3.2263857495000004e-11,95670,40974852,3611134988
4980,3378475783,239334800,3.2310198e-11,118200,40975352,3652110340
4983,3512907535,238971003,3.2261085405e-11,93204,40975520,3693085860
4986,3367523599,238962388,3.225992238e-11,93542,40975476,3734061336
4989,3362031729,239349700,3.23122095e-11,93332,40974700,3775036036
4992,3355450146,248817382,3.3590346570000004e-11,93408,-565304568,3209731468
4995,2116312886,236720265,3.1957235775000003e-11,73208,3074896,3212806364
4998,2318333345,237084051,3.2006346885000006e-11,88470,3075396,3215881760
5001,3368593145,236720270,3.1957236450000004e-11,73554,3074896,3218956656
5004,4823889530,236720270,3.1957236450000004e-11,73554,3074896,3222031552
5007,4844389024,237083590,3.200628465e-11,73472,3074896,3225106448
5010,3373529030,236720268,3.195723618e-11,73470,3074896,3228181344
5013,4856002986,237120351,3.2011247385e-11,87410,3075396,3231256740
5016,4840099109,236720396,3.195725346e-11,77634,3074896,3234331636
5019,4838370502,237083798,3.200631273e-11,80224,3074896,3237406532
5022,4915086394,236720472,3.1957263720000005e-11,80114,3074896,3240481428
5025,3354234451,236720479,3.1957264665000004e-11,80170,3074896,3243556324
5028,4823047531,237120119,3.2011216065e-11,79842,3074896,3246631220
5031,4838858970,236720667,3.1957290045e-11,86458,3075388,3249706608
5034,3381786105,237083677,3.2006296395e-11,76304,3074896,3252781504
5037,3360997317,236720479,3.1957264665000004e-11,80336,3074896,3255856400
5040,3518207213,236720464,3.195726264e-11,79852,3074896,3258931296
5043,3530829870,237120143,3.2011219305e-11,80652,3074896,3262006192
5046,3383576205,236720402,3.195725427e-11,77840,3074896,3265081088
5049,4837745859,237120468,3.201126318e-11,91188,3075396,3268156484
5052,4909314655,236720316,3.195724266e-11,75024,3074896,3271231380
5055,4836108103,237083760,3.20063076e-11,78998,3074896,3274306276
5058,3359171418,236720431,3.1957258185e-11,78498,3074896,3277381172
5061,3345287771,236720428,3.195725778e-11,78676,3074896,3280456068
5064,3349121462,237120069,3.2011209315e-11,78242,3074896,3283530964
5067,4906309484,236720789,3.1957306515e-11,90426,3075396,3286606360
5070,4850379979,236720345,3.1957246575e-11,75978,3074896,3289681256
5073,4901908864,237083770,3.2006308950000005e-11,79330,3074896,3292756152
5076,4873821684,236720379,3.1957251165000006e-11,77098,3074896,3295831048
5079,4835743465,237083692,3.200629842e-11,76804,3074896,3298905944
5082,4830338696,236720807,3.1957308945e-11,90986,3075396,3301981340
5085,4883117055,237083654,3.2006293290000004e-11,75568,3074896,3305056236
5088,4833296358,236720290,3.195723915e-11,74192,3074896,3308131132
5091,4826273332,237083696,3.200629896e-11,76654,3074896,3311206028
5094,4838623606,236720386,3.195725211e-11,77322,3074896,3314280924
5097,6596271443,237083703,3.2006299905e-11,77166,3074896,3317355820
5100,6587856420,237084074,3.200634999e-11,89232,3075396,3320431216
5103,6599468066,236720290,3.195723915e-11,74186,3074896,3323506112
5106,4959138490,237083617,3.2006288295000004e-11,74364,3074896,3326581008
5109,4910440349,236720278,3.195723753e-11,73812,3074896,3329655904
5112,4817044176,237083607,3.2006286945e-11,74030,3074896,3332730800
5115,4818524526,236720284,3.195723834e-11,74006,3074896,3335805696
5118,2118093683,237084964,3.200647014e-11,118141,3076272,3338881968
5121,2135167594,236720136,3.195721836e-11,69174,3074896,3341956864
5124,2160444596,236720202,3.1957227270000005e-11,70970,3074896,3345031760
5127,2166648943,237083529,3.2006276415e-11,71496,3074896,3348106656
5130,2826600321,236720200,3.1957227e-11,71276,3074896,3351181552
5133,3434820866,236720726,3.195729801e-11,88362,3075396,3354256948
5136,3004872010,237083380,3.20062563e-11,66672,3074896,3357331844
5139,3209010168,236720138,3.195721863e-11,69246,3074896,3360406740
5142,2189684012,236720140,3.19572189e-11,69304,3074896,3363481636
5145,3315761733,236720058,3.195720783e-11,66662,3074896,3366556532
5148,4297283132,236720058,3.195720783e-11,66662,3074896,3369631428
5151,3725088865,237083980,3.20063373e-11,86166,3075396,3372706824
5154,3769158572,236720161,3.1957221735e-11,69626,3074896,3375781720
5157,2818957775,237083423,3.2006262105e-11,68058,3074896,3378856616
5160,3728253263,236720103,3.1957213905e-11,68116,3074896,3381931512
5163,2780650456,236720326,3.1957244010000004e-11,75356,3074896,3385006408
5166,2666877552,236720341,3.1957246035e-11,75858,3074896,3388081304
5169,4298889081,236720360,3.19572486e-11,76468,3074896,3391156200
5172,3809365109,237083674,3.200629599e-11,76222,3074896,3394231096
5175,2759083236,236720357,3.1957248195000003e-11,76386,3074896,3397305992
5178,3720357802,237120418,3.201125643e-11,89580,3075396,3400381388
5181,3136439190,236720333,3.1957244955e-11,75598,3074896,3403456284
5184,3388755700,236720367,3.1957249545000006e-11,76702,3074896,3406531180
5187,2235379973,236720383,3.1957251705e-11,76676,3074896,3409606076
5190,2149847045,236720359,3.1957248465e-11,76428,3074896,3412680972
5193,2141964358,236720775,3.1957304625e-11,89958,3075388,3415756360
5196,2138464908,236720321,3.1957243335e-11,75194,3074896,3418831256
5199,2129292998,237083734,3.2006304090000004e-11,78180,3074896,3421906152
5202,3480069507,236720416,3.195725616e-11,78298,3074896,3424981048
5205,2172299961,236720423,3.1957257105000005e-11,78512,3074896,3428055944
5208,3387534909,237083744,3.200630544e-11,78482,3074896,3431130840
5211,2134459752,236720852,3.195731502e-11,92460,3075396,3434206236
5214,3361909360,236720328,3.195724428e-11,75432,3074896,3437281132
5217,3407069718,237083733,3.2006303955e-11,78118,3074896,3440356028
5220,2159727268,236720449,3.1957260615000003e-11,78756,3074896,3443430924
5223,2337343407,236720431,3.1957258185e-11,78772,3074896,3446505820
5226,2119109156,236720380,3.19572513e-11,77132,3074896,3449580716
5229,2133956437,237084127,3.2006357145e-11,90946,3075396,3452656112
5232,2121508996,236720262,3.195723537e-11,73300,3074896,3455731008
5235,2125323961,236720340,3.19572459e-11,75818,3074896,3458805904
5238,2117145690,236720371,3.1957250085e-11,76838,3074896,3461880800
5241,2128384115,236720378,3.195725103e-11,77064,3074896,3464955696
5244,2133063621,237084151,3.2006360385000004e-11,91722,3075396,3468031092
5247,2120774118,236720299,3.1957240365e-11,74480,3074896,3471105988
5250,2128541328,236720280,3.19572378e-11,73884,3074896,3474180884
5253,2145845309,236720424,3.195725724e-11,77756,3074896,3477255780
5256,2104032063,237083636,3.2006290860000004e-11,74984,3074896,3480330676
5259,3417750509,236720333,3.1957244955e-11,75584,3074896,3483405572
5262,3375686945,236720756,3.1957302060000003e-11,89356,3075396,3486480968
5265,3513786069,237083621,3.2006288835e-11,74496,3074896,3489555864
5268,4821989978,239820644,3.237578694e-11,75464,3079000,3492634864
5271,4841118227,239482162,3.233009187e-11,99777,39438560,3532073424
5274,3365565475,238961544,3.225980844e-11,96370,40975128,3573048552
5277,4838118951,238991705,3.2263880175e-11,96396,40975268,3614023820
5280,4919590356,239325538,3.230894763e-11,116794,40975848,3654999668
5283,4965718190,238960608,3.225968208e-11,96512,40974668,3695974336
5286,4870621087,239328706,3.230937531e-11,94390,40975128,3736949464
5289,3384998591,238989943,3.2263642305e-11,93606,40974680,3777924144
5292,4863263211,249361963,3.3663865005e-11,93648,-565283356,3212640788
5295,3372055681,236720746,3.195730071e-11,89026,3075396,3215716184
5298,3370044579,236720217,3.1957229295e-11,71826,3074896,3218791080
5301,3376547248,237086631,3.2006695185000003e-11,73100,3074896,3221865976
5304,3377164202,236720279,3.1957237665e-11,73830,3074896,3224940872
5307,3389378415,236720293,3.1957239555e-11,74290,3074896,3228015768
5310,4836554472,237086646,3.200669721e-11,73580,3074896,3231090664
5313,3364621165,236720742,3.1957300170000005e-11,88886,3075396,3234166060
5316,3374595040,237123419,3.2011661565e-11,77962,3074896,3237240956
5319,3365935308,236720481,3.1957264935e-11,80220,3074896,3240315852
5322,4890764625,236720499,3.1957267365e-11,80986,3074896,3243390748
5325,4849340277,237123504,3.201167304e-11,80738,3074896,3246465644
5328,4832947827,236720490,3.195726615e-11,80712,3074896,3249540540
5331,4833155581,237123725,3.2011702875e-11,87916,3075396,3252615936
5334,4837466564,236720210,3.1957228349999997e-11,71588,3074896,3255690832
5337,4826630185,236720204,3.195722754e-11,71392,3074896,3258765728
5340,4849237236,237123217,3.2011634295e-11,71392,3074896,3261840624
5343,4846659897,236720415,3.1957256025e-11,78260,3074896,3264915520
5346,4844766673,237086740,3.2006709900000005e-11,76644,3074896,3267990416
5349,4827109610,236720449,3.1957260615000003e-11,79372,3074896,3271065312
5352,4842096671,237086822,3.200672097e-11,79098,3074896,3274140208
5355,4841768862,236720436,3.195725886e-11,78934,3074896,3277215104
5358,4839440680,237087195,3.2006771325000004e-11,91442,3075396,3280290500
5361,4884027223,236720326,3.1957244010000004e-11,75370,3074896,3283365396
5364,4827490865,237086792,3.200671692e-11,78334,3074896,3286440292
5367,5072008493,236720451,3.1957260885e-11,79414,3074896,3289515188
5370,4832115257,237123461,3.2011667235e-11,79336,3074896,3292590084
5373,3362468302,236720476,3.195726426e-11,80252,3074896,3295664980
5376,4829507358,237123775,3.2011709625e-11,89528,3075396,3298740376
5379,4826046708,236720397,3.1957253595e-11,77684,3074896,3301815272
5382,4828950635,236720400,3.1957254000000003e-11,77766,3074896,3304890168
5385,4843205650,237123410,3.201166035e-11,77416,3074896,3307965064
5388,4840839998,236720378,3.195725103e-11,77068,3074896,3311039960
5391,4847992207,237087181,3.2006769435e-11,90970,3075396,3314115356
5394,6615149032,236720303,3.1957240905e-11,74612,3074896,3317190252
5397,6653371211,237123406,3.201165981e-11,77550,3074896,3320265148
5400,4842986057,237086780,3.20067153e-11,77932,3074896,3323340044
5403,4879022239,236720408,3.195725508e-11,78014,3074896,3326414940
5406,6644730165,237086685,3.2006702475000005e-11,74846,3074896,3329489836
5409,4867634973,236720723,3.1957297605000006e-11,88276,3075396,3332565232
5412,4828168309,237086744,3.200671044e-11,76760,3074896,3335640128
5415,6608678660,236720415,3.1957256025e-11,78252,3074896,3338715024
5418,6608374500,237086814,3.2006719890000005e-11,78696,3074896,3341789920
5421,4866072852,236720411,3.1957255485e-11,78140,3074896,3344864816
5424,6610710504,237086775,3.2006714625e-11,77792,3074896,3347939712
5427,4845556370,237088184,3.200690484e-11,123555,3076272,3351015984
5430,6670789922,236720418,3.195725643e-11,78364,3074896,3354090880
5433,6605660746,237086801,3.2006718135e-11,78628,3074896,3357165776
5436,4843897003,236720354,3.195724779e-11,76274,3074896,3360240672
5439,6656738213,237086733,3.2006708955e-11,76412,3074896,3363315568
5442,4849307465,237087237,3.2006776995e-11,92788,3075396,3366390964
5445,6606834911,236720310,3.195724185e-11,74854,3074896,3369465860
5448,6643682125,237086748,3.200671098e-11,76524,3074896,3372540756
5451,4823797874,236720366,3.195724941e-11,76678,3074896,3375615652
5454,6585122263,237086740,3.2006709900000005e-11,76652,3074896,3378690548
5457,4825659280,236720374,3.195725049e-11,76928,3074896,3381765444
5460,6606671806,237123853,3.2011720155e-11,92076,3075396,3384840840
5463,6604734477,237086723,3.2006707605e-11,76092,3074896,3387915736
5466,6720424548,236720577,3.1957277895000004e-11,83522,3074896,3390990632
5469,4875222490,237160223,3.2016630105e-11,83356,3074896,3394065528
5472,4928736565,236720571,3.1957277085000004e-11,83328,3074896,3397140424
5475,8748874241,237160478,3.201666453e-11,91642,3075396,3400215820
5478,4850999383,237086795,3.2006717325e-11,78420,3074896,3403290716
5481,2521200833,236720448,3.1957260480000004e-11,78946,3074896,3406365612
5484,3362553594,236720437,3.1957258995e-11,78972,3074896,3409440508
5487,2651838069,236720428,3.195725778e-11,78664,3074896,3412515404
5490,2357539674,236720871,3.1957317585000005e-11,93090,3075396,3415590800
5493,3649120888,237086786,3.200671611e-11,78126,3074896,3418665696
5496,2899342373,236720387,3.1957252245e-11,77352,3074896,3421740592
5499,3533423266,236720392,3.1957252920000005e-11,77508,3074896,3424815488
5502,3898774068,236720378,3.195725103e-11,77064,3074896,3427890384
5505,2503799959,236720372,3.195725022e-11,76854,3074896,3430965280
5508,3894291450,236720800,3.1957308e-11,90792,3075396,3434040676
5511,2477856405,236720314,3.1957242390000003e-11,74978,3074896,3437115572
5514,2855697141,237086782,3.200671557e-11,77466,3074896,3440190468
5517,2645255650,236720394,3.195725319e-11,77578,3074896,3443265364
5520,2441291913,236720368,3.195724968e-11,76730,3074896,3446340260
5523,2567954942,237087287,3.2006783745e-11,94402,3075396,3449415656
5526,3490300344,236720384,3.195725184e-11,77246,3074896,3452490552
5529,9609836238,237123503,3.2011672905e-11,80708,3074896,3455565448
5532,9811724179,237123506,3.201167331e-11,80792,3074896,3458640344
5535,9159508226,237086859,3.2006725965e-11,80514,3074896,3461715240
5538,14653611389,237416590,3.205123965e-11,80242,3074896,3464790136
5541,2148104278,236720793,3.1957307055e-11,90562,3075396,3467865532
5544,2157828144,236720368,3.195724968e-11,76748,3074896,3470940428
5547,2135214665,236720490,3.195726615e-11,80124,3074896,3474015324
5550,2142221597,237086867,3.2006727045e-11,80780,3074896,3477090220
5553,2127824743,236720486,3.1957265609999997e-11,80570,3074896,3480165116
5556,2132067731,236720435,3.1957258725000005e-11,78894,3074896,3483240012
5559,2123990430,236720827,3.1957311645e-11,91644,3075396,3486315408
5562,2194160971,237086708,3.200670558e-11,75606,3074896,3489390304
5565,3497342037,239820735,3.2375799225e-11,79200,3079000,3492469304
5568,4846064212,239507914,3.2333568390000005e-11,107712,39438352,3531907656
5571,3375448494,239353318,3.231269793e-11,100984,40974864,3572882520
5574,3413119730,238961308,3.225977658e-11,101274,40976324,3613858844
5577,3473085973,239325332,3.230891982e-11,120336,40975156,3654834000
5580,3417805778,238954460,3.22588521e-11,98288,40975048,3695809048
5583,3369035900,238959357,3.2259513195e-11,102020,40974948,3736783996
5586,3462105196,239351135,3.2312403225e-11,99602,40975300,3777759296
5589,4982894042,249263133,3.3650522955e-11,99554,-551474516,3226284780
5592,3481519071,236720826,3.195731151e-11,91618,3075396,3229360176
5595,3465215535,237086731,3.2006708685e-11,76360,3074896,3232435072
5598,3369694213,236720359,3.1957248465e-11,76426,3074896,3235509968
5601,3359977758,236720412,3.1957255620000004e-11,78182,3074896,3238584864
5604,3369420017,237086770,3.200671395e-11,77612,3074896,3241659760
5607,3356860768,236720397,3.1957253595e-11,77684,3074896,3244734656
5610,3389510073,236720796,3.195730746e-11,90482,3075396,3247810052
5613,3365319731,237123416,3.201166116e-11,77874,3074896,3250884948
5616,3356716002,236720350,3.195724725e-11,76162,3074896,3253959844
5619,3366417398,236720356,3.195724806e-11,76332,3074896,3257034740
5622,4935088221,237123372,3.201165522e-11,76444,3074896,3260109636
5625,3385035885,236720353,3.1957247655e-11,76246,3074896,3263184532
5628,3363156028,237123732,3.201170382e-11,88126,3075396,3266259928
5631,4833684528,236720336,3.1957245360000006e-11,75710,3074896,3269334824
5634,4833748512,237086752,3.200671152e-11,77014,3074896,3272409720
5637,4822832424,236720357,3.1957248195000003e-11,76376,3074896,3275484616
5640,4839178685,237086740,3.2006709900000005e-11,76626,3074896,3278559512
5643,3362862206,236720812,3.195730962e-11,90982,3075396,3281634908
5646,3368031683,236720247,3.1957233345e-11,72808,3074896,3284709804
5649,4832123165,237086656,3.200669856e-11,73914,3074896,3287784700
5652,3360629282,236720314,3.1957242390000003e-11,74990,3074896,3290859596
5655,3351715319,236720322,3.195724347e-11,75240,3074896,3293934492
5658,4830765702,237086686,3.200670261e-11,74882,3074896,3297009388
5661,4829236489,236720712,3.195729612e-11,87922,3075396,3300084784
5664,4831913014,237123257,3.2011639695000004e-11,72684,3074896,3303159680
5667,4841943585,236720320,3.1957243200000004e-11,75174,3074896,3306234576
5670,4816265209,236720324,3.195724374e-11,75310,3074896,3309309472
5673,4822917822,236720331,3.1957244685e-11,75334,3074896,3312384368
5676,3417133708,236720213,3.1957228755e-11,71692,3074896,3315459264
5679,4844601289,237123658,3.201169383e-11,85750,3075396,3318534660
5682,4828915765,236720180,3.19572243e-11,70604,3074896,3321609556
5685,4847253779,237086627,3.2006694645e-11,72978,3074896,3324684452
5688,4835168374,236720252,3.1957234020000004e-11,72978,3074896,3327759348
5691,4822623801,237123261,3.2011640235e-11,72840,3074896,3330834244
5694,4903507822,236720636,3.195728586e-11,85462,3075396,3333909640
5697,3353121058,236720275,3.1957237125e-11,73716,3074896,3336984536
5700,4827972656,237123323,3.2011648605e-11,74850,3074896,3340059432
5703,4838794582,236720322,3.195724347e-11,75230,3074896,3343134328
5706,4870365560,237123319,3.2011648065000004e-11,74500,3074896,3346209224
5709,4829325696,236720292,3.195723942e-11,74256,3074896,3349284120
5712,4829600477,237123315,3.2011647525e-11,74578,3074896,3352359016
5715,3346982929,236720310,3.195724185e-11,74852,3074896,3355433912
5718,4999280797,236720848,3.1957314480000003e-11,92352,3075396,3358509308
5721,6570892878,237123335,3.2011650225e-11,75250,3074896,3361584204
5724,4848359863,236720325,3.1957243875e-11,75334,3074896,3364659100
5727,4822720394,237123338,3.201165063e-11,75328,3074896,3367733996
5730,6602068196,237123340,3.20116509e-11,75412,3074896,3370808892
5733,4836973644,236720926,3.195732501e-11,94862,3075396,3373884288
5736,4832587635,236720288,3.195723888e-11,74138,3074896,3376959184
5739,6591361964,237123317,3.2011647795e-11,74372,3074896,3380034080
5742,4797218048,236720374,3.195725049e-11,76918,3074896,3383108976
5745,6582823007,237123379,3.2011656165e-11,76666,3074896,3386183872
5748,4837025534,237123382,3.201165657e-11,76754,3074896,3389258768
5751,2546615493,236720938,3.195732663e-11,95264,3075396,3392334164
5754,2736665370,237086704,3.2006705040000004e-11,75460,3074896,3395409060
5757,2578835527,236720300,3.19572405e-11,74516,3074896,3398483956
5760,2428456089,236720373,3.1957250355000006e-11,76896,3074896,3401558852
5763,3019393265,237086762,3.200671287e-11,77350,3074896,3404633748
5766,2396351143,236720311,3.1957241985e-11,74888,3074896,3407708644
5769,3818469842,236720864,3.195731664e-11,92868,3075396,3410784040
5772,2244532613,236720355,3.1957247925e-11,75948,3074896,3413858936
5775,3692002321,236720322,3.195724347e-11,75230,3074896,3416933832
5778,2294205058,237086701,3.2006704635e-11,75364,3074896,3420008728
5781,2930679804,236720327,3.1957244145e-11,75390,3074896,3423083624
5784,2559104867,236720924,3.195732474e-11,94804,3075396,3426159020
5787,3576914433,237086595,3.2006690325e-11,71914,3074896,3429233916
5790,5524769661,236720332,3.1957244820000004e-11,75568,3074896,3432308812
5793,9604813155,237086723,3.2006707605e-11,76076,3074896,3435383708
5796,7508221373,237159927,3.2016590145000004e-11,73728,3074896,3438458604
5799,11403110682,237086651,3.2006697885e-11,73728,3074896,3441533500
5802,10169127673,237087243,3.2006777805e-11,92626,3075396,3444608896
5805,3521902086,237159827,3.2016576645e-11,70496,3074896,3447683792
5808,2259193368,236720285,3.1957238475e-11,74036,3074896,3450758688
5811,3635207028,237086654,3.2006698290000005e-11,73826,3074896,3453833584
5814,2166572532,236720295,3.1957239825000004e-11,74368,3074896,3456908480
5817,3457052274,236720277,3.1957237395000004e-11,73770,3074896,3459983376
5820,2170886126,236720827,3.1957311645e-11,91652,3075396,3463058772
5823,2163196232,237086654,3.2006698290000005e-11,73834,3074896,3466133668
5826,2476170994,236720385,3.1957251975e-11,77288,3074896,3469208564
5829,2157596926,236720479,3.1957264665000004e-11,80336,3074896,3472283460
5832,2120261086,236720483,3.1957265205e-11,80470,3074896,3475358356
5835,2134792701,237086862,3.200672637e-11,80224,3074896,3478433252
5838,2140086367,236720463,3.1957262505e-11,79824,3074896,3481508148
5841,2172366424,236720813,3.1957309755e-11,91212,3075396,3484583544
5844,2169283036,236720211,3.1957228485e-11,71618,3074896,3487658440
5847,3470024365,240186845,3.2425224075e-11,71422,3079000,3490737440
5850,4895199691,239537608,3.233757708e-11,92994,39438296,3530175736
5853,4870287196,239325084,3.230888634e-11,100932,40975476,3571151212
5856,4930020774,238979767,3.2262268544999997e-11,99278,40974696,3612125908
5859,4873631007,239328070,3.230928945e-11,101030,40975268,3653101176
5862,3529260510,238954651,3.2258877885e-11,101068,40975112,3694076288
5865,3359678595,238967290,3.226058415e-11,101354,40975156,3735051444
5868,4828972896,239322926,3.2308595010000006e-11,127602,40975864,3776027308
5871,4831414126,238983750,3.226280625e-11,99784,40974696,3817002004
5874,3566568283,247523505,3.3415673175e-11,100862,-583231864,3233770140
5877,3348933603,236720453,3.1957261155e-11,79484,3074896,3236845036
5880,3448437672,236720448,3.1957260480000004e-11,79348,3074896,3239919932
5883,3352915789,237086834,3.200672259e-11,79700,3074896,3242994828
5886,3403915174,236720911,3.1957322985e-11,94374,3075396,3246070224
5889,3392966515,236720396,3.195725346e-11,77630,3074896,3249145120
5892,3373615052,237086756,3.200671206e-11,77166,3074896,3252220016
5895,3390848731,236720401,3.1957254135e-11,77822,3074896,3255294912
5898,3469050000,236720408,3.195725508e-11,77850,3074896,3258369808
5901,3424400318,237087326,3.200678901e-11,95666,3075396,3261445204
5904,3373941724,236720316,3.195724266e-11,75028,3074896,3264520100
5907,3682665206,236720394,3.195725319e-11,77578,3074896,3267594996
5910,3374435880,237123413,3.2011660755e-11,77770,3074896,3270669892
5913,4905958344,236720388,3.195725238e-11,77390,3074896,3273744788
5916,6724183124,236720337,3.1957245495e-11,75740,3074896,3276819684
5919,9020656765,237160518,3.201666993e-11,92944,3075396,3279895080
5922,6600077227,237196561,3.2021535735e-11,73634,3074896,3282969976
5925,5001842371,236720343,3.1957246305e-11,75930,3074896,3286044872
5928,6684454252,237123359,3.2011653465e-11,75846,3074896,3289119768
5931,5089732490,237086719,3.2006707065e-11,75934,3074896,3292194664
5934,4868848219,236720343,3.1957246305e-11,75908,3074896,3295269560
5937,6623546000,237123892,3.201172542e-11,93352,3075396,3298344956
5940,4864763594,236720280,3.19572378e-11,73872,3074896,3301419852
5943,4866274428,237123396,3.2011658460000007e-11,77222,3074896,3304494748
5946,4865873592,236720307,3.1957241445000004e-11,74748,3074896,3307569644
5949,4846602693,237086692,3.200670342e-11,75092,3074896,3310644540
5952,4869722883,236720859,3.1957315965000005e-11,92698,3075396,3313719936
5955,5192032964,237086615,3.2006693025e-11,72566,3074896,3316794832
5958,4885215254,236720317,3.1957242795e-11,75084,3074896,3319869728
5961,4833386201,237086696,3.200670396e-11,74996,3074896,3322944624
5964,4828687976,236720306,3.195724131e-11,74720,3074896,3326019520
5967,4849380501,237086696,3.200670396e-11,75218,3074896,3329094416
5970,4842591606,236720827,3.1957311645e-11,91662,3075396,3332169812
5973,4846787257,237086620,3.20066937e-11,72740,3074896,3335244708
5976,6612075367,236720229,3.1957230915e-11,72222,3074896,3338319604
5979,4899768010,237123253,3.2011639155e-11,72556,3074896,3341394500
5982,6598705797,236720246,3.1957233210000004e-11,72780,3074896,3344469396
5985,6792957643,237086626,3.200669451e-11,72918,3074896,3347544292
5988,6606432750,236721500,3.19574025e-11,113534,3076240,3350620532
5991,4799136310,237086509,3.2006678715e-11,69124,3074896,3353695428
5994,4836265536,236720176,3.195722376e-11,70258,3074896,3356770324
5997,6596852900,237086527,3.2006681145e-11,69704,3074896,3359845220
6000,6608764114,237086531,3.2006681685e-11,69842,3074896,3362920116
6003,4831075562,236720364,3.195724914e-11,76622,3074896,3365995012
6006,6593428755,237086602,3.200669127e-11,72138,3074896,3369069908
6009,6594795677,236720290,3.195723915e-11,74184,3074896,3372144804
6012,4839127137,237086663,3.2006699505e-11,74126,3074896,3375219700
6015,4848693412,236720287,3.1957238745e-11,74102,3074896,3378294596
6018,6599281771,237087241,3.2006777535e-11,92908,3075396,3381369992
6021,6573969304,237086614,3.200669289e-11,72530,3074896,3384444888
6024,6615051536,236720243,3.1957232805e-11,72680,3074896,3387519784
6027,3410029595,237123301,3.2011645635000003e-11,73854,3074896,3390594680
6030,3512773875,236720290,3.195723915e-11,74200,3074896,3393669576
6033,2806310838,237087269,3.2006781315000004e-11,93826,3075396,3396744972
6036,4342512538,236720140,3.19572189e-11,69322,3074896,3399819868
6039,2631797115,237086593,3.2006690055e-11,71866,3074896,3402894764
6042,3484012669,236720247,3.1957233345e-11,72812,3074896,3405969660
6045,4314458573,236720236,3.195723186e-11,72452,3074896,3409044556
6048,6039556101,236720227,3.1957230645000005e-11,72152,3074896,3412119452
6051,3450145991,237123851,3.2011719885000006e-11,92004,3075396,3415194848
6054,4442880349,236720271,3.1957236585000003e-11,73592,3074896,3418269744
6057,6107532530,237086720,3.20067072e-11,75686,3074896,3421344640
6060,5158142926,237086719,3.2006707065e-11,75936,3074896,3424419536
6063,4134319781,236720354,3.195724779e-11,76286,3074896,3427494432
6066,3543288558,237123313,3.2011647255000004e-11,74510,3074896,3430569328
6069,5350093767,236720776,3.195730476e-11,90000,3075396,3433644724
6072,4129663031,237123137,3.2011623495e-11,68798,3074896,3436719620
6075,5920840608,236720188,3.195722538e-11,70874,3074896,3439794516
6078,4859621624,237123217,3.2011634295e-11,71400,3074896,3442869412
6081,5967969101,236720197,3.1957226595000004e-11,71180,3074896,3445944308
6084,3662904876,236720801,3.1957308135e-11,90812,3075396,3449019704
6087,5365718569,237123194,3.201163119e-11,70664,3074896,3452094600
6090,4914120824,236720268,3.195723618e-11,73142,3074896,3455169496
6093,2146443148,237086691,3.2006703285000005e-11,75046,3074896,3458244392
6096,2231756854,236720190,3.1957225650000005e-11,70960,3074896,3461319288
6099,2176754507,236720197,3.1957226595000004e-11,71170,3074896,3464394184
6102,2136284724,236720802,3.195730827e-11,90844,3075396,3467469580
6105,2130247034,237086543,3.2006683305e-11,70220,3074896,3470544476
6108,2142501338,236720200,3.1957227e-11,71280,3074896,3473619372
6111,2238056580,236720161,3.1957221735e-11,70010,3074896,3476694268
6114,2168680149,236720241,3.1957232535e-11,72594,3074896,3479769164
6117,3409036022,237086611,3.2006692485e-11,72456,3074896,3482844060
6120,2136748850,236720884,3.1957319340000004e-11,93518,3075396,3485919456
6123,3387513123,236720437,3.1957258995e-11,78620,3074896,3488994352
6126,4833563000,240187059,3.2425252965e-11,78902,3079000,3492073352
6129,4863511279,239567626,3.234162951e-11,110869,39438352,3531511704
6132,3376991099,239325409,3.2308930215e-11,102554,40976388,3572488092
6135,3361579683,238954338,3.225883563e-11,102286,40974336,3613462428
6138,3370949087,238989513,3.2263584255e-11,126576,40975976,3654438404
6141,3374671325,239263395,3.2300558325e-11,99496,40975060,3695413464
6144,3363451909,238891176,3.2250308760000004e-11,102178,40974864,3736388328
6147,3908757521,238922424,3.225452724e-11,101886,40974948,3777363276
6150,5007192552,249690863,3.3708266505e-11,101896,-488395972,3288967304
6153,2136431940,236721012,3.195733662e-11,97662,3075396,3292042700
6156,2128519569,236720310,3.195724185e-11,74702,3074896,3295117596
6159,3378338520,237086789,3.2006716515e-11,78218,3074896,3298192492
6162,2174247997,236720414,3.195725589e-11,78220,3074896,3301267388
6165,2295603632,236720407,3.1957254945e-11,77990,3074896,3304342284
6168,3368862534,236720410,3.1957255350000006e-11,78104,3074896,3307417180
6171,3491946933,237087301,3.2006785635e-11,94872,3075396,3310492576
6174,3369950712,236720343,3.1957246305e-11,75920,3074896,3313567472
6177,3367292503,236720424,3.195725724e-11,78542,3074896,3316642368
6180,3361183247,237086799,3.2006717865e-11,78570,3074896,3319717264
6183,3355602598,236720429,3.1957257915000005e-11,78724,3074896,3322792160
6186,3362957408,236720371,3.1957250085e-11,76670,3074896,3325867056
6189,3351911008,237087269,3.2006781315000004e-11,93828,3075396,3328942452
6192,3364376476,236720307,3.1957241445000004e-11,74748,3074896,3332017348
6195,3500943834,236720334,3.195724509e-11,75632,3074896,3335092244
6198,3385848539,236720366,3.195724941e-11,76654,3074896,3338167140
6201,3351039077,236720372,3.195725022e-11,76878,3074896,3341242036
6204,3364232675,237087291,3.2006784285e-11,94556,3075396,3344317432
6207,4826708613,236720341,3.1957246035e-11,75862,3074896,3347392328
6210,3367204507,236720270,3.1957236450000004e-11,73560,3074896,3350467224
6213,3375431945,237086772,3.2006714220000004e-11,77680,3074896,3353542120
6216,3365511007,236720330,3.1957244550000006e-11,75496,3074896,3356617016
6219,3351509091,236720336,3.1957245360000006e-11,75524,3074896,3359691912
6222,3530664673,237087230,3.2006776050000006e-11,92548,3075396,3362767308
6225,3370848932,236720303,3.1957240905e-11,74604,3074896,3365842204
6228,3355831141,236720336,3.1957245360000006e-11,75710,3074896,3368917100
6231,3357918784,237086715,3.2006706525e-11,75822,3074896,3371991996
6234,3351726005,236720327,3.1957244145e-11,75400,3074896,3375066892
6237,4836431599,237086714,3.200670639e-11,75788,3074896,3378141788
6240,4870478373,236720809,3.1957309215e-11,91068,3075396,3381217184
6243,4869809817,237086719,3.2006707065e-11,75940,3074896,3384292080
6246,4937747713,236720284,3.195723834e-11,73994,3074896,3387366976
6249,4831759181,236720284,3.195723834e-11,74022,3074896,3390441872
6252,4828327802,237123317,3.2011647795e-11,74452,3074896,3393516768
6255,4898403284,236720827,3.1957311645e-11,91642,3075396,3396592164
6258,4831623931,237123239,3.2011637265e-11,72114,3074896,3399667060
6261,3355350096,236720261,3.1957235235e-11,73250,3074896,3402741956
6264,4828010459,237123315,3.2011647525e-11,74578,3074896,3405816852
6267,4830682852,236720290,3.195723915e-11,74190,3074896,3408891748
6270,4837997494,236720283,3.1957238205000004e-11,73980,3074896,3411966644
6273,4840327551,237123836,3.201171786e-11,91526,3075396,3415042040
6276,3366712398,236720392,3.1957252920000005e-11,77530,3074896,3418116936
6279,4834141769,237123493,3.2011671555e-11,80390,3074896,3421191832
6282,4836894486,236720481,3.1957264935e-11,80416,3074896,3424266728
6285,4821177137,237123500,3.20116725e-11,80390,3074896,3427341624
6288,4839404540,236720477,3.1957264395e-11,80268,3074896,3430416520
6291,4889268197,236721628,3.195741978e-11,117683,3076272,3433492792
6294,4838258036,237123115,3.2011620525e-11,68088,3074896,3436567688
6297,4928632259,236720148,3.195721998e-11,69598,3074896,3439642584
6300,6623100226,237086472,3.200667372e-11,67936,3074896,3442717480
6303,4870844386,237086675,3.2006701125e-11,74538,3074896,3445792376
6306,4831787596,236720295,3.1957239825000004e-11,74346,3074896,3448867272
6309,4844214904,236720306,3.195724131e-11,74728,3074896,3451942168
6312,4831421231,237123314,3.201164739e-11,74562,3074896,3455017064
6315,6576830882,236720312,3.195724212e-11,74700,3074896,3458091960
6318,4839322931,237123857,3.2011720695e-11,92222,3075396,3461167356
6321,6582579690,236720277,3.1957237395000004e-11,73774,3074896,3464242252
6324,4847157422,237123306,3.2011646310000004e-11,74284,3074896,3467317148
6327,6631941740,236720298,3.195724023e-11,74462,3074896,3470392044
6330,4844428117,237159940,3.2016591900000003e-11,74172,3074896,3473466940
6333,4929863185,236720308,3.195724158e-11,74790,3074896,3476541836
6336,7972669459,237123769,3.2011708815e-11,89340,3075396,3479617232
6339,6918191868,236720179,3.1957224165e-11,70578,3074896,3482692128
6342,2985468437,237086620,3.20066937e-11,72734,3074896,3485767024
6345,2380512940,236720257,3.1957234695e-11,73128,3074896,3488841920
6348,12317544624,240186877,3.2425228395e-11,73254,3079000,3491920920
6351,9286157308,239963753,3.2395106655e-11,141726,38926728,3530847648
6354,8169321550,239363944,3.231413244e-11,93708,40975972,3571823620
6357,11804942212,239305579,3.2306253165e-11,91744,40974864,3612798484
6360,10232778378,239275965,3.2302255275e-11,95082,40976332,3653774816
6363,12559669494,248261560,3.35153106e-11,94292,-258798364,3394976452
6366,5766706446,237086580,3.20066883e-11,71438,3074896,3398051348
6369,6849644058,237123809,3.2011714215e-11,90650,3075396,3401126744
6372,11326963121,237233214,3.202648389e-11,74124,3074896,3404201640
6375,2144873725,236720316,3.195724266e-11,75034,3074896,3407276536
6378,2150060992,236720313,3.1957242255e-11,74950,3074896,3410351432
6381,2143919728,236720315,3.1957242525e-11,75008,3074896,3413426328
6384,2356834989,237086694,3.200670369e-11,75146,3074896,3416501224
6387,2192524889,236720829,3.1957311915000004e-11,91712,3075396,3419576620
6390,2154399510,236720321,3.1957243335e-11,75220,3074896,3422651516
6393,2138850044,236720354,3.195724779e-11,76284,3074896,3425726412
6396,2133283061,237086654,3.2006698290000005e-11,73680,3074896,3428801308
6399,2124026825,236720270,3.1957236450000004e-11,73544,3074896,3431876204
6402,2131957886,236720881,3.1957318935e-11,93408,3075396,3434951600
6405,2127531079,236720228,3.1957230780000003e-11,72192,3074896,3438026496
6408,2422333566,237086657,3.2006698695e-11,73924,3074896,3441101392
6411,2303809002,236720276,3.195723726e-11,73728,3074896,3444176288
6414,2131567041,236720271,3.1957236585000003e-11,73590,3074896,3447251184
6417,2127572784,236720271,3.1957236585000003e-11,73590,3074896,3450326080
6420,2125601955,236720857,3.1957315695e-11,92618,3075396,3453401476
6423,3366768039,237086602,3.200669127e-11,72142,3074896,3456476372
6426,3396623727,236720372,3.195725022e-11,76688,3074896,3459551268
6429,3540359157,236720486,3.1957265609999997e-11,80568,3074896,3462626164
6432,3382589253,237086847,3.2006724345e-11,80096,3074896,3465701060
6435,2137597846,236720482,3.195726507e-11,80428,3074896,3468775956
6438,3365231744,236720463,3.1957262505e-11,79824,3074896,3471850852
6441,3353682449,237087157,3.2006766195e-11,90202,3075388,3474926240
6444,3414191192,236720409,3.1957255215e-11,78064,3074896,3478001136
6447,3456074125,236720477,3.1957264395e-11,80276,3074896,3481076032
6450,3406706534,237086855,3.2006725425e-11,80360,3074896,3484150928
6453,3509177749,236720486,3.1957265609999997e-11,80568,3074896,3487225824
6456,4838154788,240157770,3.2421298950000005e-11,78698,3079000,3490304824
6459,4886260052,239593125,3.2345071875e-11,145049,38926912,3529231736
6462,4855057364,249023155,3.3618125925e-11,98422,-80473484,3448758252
6465,2135629339,236720418,3.195725643e-11,78358,3074896,3451833148
6468,3363906442,236720428,3.195725778e-11,78694,3074896,3454908044
6471,3385778026,237086815,3.2006720025000004e-11,79074,3074896,3457982940
6474,3595736920,236720948,3.195732798e-11,95450,3075396,3461058336
6477,3356160181,236720324,3.195724374e-11,75304,3074896,3464133232
6480,3408000289,237086743,3.2006710305e-11,76746,3074896,3467208128
6483,4903927965,236720434,3.195725859e-11,78886,3074896,3470283024
6486,4842369724,237086756,3.200671206e-11,77144,3074896,3473357920
6489,4826524300,236720381,3.1957251435e-11,77144,3074896,3476432816
6492,3516078235,236720863,3.1957316505e-11,92824,3075396,3479508212
6495,4854130211,237123389,3.2011657515e-11,76998,3074896,3482583108
6498,4955907420,236720310,3.195724185e-11,74862,3074896,3485658004
6501,4911945007,237123392,3.2011657920000004e-11,77076,3074896,3488732900
6504,6655604795,239791352,3.237183252e-11,77406,3079000,3491811900
6507,4873029369,239962964,3.2395000140000004e-11,104513,38926744,3530738644
6510,4871543785,248165421,3.3502331835000005e-11,123628,-57393908,3473344736
6513,3380026077,237123346,3.201165171e-11,75596,3074896,3476419632
6516,4832981649,236720353,3.1957247655e-11,76250,3074896,3479494528
6519,4829817284,236720341,3.1957246035e-11,75866,3074896,3482569424
6522,3366850374,237123362,3.2011653870000004e-11,76116,3074896,3485644320
6525,4843716035,236720871,3.1957317585000005e-11,93076,3075396,3488719716
6528,4829438524,237086645,3.2006697075e-11,73536,3074896,3491794612
6531,3527333396,236720356,3.195724806e-11,76184,3074896,3494869508
6534,4833464312,237086727,3.2006708145e-11,76214,3074896,3497944404
6537,3374579789,236720346,3.195724671e-11,76016,3074896,3501019300
6540,6674742636,240186929,3.2425235415000003e-11,75988,3079000,3504098300
6543,4838559479,249995869,3.3749442315e-11,139924,-9230580,3494867720
6546,4843026464,237086596,3.200669046e-11,71964,3074896,3497942616
6549,4874459019,236720304,3.195724104e-11,74664,3074896,3501017512
6552,4842444454,236720293,3.1957239555e-11,74304,3074896,3504092408
6555,4840842877,237123312,3.2011647120000005e-11,74498,3074896,3507167304
6558,4821791441,236720304,3.195724104e-11,74660,3074896,3510242200
6561,6613252725,237123771,3.2011709085000006e-11,89394,3075396,3513317596
6564,4843540456,236720238,3.195723213e-11,72522,3074896,3516392492
6567,6601070190,237123313,3.2011647255000004e-11,74510,3074896,3519467388
6570,4881042562,236720303,3.1957240905e-11,74624,3074896,3522542284
6573,4859831860,237123325,3.2011648875000004e-11,74730,3074896,3525617180
6576,6606913687,239850263,3.2379785505e-11,90812,3079500,3528696680
6579,6608235947,239926658,3.239009883e-11,93134,38926088,3567622768
6582,6631339014,248449768,3.354071868e-11,91230,-54319412,3513303356
6585,4848400124,237123254,3.201163929e-11,72622,3074896,3516378252
6588,6623140527,236720197,3.1957226595000004e-11,71170,3074896,3519453148
6591,6613571512,237123249,3.2011638615e-11,72426,3074896,3522528044
6594,4888054253,237088049,3.2006886614999997e-11,119185,3076272,3525604316
6597,6629169193,236720168,3.195722268e-11,70062,3074896,3528679212
6600,4824070442,237086613,3.2006692755e-11,72510,3074896,3531754108
6603,6637150294,236720450,3.195726075e-11,79390,3074896,3534829004
6606,4833917193,237123441,3.2011664535e-11,78684,3074896,3537903900
6609,6725063149,236720412,3.1957255620000004e-11,78156,3074896,3540978796
6612,8772657427,240289542,3.2439088170000004e-11,78762,3079000,3544057796
6615,8715899040,250673890,3.3840975150000005e-11,106225,-6154020,3537903776
6618,5056852054,236720958,3.1957329330000004e-11,95922,3075396,3540979172
6621,6615481425,237123460,3.2011667100000004e-11,79284,3074896,3544054068
6624,8751452982,236720504,3.1957268040000004e-11,81144,3074896,3547128964
6627,6616287879,237160160,3.2016621600000004e-11,81328,3074896,3550203860
6630,6657643896,237160168,3.201662268e-11,81580,3074896,3553278756
6633,6603255955,236721076,3.195734526e-11,99744,3075396,3556354152
6636,6618512666,237123447,3.2011665345e-11,78700,3074896,3559429048
6639,6608980191,236720349,3.1957247115e-11,76122,3074896,3562503944
6642,2274676316,236720462,3.195726237e-11,79774,3074896,3565578840
6645,3804626089,237086837,3.2006722995e-11,79800,3074896,3568653736
6648,6867466676,239879164,3.2383687140000006e-11,79400,3079000,3571732736
6651,10365124427,239890536,3.238522236e-11,145705,38927084,3610659820
6654,7608114833,249013681,3.3616846935000004e-11,101656,-52781052,3557878768
6657,3661635101,237086778,3.2006715030000004e-11,77702,3074896,3560953664
6660,3772367363,236720461,3.1957262235e-11,79760,3074896,3564028560
6663,2733213464,237086853,3.2006725155e-11,80316,3074896,3567103456
6666,3808963566,236720422,3.195725697e-11,78488,3074896,3570178352
6669,2990839694,236720921,3.1957324335000004e-11,94722,3075396,3573253748
6672,5555687976,237086796,3.2006717460000004e-11,78454,3074896,3576328644
6675,7013452958,237086799,3.2006717865e-11,78566,3074896,3579403540
6678,7499263594,236720418,3.195725643e-11,78352,3074896,3582478436
6681,6993457600,237123441,3.2011664535e-11,78698,3074896,3585553332
6684,12804520416,240282710,3.2438165850000006e-11,96756,3079500,3588632832
6687,14960943467,251052312,3.389206212e-11,99865,-4623620,3584009212
6690,2289486802,236720431,3.1957258185e-11,78774,3074896,3587084108
6693,2167360362,236720441,3.1957259535000005e-11,79102,3074896,3590159004
6696,2424239519,237086765,3.2006713275000005e-11,77266,3074896,3593233900
6699,2119776180,236720377,3.1957250895e-11,77016,3074896,3596308796
6702,2395149886,236720909,3.1957322715000004e-11,94324,3075396,3599384192
6705,2170789616,236720281,3.1957237935e-11,73898,3074896,3602459088
6708,2146309383,236720396,3.195725346e-11,77658,3074896,3605533984
6711,2141413832,236720390,3.195725265e-11,77438,3074896,3608608880
6714,2145184574,236720392,3.1957252920000005e-11,77520,3074896,3611683776
6717,2298977439,236720374,3.195725049e-11,76922,3074896,3614758672
6720,3486038090,240275211,3.2437153485e-11,93308,3079500,3617838172
6723,3374419164,250066802,3.375901827e-11,98688,-12316052,3605522120
6726,2145426122,236720570,3.195727695e-11,83286,3074896,3608597016
6729,2135360635,236720642,3.195728667e-11,85642,3074896,3611671912
6732,2350234090,237087016,3.2006747160000005e-11,85614,3074896,3614746808
6735,2209415953,236721065,3.1957343775e-11,99388,3075396,3617822204
6738,3388209874,236720372,3.195725022e-11,76874,3074896,3620897100
6741,3362636853,236720411,3.1957255485e-11,78142,3074896,3623971996
6744,3366953970,236720417,3.1957256295000005e-11,78338,3074896,3627046892
6747,3356786546,236720420,3.19572567e-11,78254,3074896,3630121788
6750,3401935119,236720423,3.1957257105000005e-11,78530,3074896,3633196684
6753,3399465170,236720900,3.19573215e-11,94038,3075396,3636272080
6756,5044125773,239937567,3.2391571545000005e-11,76608,3079000,3639351080
6759,4847144580,239929007,3.2390415945000004e-11,97378,38926380,3678277460
6762,4869989635,248700324,3.357454374e-11,96918,-57398380,3620879080
6765,3367379655,237123383,3.2011656705e-11,76790,3074896,3623953976
6768,3354684730,236720918,3.195732393e-11,94430,3075396,3627029372
6771,2290969680,236720315,3.1957242525e-11,75010,3074896,3630104268
6774,3377214755,237086760,3.20067126e-11,77278,3074896,3633179164
6777,3398543196,236720367,3.1957249545000006e-11,76696,3074896,3636254060
6780,3355121739,236720379,3.1957251165000006e-11,77084,3074896,3639328956
6783,3513690172,237086738,3.200670963e-11,76572,3074896,3642403852
6786,3359070527,236720449,3.1957260615000003e-11,79364,3074896,3645478748
6789,3371825273,236720556,3.195727506e-11,82850,3074896,3648553644
6792,5233808620,240304120,3.24410562e-11,82392,3079000,3651632644
6795,4849147507,250589668,3.382960518e-11,113570,-4621700,3647010944
6798,4876551359,237086925,3.2006734875e-11,82636,3074896,3650085840
6801,4866859750,236720943,3.1957327305e-11,95428,3075388,3653161228
6804,4831337115,237086850,3.200672475e-11,80196,3074896,3656236124
6807,4849204554,236720533,3.1957271955e-11,82104,3074896,3659311020
6810,5035245338,236720561,3.1957275735e-11,82852,3074896,3662385916
6813,3378123391,236720555,3.1957274925e-11,82806,3074896,3665460812
6816,4890847142,236720508,3.195726858e-11,81302,3074896,3668535708
6819,3348200260,237087309,3.2006786715e-11,95128,3075396,3671611104
6822,4868258573,236720475,3.1957264125e-11,80210,3074896,3674686000
6825,4817962860,237086884,3.200672934e-11,81324,3074896,3677760896
6828,6651807379,239966965,3.2395540275000004e-11,81568,3079000,3680839896
6831,4848440278,239964077,3.2395150395e-11,109784,38926228,3719766124
6834,6609878420,249112508,3.363018858e-11,127168,-54318568,3665447556
6837,4846826341,237086787,3.2006716245e-11,78182,3074896,3668522452
6840,4842827584,236720506,3.195726831e-11,81226,3074896,3671597348
6843,6670073446,237086913,3.2006733255000004e-11,82256,3074896,3674672244
6846,6647304024,237086841,3.2006723535e-11,79906,3074896,3677747140
6849,4998805832,236720458,3.195726183e-11,79646,3074896,3680822036
6852,4874848540,237160579,3.2016678165e-11,94924,3075396,3683897432
6855,6746829099,236720384,3.195725184e-11,77252,3074896,3686972328
6858,4933084278,237123422,3.201166197e-11,78054,3074896,3690047224
6861,4912118645,236720483,3.1957265205e-11,80298,3074896,3693122120
6864,8801531697,237086833,3.2006722455000004e-11,79660,3074896,3696197016
6867,11341598104,240399178,3.245388903e-11,80120,3079000,3699276016
6870,8835511817,239962788,3.239497638e-11,142533,38926784,3738202800
6873,6622067841,248761838,3.358284813e-11,98660,-57396012,3680806788
6876,5062982000,237123432,3.201166332e-11,78392,3074896,3683881684
6879,6624123436,237086801,3.2006718135e-11,78612,3074896,3686956580
6882,4991891057,236720415,3.1957256025e-11,78246,3074896,3690031476
6885,6739765887,237087296,3.200678496e-11,94546,3075396,3693106872
6888,4872093275,236720305,3.1957241175000006e-11,74698,3074896,3696181768
6891,6610493509,237086798,3.200671773e-11,78532,3074896,3699256664
6894,4842640746,236720427,3.1957257645e-11,78646,3074896,3702331560
6897,6604956214,237123439,3.2011664265e-11,78630,3074896,3705406456
6900,4844714812,236720410,3.1957255350000006e-11,78086,3074896,3708481352
6903,4839645330,237124832,3.201185232e-11,123879,3076272,3711557624
6906,4834226754,239996321,3.2399503335e-11,85188,3079000,3714636624
6909,6762594671,239942647,3.2392257345e-11,151769,38926992,3753563616
6912,6623699221,249648672,3.3702570720000004e-11,102038,-46625404,3706938212
6915,4925993975,236720502,3.195726777e-11,81078,3074896,3710013108
6918,4868019554,236720498,3.195726723e-11,80958,3074896,3713088004
6921,6596138820,237123528,3.2011676280000003e-11,81514,3074896,3716162900
6924,4846853489,236721053,3.1957342155e-11,98986,3075396,3719238296
6927,6600590836,237123427,3.2011662645000006e-11,78242,3074896,3722313192
6930,4084688909,237123544,3.201167844e-11,81838,3074896,3725388088
6933,2345435270,236720525,3.1957270875e-11,81848,3074896,3728462984
6936,2569574811,236720468,3.195726318e-11,79968,3074896,3731537880
6939,2222016708,237086849,3.2006724615e-11,80192,3074896,3734612776
6942,3410933679,236720978,3.195733203e-11,96572,3075396,3737688172
6945,9352207411,240428381,3.2457831435e-11,78742,3079000,3740767172
6948,7333034670,239578469,3.2343093315e-11,103696,38927404,3779694576
6951,10987765352,249516430,3.368471805e-11,101586,-54320888,3725373688
6954,2478687306,236720468,3.195726318e-11,79846,3074896,3728448584
6957,2188579633,236720474,3.195726399e-11,80168,3074896,3731523480
6960,3159089123,236720908,3.195732258e-11,94290,3075396,3734598876
6963,2578514337,236720286,3.195723861e-11,74074,3074896,3737673772
6966,3598064926,237086700,3.20067045e-11,75326,3074896,3740748668
6969,2494484032,236720329,3.1957244415e-11,75460,3074896,3743823564
6972,3048057433,237086705,3.2006705175e-11,75486,3074896,3746898460
6975,2709125724,236720862,3.195731637e-11,92798,3075396,3749973856
6978,3101095644,236720264,3.1957235640000004e-11,73350,3074896,3753048752
6981,2375217274,237086713,3.2006706255e-11,75754,3074896,3756123648
6984,19414283534,240457596,3.2461775460000005e-11,75646,3079000,3759202648
6987,11682347692,240368674,3.2449770990000006e-11,99735,38926380,3798129028
6990,4896490613,248983836,3.3612817860000003e-11,96180,-57398380,3740730648
6993,3387726507,237087261,3.2006780235000006e-11,93572,3075396,3743806044
6996,2245220233,236720279,3.1957237665e-11,73832,3074896,3746880940
6999,3376466894,236720394,3.195725319e-11,77592,3074896,3749955836
7002,3530171090,236720384,3.195725184e-11,77234,3074896,3753030732
7005,3420422737,236720386,3.195725211e-11,77316,3074896,3756105628
7008,2169600528,236720394,3.195725319e-11,77428,3074896,3759180524
7011,2140841323,236720865,3.1957316775000005e-11,92884,3075396,3762255920
7014,3380607822,237086692,3.200670342e-11,75092,3074896,3765330816
7017,2125974918,236720398,3.1957253730000005e-11,77718,3074896,3768405712
7020,2352196914,236720397,3.1957253595e-11,77692,3074896,3771480608
7023,4829397809,240420969,3.2456830815e-11,78136,3079000,3774559608
7026,4865701868,250983999,3.3882839865e-11,111761,-7692616,3766866992
7029,2143700451,236720578,3.1957278030000003e-11,83546,3074896,3769941888
7032,2137727645,237086952,3.200673852e-11,83516,3074896,3773016784
7035,3421943784,236720572,3.195727722e-11,83352,3074896,3776091680
7038,3362749159,236720572,3.195727722e-11,83356,3074896,3779166576
7041,2130707525,237087334,3.200679009e-11,95938,3075396,3782241972
7044,3555010704,236720455,3.1957261425e-11,79568,3074896,3785316868
7047,2294490562,236720577,3.1957277895000004e-11,83516,3074896,3788391764
7050,2133911343,236720592,3.195727992e-11,83820,3074896,3791466660
7053,3377514334,237086956,3.2006739060000004e-11,83654,3074896,3794541556
7056,5003414702,236720521,3.1957270335e-11,81702,3074896,3797616452
7059,3356501800,237087362,3.200679387e-11,96850,3075396,3800691848
7062,6600576130,240083912,3.241132812e-11,78552,3079000,3803770848
7065,6620631500,239998734,3.239982909e-11,110911,38927196,3842698044
7068,4910443413,249288416,3.365393616e-11,103978,-54320132,3788377912
7071,3389966179,237086899,3.2006731365e-11,81784,3074896,3791452808
7074,4867588197,236720538,3.195727263e-11,82118,3074896,3794527704
7077,4838423893,237087333,3.2006789955e-11,95900,3075396,3797603100
7080,3380832253,236720441,3.1957259535000005e-11,79096,3074896,3800677996
7083,4846381909,236720558,3.195727533e-11,82900,3074896,3803752892
7086,3373569187,237086848,3.200672448e-11,80142,3074896,3806827788
7089,4839020142,236720484,3.1957265340000005e-11,80490,3074896,3809902684
7092,4866416410,237087359,3.2006793465e-11,96738,3075396,3812978080
7095,4854102961,236720455,3.1957261425e-11,79568,3074896,3816052976
7098,4849333329,237086828,3.200672178e-11,79486,3074896,3819127872
7101,4870944782,240083988,3.241133838e-11,81032,3079000,3822206872
7104,4850154274,240007002,3.240094527e-11,107366,38926784,3861133656
7107,6623728084,249280446,3.3652860210000004e-11,102522,-55864448,3805269208
7110,3428026526,237090363,3.2007199005e-11,95172,3075396,3808344604
7113,4840327979,236720452,3.195726102e-11,79470,3074896,3811419500
7116,6626597920,237126824,3.201212124e-11,79492,3074896,3814494396
7119,6685692536,236720436,3.195725886e-11,78936,3074896,3817569292
7122,6697828762,237089872,3.200713272e-11,79186,3074896,3820644188
7125,6658882033,237089868,3.200713218e-11,79074,3074896,3823719084
7128,6685851260,236720910,3.195732285e-11,94210,3075396,3826794480
7131,6791590836,237126773,3.2012114355000005e-11,77842,3074896,3829869376
7134,6647837916,236720457,3.1957261695e-11,79618,3074896,3832944272
7137,4953167729,237126808,3.201211908e-11,78980,3074896,3836019168
7140,8729080942,240482533,3.2465141955e-11,78796,3079000,3839098168
7143,6659742283,251162914,3.3906993390000005e-11,140418,-7693976,3831404192
7146,4859815674,237089706,3.200711031e-11,73818,3074896,3834479088
7149,6622137597,237089789,3.2007121515000006e-11,76518,3074896,3837553984
7152,4850179777,236720388,3.195725238e-11,77374,3074896,3840628880
7155,6696086769,237089830,3.200712705e-11,77844,3074896,3843703776
7158,4839901854,236720391,3.1957252785e-11,77486,3074896,3846778672
7161,6611336615,237127218,3.201217443e-11,92310,3075396,3849854068
7164,4847199761,236720324,3.195724374e-11,75288,3074896,3852928964
7167,6605168527,237089843,3.2007128805e-11,78250,3074896,3856003860
7170,4837609091,236720410,3.1957255350000006e-11,77914,3074896,3859078756
7173,6600504741,237126781,3.2012115435e-11,78092,3074896,3862153652
7176,4828085892,236720328,3.195724428e-11,75414,3074896,3865228548
7179,6604909507,240549197,3.2474141595e-11,92016,3079500,3868308048
7182,8719462430,239988128,3.239839728e-11,93428,38926020,3907234068
7185,8724763675,249949109,3.3743129715e-11,94554,-54319368,3852914700
7188,4854660873,236720333,3.1957244955e-11,75612,3074896,3855989596
7191,6832088495,237130026,3.2012553510000005e-11,74284,3074896,3859064492
7194,6776152274,236721791,3.1957441785e-11,122975,3076272,3862140764
7197,6626070962,237092650,3.200750775e-11,70278,3074896,3865215660
7200,7491630744,237167229,3.2017575915e-11,72980,3074896,3868290556
7203,2451047449,236720452,3.195726102e-11,79474,3074896,3871365452
7206,3942800232,237092901,3.2007541635e-11,78410,3074896,3874440348
7209,2543478805,236720419,3.1957256565e-11,78378,3074896,3877515244
7212,3431986875,237092907,3.2007542445e-11,78626,3074896,3880590140
7215,2265678431,236720411,3.1957255485e-11,78128,3074896,3883665036
7218,9984554445,240552578,3.247459803e-11,93080,3079500,3886744536
7221,12561615950,240020140,3.24027189e-11,106788,38927596,3925672132
7224,10166226308,249984663,3.3747929505e-11,100460,-54326808,3871345324
7227,3863673416,236720413,3.1957255755e-11,78210,3074896,3874420220
7230,2360131684,237095947,3.2007952845000004e-11,78210,3074896,3877495116
7233,3398885254,236720948,3.195732798e-11,95576,3075396,3880570512
7236,2396963123,236720339,3.1957245765e-11,75784,3074896,3883645408
7239,2902368602,236720272,3.195723672e-11,73620,3074896,3886720304
7242,2474483006,236720376,3.195725076e-11,76996,3074896,3889795200
7245,2928756282,237095915,3.2007948525e-11,77020,3074896,3892870096
7248,11711747309,236720356,3.195724806e-11,76346,3074896,3895944992
7251,10582621762,237133950,3.201308325e-11,92818,3075396,3899020388
7254,6923385750,237133422,3.201301197e-11,75670,3074896,3902095284
7257,4905435840,240584555,3.2478914925e-11,74660,3079000,3905174284
7260,4949907563,251357758,3.393329733e-11,103021,-9230936,3895943348
7263,2160229445,237095915,3.2007948525e-11,77150,3074896,3899018244
7266,2163484913,236720328,3.195724428e-11,75418,3074896,3902093140
7269,2155434110,236720863,3.1957316505e-11,92818,3075396,3905168536
7272,3661328827,236720433,3.1957258455e-11,78836,3074896,3908243432
7275,2139775878,237095970,3.200795595e-11,78948,3074896,3911318328
7278,2160982224,236720436,3.195725886e-11,78948,3074896,3914393224
7281,2178122331,236720430,3.195725805e-11,78750,3074896,3917468120
7284,2144670553,236720953,3.1957328655e-11,95734,3075396,3920543516
7287,2135495312,237095874,3.200794299e-11,75640,3074896,3923618412
7290,2335539500,236720438,3.195725913e-11,79018,3074896,3926693308
7293,2122473578,236720448,3.1957260480000004e-11,79348,3074896,3929768204
7296,3412537898,240200860,3.2427116100000004e-11,77178,3079000,3932847204
7299,3376702555,239997048,3.239960148e-11,98699,38926172,3971773376
7302,3370816436,249717254,3.3711829290000005e-11,122530,-54318872,3917454504
7305,2343390091,236720282,3.195723807e-11,73946,3074896,3920529400
7308,2369310931,237098985,3.2008362975e-11,77706,3074896,3923604296
7311,3409560091,236720400,3.1957254000000003e-11,77624,3074896,3926679192
7314,3367891000,236720375,3.1957250625000004e-11,76970,3074896,3929754088
7317,3367631452,237098981,3.2008362435e-11,77568,3074896,3932828984
7320,3619254133,236720847,3.1957314345000004e-11,92312,3075396,3935904380
7323,3452406092,236720433,3.1957258455e-11,78852,3074896,3938979276
7326,3394778218,237136944,3.201348744e-11,80968,3074896,3942054172
7329,3378514842,236720584,3.1957278840000003e-11,83756,3074896,3945129068
7332,3372707198,236720584,3.1957278840000003e-11,83752,3074896,3948203964
7335,4842655911,240579627,3.2478249645e-11,83368,3079000,3951282964
7338,4929032760,239640488,3.235146588e-11,115669,38925852,3990208816
7341,4827094649,250835697,3.3862819095e-11,120504,-43551164,3946657652
7344,3370930698,236720308,3.195724158e-11,74774,3074896,3949732548
7347,3452570935,236720306,3.195724131e-11,74716,3074896,3952807444
7350,3347612215,237140106,3.201391431e-11,74578,3074896,3955882340
7353,3370285060,236720514,3.195726939e-11,81296,3074896,3958957236
7356,3455984904,236720482,3.195726507e-11,80452,3074896,3962032132
7359,3375107634,237102195,3.2008796325000003e-11,82808,3074896,3965107028
7362,3378875600,236720539,3.1957272765e-11,82284,3074896,3968181924
7365,4854800473,237102184,3.200879484e-11,82444,3074896,3971256820
7368,3386934953,236720978,3.195733203e-11,96556,3075396,3974332216
7371,3446364679,236720477,3.1957264395e-11,80276,3074896,3977407112
7374,5070605306,240611867,3.2482602045000005e-11,81466,3079000,3980486112
7377,6660193070,239647246,3.235237821e-11,112995,38926756,4019412868
7380,6628567851,250364044,3.379914594e-11,104486,-54319604,3965093264
7383,6631978605,237143727,3.2014403145e-11,83150,3074896,3968168160
7386,4869566883,236720917,3.1957323795e-11,94582,3075396,3971243556
7389,5065364056,237143678,3.201439653e-11,81552,3074896,3974318452
7392,6675391447,236720510,3.1957268850000004e-11,81360,3074896,3977393348
7395,6639113478,237105197,3.2009201595e-11,81158,3074896,3980468244
7398,6652222017,236720501,3.1957267635e-11,81050,3074896,3983543140
7401,4899259767,236720970,3.1957330950000004e-11,96298,3075396,3986618536
7404,6653094982,237105126,3.200919201e-11,78850,3074896,3989693432
7407,4947620385,236720505,3.1957268175e-11,81042,3074896,3992768328
7410,6738149120,237105190,3.2009200650000003e-11,80922,3074896,3995843224
7413,4900642834,236720501,3.1957267635e-11,81070,3074896,3998918120
7416,6652553253,240682577,3.2492147895e-11,79598,3079000,4001997120
7419,8785249225,252039482,3.402533007e-11,138875,-10774960,3991222160
7422,4851223763,236720350,3.195724725e-11,76134,3074896,3994297056
7425,4967263194,237105147,3.2009194845e-11,79536,3074896,3997371952
7428,4854952971,236720452,3.195726102e-11,79452,3074896,4000446848
7431,4867094983,237105144,3.200919444e-11,79426,3074896,4003521744
7434,4873018276,236720454,3.1957261290000005e-11,79514,3074896,4006596640
7437,6670199376,237105541,3.2009248035e-11,92318,3075396,4009672036
7440,4857967830,236720353,3.1957247655e-11,76246,3074896,4012746932
7443,6645138501,237143642,3.201439167e-11,80372,3074896,4015821828
7446,4861601086,236720415,3.1957256025e-11,78252,3074896,4018896724
7449,6711294435,237182046,3.2019576210000004e-11,78266,3074896,4021971620
7452,6635199529,236720896,3.1957320960000004e-11,93718,3075396,4025047016
7455,4841245287,237143510,3.201437385e-11,76066,3074896,4028121912
7458,8706511243,240711791,3.2496091785e-11,78584,3079000,4031200912
7461,8712926662,251487729,3.3950843415e-11,101969,-12309796,4018891116
7464,6688401568,237105101,3.2009188635e-11,78032,3074896,4021966012
7467,6604369139,237105123,3.2009191605e-11,78530,3074896,4025040908
7470,4851618657,236720850,3.195731475e-11,92390,3075396,4028116304
7473,4845035313,237143518,3.201437493e-11,76354,3074896,4031191200
7476,3763158659,236720340,3.19572459e-11,75808,3074896,4034266096
7479,2746896822,236720358,3.195724833e-11,76394,3074896,4037340992
7482,3176913341,236720359,3.1957248465e-11,76438,3074896,4040415888
7485,2751819332,237105062,3.200918337e-11,76754,3074896,4043490784
7488,3650061289,236720853,3.1957315155000005e-11,92496,3075396,4046566180
7491,2603824293,236720349,3.1957247115e-11,76110,3074896,4049641076
7494,3819008146,236720369,3.1957249815000004e-11,76772,3074896,4052715972
7497,3246017307,236720387,3.1957252245e-11,77008,3074896,4055790868
7500,11695476133,240702655,3.2494858425000005e-11,77008,3079000,4058869868
7503,10457276507,250209697,3.3778309095000005e-11,115249,3074896,4061944764
7506,5321884570,237108257,3.2009614695e-11,81386,3074896,4065019660
7509,6017590709,236720517,3.1957269795e-11,81584,3074896,4068094556
7512,7658824364,237147048,3.201485148e-11,81936,3074896,4071169452
7515,7780073954,237147045,3.2014851075000004e-11,81826,3074896,4074244348
7518,5284026349,237109557,3.2009790195000006e-11,123631,3076272,4077320620
7521,8282002949,236720330,3.1957244550000006e-11,75498,3074896,4080395516
7524,5402440286,236720428,3.195725778e-11,78682,3074896,4083470412
7527,5767674709,237108174,3.200960349e-11,78684,3074896,4086545308
7530,2158134643,236720432,3.195725832e-11,78454,3074896,4089620204
7533,2137778983,237108688,3.200967288e-11,95376,3075396,4092695600
7536,2203825791,236720352,3.195724752e-11,76210,3074896,4095770496
7539,2221669283,236720388,3.195725238e-11,77372,3074896,4098845392
