Size,Time,Cycles,Price,Instructions,HeapSize,TotalHeapSize
500,2261108869,80744862,1.090055637e-11,7753347,1250264,3447496
1000,2321143732,80852259,1.0915054965e-11,9206162,1269828,4717324
1500,2260596720,80870280,1.09174878e-11,9791845,1280188,5997512
2000,2239452285,80880274,1.091883699e-11,10116644,1279312,7276824
2500,2233785690,80884612,1.091942262e-11,10157464,1279304,8556128
3000,14302383444,80889608,1.0920097080000001e-11,10289797,1278688,9834816
3500,2131465011,80898694,1.092132369e-11,10715322,1279304,11114120
4000,2109722597,80900039,1.0921505265e-11,10759026,1279804,12393924
4500,2114617176,80898651,1.0921317885000001e-11,10713910,1279656,13673580
5000,2120889378,80900974,1.092163149e-11,10689262,1279312,14952892
5500,2109827979,81011440,1.09365444e-11,11596307,1278784,16231676
6000,2106272140,81010277,1.0936387395e-11,11558503,1280252,17511928
6500,2103486236,81008091,1.0936092285000002e-11,11487472,1278804,18790732
7000,2105421283,81021321,1.0937878335e-11,11817284,1279304,20070036
7500,2360045359,81025605,1.0938456675e-11,12056672,1280160,21350196
8000,2202775319,81021417,1.0937891295000001e-11,11920559,1278280,22628476
8500,2147401951,81024617,1.0938323295e-11,12024566,1279776,23908252
9000,2140102467,81027906,1.093876731e-11,12031282,1278812,25187064
9500,2144175547,81026977,1.0938641895000001e-11,12101262,1280296,26467360
10000,2243950327,81026052,1.093851702e-11,12071213,1281180,27748540
10500,2296806295,81026130,1.0938527550000001e-11,12073736,1279784,29028324
11000,2232554422,81024488,1.0938305880000002e-11,12020375,1279784,30308108
11500,2337182617,81024152,1.093826052e-11,12009445,1280284,31588392
12000,18344780141,81031977,1.0939316895e-11,12083449,1280784,32869176
12500,2090983693,86059712,1.161806112e-11,12019662,-15688976,17180200
13000,2114561446,81022073,1.0937979855000002e-11,11941897,1278784,18458984
13500,2116319315,81023486,1.093817061e-11,11987801,1279284,19738268
14000,2114690739,81031893,1.0939305555e-11,12261029,1288520,21026788
14500,2109730445,81045381,1.0941126435000001e-11,12699399,1303784,22330572
15000,2111465949,81057234,1.094272659e-11,13084599,1303284,23633856
15500,2106014024,81046728,1.094130828e-11,12743168,1303776,24937632
16000,2107070478,81053024,1.094215824e-11,12649182,1304276,26241908
16500,2143120539,81052192,1.0942045920000001e-11,12920763,1303760,27545668
17000,2303839489,81054241,1.0942322535000002e-11,12987352,1302804,28848472
17500,2145804567,81055590,1.094250465e-11,13031169,1304284,30152756
18000,2175266727,81066324,1.0943953740000001e-11,13081426,1304796,31457552
18500,2119106612,81053131,1.0942172685e-11,12951266,1303812,32761364
19000,2137149145,81054965,1.0942420275e-11,13010866,1303812,34065176
19500,2135342813,81052544,1.094209344e-11,12932195,1303784,35368960
20000,2140807281,81056182,1.094258457e-11,13050290,1303284,36672244
20500,2154407297,81070581,1.0944528435e-11,13219797,1305272,37977516
21000,2269358116,81058815,1.0942940025e-11,13135994,1304788,39282304
21500,3500887967,81054602,1.094237127e-11,12999090,1303304,40585608
22000,11748191868,81065672,1.094386572e-11,13060246,1303304,41888912
22500,2128213273,81052240,1.09420524e-11,12623689,1304524,43193436
23000,2124134866,81043849,1.0940919615e-11,12649602,1303788,44497224
23500,2131091447,81056331,1.0942604685e-11,13055274,1303312,45800536
24000,2133783900,81056844,1.094267394e-11,13071938,1302312,47102848
24500,2128414514,81067509,1.0944113715e-11,13119953,1304688,48407536
25000,2120200313,87802755,1.1853371925000002e-11,12978882,24436208,72843744
25500,2095533149,83472860,1.12688361e-11,15679879,-31867984,40975760
26000,2142785453,81054313,1.0942332255000002e-11,12989676,1303812,42279572
26500,2128189539,81054032,1.0942294320000002e-11,12980546,1303304,43582876
27000,2602076054,81053494,1.094222169e-11,12963049,1304180,44887056
27500,2492860378,81054836,1.0942402860000002e-11,13006696,1303812,46190868
28000,2171062937,81053891,1.0942275285000002e-11,12975976,1303296,47494164
28500,2219301248,81068823,1.0944291105e-11,13063427,1304688,48798852
29000,2251638757,81055146,1.094244471e-11,13016771,1303688,50102540
29500,2202554799,81055332,1.094246982e-11,13022804,1303812,51406352
30000,2274668570,81079510,1.094573385e-11,13410762,1303304,52709656
30500,2179515805,81077206,1.094542281e-11,13733692,1305652,54015308
31000,2481580846,81069852,1.094443002e-11,13494695,1302784,55318092
31500,2217891951,81070163,1.0944472005e-11,13504822,1303784,56621876
32000,2624407339,81083997,1.0946339595e-11,13556568,1302304,57924180
32500,2718031395,81070041,1.0944455535000002e-11,13500841,1303276,59227456
33000,2553589079,81069506,1.0944383310000001e-11,13483443,1303276,60530732
33500,5188047056,81085823,1.0946586105e-11,13615933,1303280,61834012
34000,14609442183,81096711,1.0948055985e-11,13611738,1303276,63137288
34500,2169342898,81070649,1.0944537615e-11,13520603,1303276,64440564
35000,2169255425,81073072,1.094486472e-11,13599346,1303304,65743868
35500,2201927496,81072289,1.0944759015000002e-11,13573891,1302268,67046136
36000,2175741855,81081679,1.0946026665e-11,13481068,1303812,68349948
36500,2126409835,81068637,1.0944265995e-11,13455204,1303296,69653244
37000,2178238706,81061488,1.0943300880000001e-11,13222876,1305536,70958780
37500,2158160507,81054710,1.094238585e-11,13002599,1303780,72262560
38000,2166361718,81056117,1.0942575795e-11,13048304,1303796,73566356
38500,2167495175,81079242,1.094569767e-11,13402032,1303304,74869660
39000,2164149456,81071475,1.0944649125000001e-11,13547450,1303660,76173320
39500,2162398025,81071253,1.0944619155e-11,13540242,1304312,77477632
40000,2160189046,81073631,1.0944940185e-11,13617520,1303812,78781444
40500,2199003108,81088557,1.0946955195e-11,13704786,1303304,80084748
41000,2209101403,81066870,1.094402745e-11,13397801,1303268,81388016
41500,2436448942,81071813,1.0944694755e-11,13558439,1304652,82692668
42000,2510808111,81078271,1.0945566585e-11,13370470,1302804,83995472
42500,2760212186,81070542,1.094452317e-11,13517124,1304804,85300276
43000,2252770841,81070538,1.0944522629999999e-11,13516992,1303304,86603580
43500,2174676817,81095586,1.0947904110000001e-11,13933220,1303304,87906884
44000,2197344587,81074534,1.094506209e-11,13646860,1305548,89212432
44500,2177192655,81065874,1.0943892990000002e-11,13365418,1303804,90516236
45000,2333803996,81069174,1.094433849e-11,13472649,1303780,91820016
45500,2383278083,81088583,1.0946958705e-11,13705614,1302312,93122328
46000,2334082644,81054994,1.094242419e-11,13011819,1304280,94426608
46500,2292030111,81054424,1.094234724e-11,12993300,1303812,95730420
47000,3515594216,81055318,1.094246793e-11,13022363,1305188,97035608
47500,14548343694,81079705,1.0945760175000001e-11,12939698,1303812,98339420
48000,2168176512,81055152,1.094244552e-11,13016960,1303812,99643232
48500,2144053279,81055069,1.0942434315e-11,13014079,1303672,100946904
49000,2135401547,81051672,1.094197572e-11,12903862,1304312,102251216
49500,2137542349,81065250,1.094380875e-11,12947310,1303304,103554520
50000,2134287229,81058152,1.094285052e-11,13114451,1304180,104858700
50500,2131653123,81150414,1.0955305890000002e-11,13904228,1304284,106162984
51000,2119726646,81147797,1.0954952595e-11,13819157,1304276,107467260
51500,2126333264,81157641,1.0956281535e-11,13741276,1303796,108771056
52000,2093076258,81159366,1.095651441e-11,14195152,1304312,110075368
52500,2151217794,81162785,1.0956975975000002e-11,14306280,1305152,111380520
53000,2274233107,81164393,1.0957193055000002e-11,14358529,1304784,112685304
53500,5210294185,88798502,1.1987797770000002e-11,14282668,10702848,123388152
54000,6817398775,87422936,1.1802096360000002e-11,17483672,39478452,162866604
54500,6648398845,88392801,1.1933028135e-11,17554229,-87320372,75546232
55000,2146959768,81159585,1.0956543975000001e-11,14202272,1304768,76851000
55500,2216810935,81168155,1.0957700925e-11,14480802,1305796,78156796
56000,2357241689,81161333,1.0956779955e-11,14259074,1304312,79461108
56500,2314541511,81163036,1.0957009859999999e-11,14314432,1303804,80764912
57000,2385826295,81155857,1.0956040694999999e-11,14081126,1306536,82071448
57500,8820937108,81192916,1.0961043660000001e-11,13894610,1304296,83375744
58000,2152867167,81150921,1.0955374335000001e-11,13920704,1304304,84680048
58500,2155995031,81161034,1.0956739590000002e-11,14249368,1303312,85983360
59000,2150431252,81166110,1.0957424850000002e-11,14414349,1305180,87288540
59500,2153920350,81165243,1.0957307805e-11,14386156,1303776,88592316
60000,2137048778,81188308,1.096042158e-11,14440316,1303804,89896120
60500,2149167934,81164616,1.095722316e-11,14365782,1304656,91200776
61000,2147889581,81165364,1.095732414e-11,14390098,1304268,92505044
61500,2163527852,81164499,1.0957207365000002e-11,14361994,1304804,93809848
62000,2163459528,81184927,1.0959965145000001e-11,14330421,1304688,95114536
62500,2141148825,81160823,1.0956711105000001e-11,14242504,1303312,96417848
63000,2142641721,81163039,1.0957010265e-11,14314534,1304804,97722652
63500,2208945452,81150348,1.0955296980000002e-11,13902076,1305564,99028216
64000,2318800220,81173033,1.0958359455e-11,13943860,1303304,100331520
64500,2313852330,81160691,1.0956693285e-11,14238228,1303812,101635332
65000,2320982164,81160050,1.0956606750000001e-11,14217381,1303796,102939128
65500,2406131928,81166393,1.0957463055000001e-11,14423549,1304652,104243780
66000,2490980414,81187588,1.096032438e-11,14416899,1305276,105549056
66500,2429266573,81163943,1.0957132304999999e-11,14343900,1303796,106852852
67000,2317910691,81162951,1.0956998385000001e-11,14311680,1304312,108157164
67500,2753341596,81186898,1.096023123e-11,14394469,1304276,109461440
68000,2344671275,81162346,1.095691671e-11,14292027,1304268,110765708
68500,2263717821,81164871,1.0957257585000001e-11,14374086,1304812,112070520
69000,14818644438,81202950,1.096239825e-11,14290229,1303764,113374284
69500,2100173843,81162996,1.0957004460000001e-11,14313134,1303284,114677568
70000,2169809167,81165492,1.095734142e-11,14394248,1304812,115982380
70500,2133924871,81164783,1.0957245705000001e-11,14371227,1303276,117285656
71000,2117978750,81181721,1.0959532335e-11,14226239,1305660,118591316
71500,2121394538,81168801,1.0957788135e-11,14501800,1303304,119894620
72000,2117274025,81171605,1.0958166675000001e-11,14592914,1304296,121198916
72500,2114998619,81165741,1.0957375035e-11,14402331,1305688,122504604
73000,2117055710,81162482,1.0956935070000001e-11,14296441,1304284,123808888
73500,2206058670,81188364,1.096042914e-11,14442126,1303776,125112664
74000,2185934381,81180544,1.095937344e-11,14883446,1304804,126417468
74500,2137033491,81179862,1.095928137e-11,14861288,1302812,127720280
75000,2190662484,81177383,1.0958946705000001e-11,14780708,1303812,129024092
75500,2148746131,81203856,1.096252056e-11,14945617,1304644,130328736
76000,2105868240,81175905,1.0958747175e-11,14732676,1303812,131632548
76500,2247359961,81178616,1.0959113160000002e-11,14820788,1303260,132935808
77000,2133564543,81178754,1.0959131790000002e-11,14825278,1303796,134239604
77500,2247471434,81201169,1.0962157815000001e-11,14858281,1304688,135544292
78000,2250028016,81171837,1.0958197995e-11,14600467,1305660,136849952
78500,2350252400,81164342,1.095718617e-11,14356890,1303796,138153748
79000,9077145746,81197286,1.0961633610000001e-11,14384346,1304804,139458552
79500,2133727781,81164534,1.0957212090000002e-11,14363129,1304680,140763232
80000,2115212522,81172685,1.0958312475000001e-11,14628028,1303284,142066516
80500,2115652236,81183099,1.0959718365000002e-11,14966494,1304776,143371292
81000,2113215259,81179302,1.095920577e-11,14843084,1303812,144675104
81500,2101005100,81200341,1.0962046035e-11,14831396,1304812,145979916
82000,2106345805,81178647,1.0959117345000001e-11,14821784,1302804,147282720
82500,2105791293,81175920,1.0958749200000002e-11,14733177,1304688,148587408
83000,2098729127,81179734,1.095926409e-11,14857132,1303304,149890712
83500,2090441572,81203192,1.096243092e-11,14924054,1304804,151195516
84000,2094474114,81179438,1.095922413e-11,14847505,1304688,152500204
84500,2095321343,81180328,1.095934428e-11,14876432,1303804,153804008
85000,2095723365,81172045,1.0958226075e-11,14607215,1304680,155108688
85500,2108707687,81163932,1.0957130820000001e-11,14343566,1303312,156412000
86000,2095914484,81190269,1.0960686315e-11,14504035,1303780,157715780
86500,2271648705,81179854,1.095928029e-11,14861033,1303776,159019556
87000,2128751290,81178812,1.095913962e-11,14827160,1303784,160323340
87500,2133475781,81181268,1.0959471180000001e-11,14906975,1303784,161627124
88000,2221415305,81200512,1.0962069120000002e-11,14836942,1302784,162929908
88500,2125634464,81183149,1.0959725115e-11,14968099,1304776,164234684
89000,2254798063,81179528,1.0959236280000001e-11,14850434,1302804,165537488
89500,2128513897,81180266,1.0959335910000001e-11,14874425,1304284,166841772
90000,2170479961,81201347,1.0962181845000001e-11,14863866,1303284,168145056
90500,2402273620,81183280,1.0959742800000002e-11,14972351,1304784,169449840
91000,8896401838,81200385,1.0962051975e-11,14832812,1304804,170754644
91500,2128421626,81179663,1.0959254505000001e-11,14854816,1303304,172057948
92000,2117503364,81178218,1.095905943e-11,14807867,1304276,173362224
92500,2104391166,81177959,1.0959024465e-11,14799418,1303284,174665508
93000,2113618519,81200246,1.096203321e-11,14828284,1304784,175970292
93500,2104847932,81169978,1.095794703e-11,14540067,1304688,177274980
94000,2104746013,81160366,1.0956649410000001e-11,14227677,1303284,178578264
94500,2099229642,81164543,1.0957213305e-11,14363417,1303784,179882048
95000,2098237941,81163958,1.0957134330000001e-11,14344388,1304296,181186344
95500,2104279849,81171774,1.095818949e-11,14598418,1303812,182490156
96000,2161334801,81175546,1.095869871e-11,14721004,1303804,183793960
96500,2193947715,81178684,1.0959122340000001e-11,14822989,1304280,185098240
97000,2137261748,81176614,1.0958842890000001e-11,14755724,1303812,186402052
97500,2149563929,81196297,1.0961500095e-11,14699939,1304688,187706740
98000,2116621955,81176234,1.0958791590000001e-11,14743369,1304284,189011024
98500,2163795766,81179057,1.0959172695000001e-11,14835116,1304796,190315820
99000,2205836430,81177917,1.0959018795000001e-11,14798078,1305160,191620980
99500,2349615707,81176194,1.0958786190000001e-11,14742082,1305296,192926276
100000,8917773751,81201532,1.0962206820000002e-11,14800539,1303772,194230048
100500,2114148915,81204757,1.0962642195000002e-11,14974888,1303312,195533360
101000,2119870871,81164346,1.0957186710000001e-11,14356998,1303784,196837144
101500,2111898226,81164080,1.0957150800000002e-11,14348372,1305160,198142304
102000,2110718207,81177727,1.0958993145e-11,14791892,1304312,199446616
102500,2111532135,81197704,1.096169004e-11,14745659,1304284,200750900
103000,2103870314,81181207,1.0959462945e-11,14904784,1303796,202054696
103500,2101232581,81177286,1.0958933610000001e-11,14777577,1304180,203358876
104000,2097397179,81174920,1.09586142e-11,14700648,1303784,204662660
104500,2172529617,81176318,1.095880293e-11,14746095,1305772,205968432
105000,2115102376,81201801,1.0962243135000001e-11,14878820,1303804,207272236
105500,3765189625,87782911,1.1850692985e-11,15017550,1307908,208580144
106000,4929581926,90567489,1.2226611015e-11,19103997,24753852,233333996
106500,4914762370,87505145,1.1813194575e-11,17911762,39475968,272809964
107000,6667848773,89204325,1.2042583875e-11,17985299,28477740,301287704
107500,8734770228,88394857,1.1933305695000001e-11,16989397,-164270024,137017680
108000,2120831065,81167498,1.095761223e-11,14459458,1303304,138320984
108500,2086133751,81168147,1.0957699844999999e-11,14480555,1303780,139624764
109000,2127849599,81169790,1.095792165e-11,14533954,1306152,140930916
109500,2118146002,81203059,1.0962412965e-11,14522813,1304776,142235692
110000,2108670872,81167493,1.0957611555000001e-11,14459290,1303784,143539476
110500,2105247275,81172835,1.0958332725000001e-11,14632909,1305268,144844744
111000,2093718437,81167720,1.0957642200000001e-11,14466670,1303768,146148512
111500,2096144310,81167454,1.095760629e-11,14458019,1305152,147453664
112000,2095605210,81210290,1.0963389150000002e-11,14757825,1303784,148757448
112500,2092857052,81176772,1.095886422e-11,14760858,1302784,150060232
113000,2087060996,81180716,1.095939666e-11,14889042,1303784,151364016
113500,2127567142,81179778,1.0959270030000001e-11,14858564,1303304,152667320
114000,2123252835,81217558,1.096437033e-11,14994044,1305160,153972480
114500,2120673188,81180313,1.0959342255e-11,14875950,1304304,155276784
115000,2107462291,81176938,1.0958886630000001e-11,14766240,1302760,156579544
115500,2130596499,81181924,1.095955974e-11,14928292,1304304,157883848
116000,2121006212,81181203,1.0959462405000001e-11,14904861,1303284,159187132
116500,2148706243,81214184,1.096391484e-11,14884395,1305172,160492304
117000,2187792411,81177922,1.0959019469999999e-11,14798230,1304296,161796600
117500,2177754723,81174824,1.0958601240000001e-11,14697545,1306188,163102788
118000,11319688940,81218241,1.0964462535000001e-11,14360800,1305160,164407948
118500,2116857563,81165808,1.095738408e-11,14404512,1303268,165711216
119000,2108775181,81173142,1.0958374170000001e-11,14642878,1304304,167015520
119500,2111093813,81170873,1.0958067855000001e-11,14569128,1303312,168318832
120000,2121523309,81213798,1.0963862730000001e-11,14871851,1305172,169624004
120500,2129954081,81179052,1.095917202e-11,14834797,1303784,170927788
121000,2137968172,81182073,1.0959579855e-11,14933130,1303276,172231064
121500,2109792263,81180119,1.0959316065e-11,14869644,1304304,173535368
122000,2128305460,81178012,1.0959031620000001e-11,14801157,1304680,174840048
122500,2139269481,81209617,1.0963298295000001e-11,14735962,1303784,176143832
123000,2089164590,81179272,1.095920172e-11,14842092,1304804,177448636
123500,2118686684,81178859,1.0959145965000001e-11,14828676,1305160,178753796
124000,2272677383,81172787,1.0958326245e-11,14631351,1305188,180058984
124500,2224516864,81197304,1.096163604e-11,14335802,1303812,181362796
125000,2119149550,81162319,1.0956913065000001e-11,14291122,1303812,182666608
125500,2124630917,81168353,1.0957727655000002e-11,14487245,1305180,183971788
126000,2101569186,81180181,1.0959324435e-11,14871646,1303784,185275572
126500,2238497032,81213499,1.0963822365000001e-11,14862108,1303812,186579384
127000,2222473176,81177429,1.0958952915000001e-11,14782226,1305160,187884544
127500,8755644258,81213831,1.0963867185000002e-11,14872902,1304312,189188856
128000,2111255085,81180743,1.0959400305000001e-11,14889926,1303312,190492168
128500,2201175758,81182353,1.0959617655e-11,14942256,1306152,191798320
129000,2105390952,81178153,1.0959050655000001e-11,14805753,1303276,193101596
129500,2105852305,81211615,1.0963568025e-11,14800878,1303804,194405400
130000,2102099134,81177715,1.0958991525e-11,14791513,1306160,195711560
130500,2099109622,81174021,1.0958492835000001e-11,14671446,1303656,197015216
131000,2095495154,81167055,1.0957552425000002e-11,14445063,1303284,198318500
131500,2094841423,81176010,1.0958761350000001e-11,14736088,1305636,199624136
132000,2094009428,81213638,1.096384113e-11,14866642,1304304,200928440
132500,2092662969,81179962,1.095929487e-11,14864358,1304812,202233252
133000,2096461470,81181468,1.095949818e-11,14913470,1305312,203538564
133500,2171680123,81178827,1.0959141645e-11,14827635,1304652,204843216
134000,2151772487,81179785,1.0959270975e-11,14858772,1304812,206148028
134500,2113944054,81180118,1.095931593e-11,14869590,1303804,207451832
135000,2108063708,81178812,1.095913962e-11,14827162,1303304,208755136
135500,2099340245,81182791,1.0959676785000001e-11,14956460,1303312,210058448
136000,2246238451,81217738,1.0964394630000001e-11,14999903,1305276,211363724
136500,2129775906,81178236,1.0959061860000001e-11,14808436,1304660,212668384
137000,2226363449,81176720,1.0958857200000001e-11,14759174,1304312,213972696
137500,4890712000,81172839,1.0958333265000002e-11,14633022,1305148,215277844
138000,6620225890,81233708,1.096655058e-11,14863503,1305152,216582996
138500,2105747839,81177110,1.0958909850000001e-11,14771836,1304304,217887300
139000,2110285546,81180885,1.0959419475e-11,14894541,1305280,219192580
139500,2110756320,81181569,1.0959511814999999e-11,14916756,1303312,220495892
140000,2103476776,81178887,1.0959149745e-11,14829588,1304152,221800044
140500,2101528832,81215379,1.0964076165e-11,14923216,1303784,223103828
141000,2098630321,81181170,1.095945795e-11,14903781,1303784,224407612
141500,2096056815,81183017,1.0959707295000001e-11,14963823,1305160,225712772
142000,2095224743,81176205,1.0958787675000002e-11,14742432,1303296,227016068
142500,2278108549,81212181,1.0963644435000001e-11,14819306,1302812,228318880
143000,2461690419,81183032,1.0959709320000001e-11,14964312,1303788,229622668
143500,2173823386,81181594,1.0959515190000002e-11,14917574,1304804,230927472
144000,2296764079,81177373,1.0958945355e-11,14780378,1306020,232233492
144500,2125372857,81220233,1.0964731455000001e-11,15080982,1303312,233536804
145000,2111070679,81198244,1.096176294e-11,15458510,1304312,234841116
145500,2126138390,81197976,1.096172676e-11,15449982,1304312,236145428
146000,2186124262,81183332,1.095974982e-11,14974043,1304276,237449704
146500,3366332395,81180146,1.095931971e-11,14870501,1305152,238754856
147000,6618295609,81227214,1.0965673890000001e-11,15307874,1304312,240059168
147500,2113363891,81195121,1.0961341335000001e-11,15357194,1304804,241363972
148000,2115338516,81194208,1.0961218080000001e-11,15327522,1304296,242668268
148500,2105025322,81193980,1.09611873e-11,15320108,1302796,243971064
149000,2107582621,81193920,1.09611792e-11,15318153,1304136,245275200
149500,2102841437,81192767,1.0961023545000001e-11,15280688,1304276,246579476
150000,2099951934,81226884,1.0965629340000001e-11,15297152,1304312,247883788
150500,2152568406,81196800,1.0961568e-11,15411770,1304296,249188084
151000,2094700624,81194022,1.096119297e-11,15321481,1303768,250491852
151500,2094358658,81192101,1.0960933635000002e-11,15259049,1304644,251796496
152000,2140909911,81178587,1.0959109245000001e-11,14819846,1304284,253100780
152500,2132137705,81215804,1.096413354e-11,14937046,1303776,254404556
153000,2143298548,81194688,1.0961282880000001e-11,15343136,1303784,255708340
153500,2234787775,81193153,1.0961075655e-11,15293224,1303784,257012124
154000,2220779008,81194937,1.0961316495000001e-11,15351204,1303284,258315408
154500,2135565243,81230070,1.096605945e-11,15400689,1304268,259619676
155000,2128060094,81195613,1.0961407755000002e-11,15373185,1303776,260923452
155500,2122017659,81195431,1.0961383185000001e-11,15367264,1303304,262226756
156000,2292028720,81193754,1.0961156790000001e-11,15312771,1303280,263530036
156500,11559657317,81250471,1.0968813585000001e-11,15299038,1303784,264833820
157000,2121382656,81192476,1.0960984260000001e-11,15271221,1304276,266138096
157500,2123539331,81191225,1.0960815375000002e-11,15230590,1303284,267441380
158000,2102256545,81192874,1.096103799e-11,15283969,1304776,268746156
158500,2093775275,81224199,1.0965266865000001e-11,15209870,1303284,270049440
159000,2095768373,81193664,1.096114464e-11,15309855,1304284,271353724
159500,2098226339,81190582,1.096072857e-11,15209681,1303284,272657008
160000,2091863570,81190546,1.096072371e-11,15208510,1304652,273961660
160500,2092137695,81182920,1.0959694200000001e-11,14960671,1302776,275264436
161000,2088274634,81215362,1.096407387e-11,14922665,1303784,276568220
161500,2082714119,81180639,1.0959386265e-11,14886538,1303784,277872004
162000,2087451383,81184291,1.0959879285e-11,15005218,1304284,279176288
162500,2087809615,81195088,1.0961336880000002e-11,15356135,1303776,280480064
163000,2147588447,81227093,1.0965657555e-11,15303922,1303776,281783840
163500,2109404163,81193716,1.096115166e-11,15311534,1303776,283087616
164000,2130771941,81193901,1.0961176635e-11,15317562,1304752,284392368
164500,2115860620,81196721,1.0961557335000001e-11,15409212,1304268,285696636
165000,2253949424,81195157,1.0961346195000002e-11,15358387,1304784,287001420
165500,2132641302,81232968,1.0966450679999999e-11,15494864,1304312,288305732
166000,2316387824,81194075,1.0961200124999999e-11,15323210,1304312,289610044
166500,2087909401,81192872,1.096103772e-11,15284091,1304772,290914816
167000,3493034494,81195873,1.0961442855000001e-11,15381650,1304276,292219092
167500,6606271420,81226942,1.096563717e-11,15299014,1303284,293522376
168000,2087166773,81193935,1.0961181225e-11,15318641,1304280,294826656
168500,2140816061,81226709,1.0965605715000001e-11,15291459,1305660,296132316
169000,2101878602,81179905,1.0959287175000001e-11,14862684,1303812,297436128
169500,2103530357,81179211,1.0959193485e-11,14840134,1304312,298740440
170000,2091745264,81178165,1.0959052275000002e-11,14806124,1304284,300044724
170500,2096143555,81221403,1.0964889405e-11,15119008,1303312,301348036
171000,2091859029,81195400,1.0961379000000001e-11,15366012,1304276,302652312
171500,2138298191,81195278,1.096136253e-11,15362298,1304276,303956588
172000,2126155329,81198329,1.0961774415e-11,15461469,1305280,305261868
172500,2126032120,81197421,1.0961651835000001e-11,15431941,1304284,306566152
173000,2276743396,81229690,1.0966008150000001e-11,15388336,1303804,307869956
173500,2231743738,81193531,1.0961126685e-11,15305518,1303812,309173768
174000,2137648130,81193896,1.0961175960000002e-11,15317383,1303280,310477048
174500,2237669549,81194567,1.0961266545e-11,15339189,1302776,311779824
175000,2098850135,81227977,1.0965776895e-11,15332662,1303776,313083600
175500,2128559674,81199466,1.0961927910000001e-11,15498413,1304280,314387880
176000,2184804001,81184132,1.095985782e-11,15000038,1303812,315691692
176500,11408138916,81242591,1.0967749785e-11,15261428,1303804,316995496
177000,2143909328,81193542,1.0961128170000001e-11,15305873,1305688,318301184
177500,2114859054,81184758,1.095994233e-11,15020390,1303312,319604496
178000,2106554504,81184040,1.0959845400000001e-11,14997062,1303812,320908308
178500,2106876636,81220103,1.0964713905000002e-11,15076758,1304304,322212612
179000,2099967321,81187068,1.0960254179999999e-11,15095473,1305680,323518292
179500,2091073660,81187453,1.0960306154999999e-11,15107974,1304312,324822604
180000,2094221287,81187742,1.096034517e-11,15117376,1304788,326127392
180500,2093232861,81187745,1.0960345575e-11,15117474,1303812,327431204
181000,2115670274,81177557,1.0958970195e-11,14786348,1304304,328735508
181500,2165511608,81184975,1.0959971625e-11,15027454,1304804,330040312
182000,2145250669,81195432,1.0961383320000002e-11,15367297,1304784,331345096
182500,2093019146,81195115,1.0961340525000001e-11,15356992,1304304,332649400
183000,2117462230,81227120,1.09656612e-11,15304796,1302312,333951712
183500,2127641116,81193866,1.096117191e-11,15316161,1304660,335256372
184000,2228359578,81194780,1.09612953e-11,15346118,1303776,336560148
184500,2124559848,81193636,1.0961140860000001e-11,15308938,1303784,337863932
185000,8779837831,81227419,1.0965701565000002e-11,15314518,1304304,339168236
185500,2113568402,81198260,1.0961765100000001e-11,15459207,1304784,340473020
186000,2104775706,81228056,1.0965787560000001e-11,15335208,1304784,341777804
186500,2102687201,81192676,1.096101126e-11,15277736,1303812,343081616
187000,2076923896,81194387,1.0961242245000002e-11,15333341,1303276,344384892
187500,2075955655,81192915,1.0961043525e-11,15285502,1303312,345688204
188000,2099381615,81189116,1.0960530660000001e-11,15162025,1304128,346992332
188500,2095914691,81178014,1.095903189e-11,14801236,1303312,348295644
189000,2222051647,81179116,1.095918066e-11,14837026,1303812,349599456
189500,2319864192,81185904,1.0960097040000002e-11,15057638,1304312,350903768
190000,2131242464,81197249,1.0961628615000001e-11,15426366,1303304,352207072
190500,2191422294,81229628,1.096599978e-11,15386311,1303284,353510356
191000,2151442365,81195440,1.09613844e-11,15367549,1304764,354815120
191500,2122518923,81196710,1.096155585e-11,15408840,1303796,356118916
192000,2101382179,81196885,1.0961579475e-11,15414531,1304660,357423576
192500,2119573887,81224847,1.0965354345e-11,15230935,1303776,358727352
193000,2222659364,81190613,1.0960732755e-11,15210700,1303312,360030664
193500,2229497559,81193496,1.0961121960000001e-11,15304393,1303776,361334440
194000,8724275687,81239380,1.09673163e-11,15375562,1304304,362638744
194500,2115482707,81194221,1.0961219835e-11,15327942,1303812,363942556
195000,2115796000,81192791,1.0961026785e-11,15281484,1304652,365247208
195500,2111692771,81192004,1.0960920540000002e-11,15255901,1305188,366552396
196000,2114016656,81211089,1.0963497015e-11,14783812,1304312,367856708
196500,2121788928,81178003,1.0959030405000001e-11,14800544,1303296,369160004
197000,2119546160,81178745,1.0959130575e-11,14824985,1305172,370465176
197500,2094980456,81179951,1.0959293385000001e-11,14864180,1304296,371769472
198000,2113341526,81192705,1.0961015175000002e-11,15278664,1303796,373073268
198500,2152518283,81232008,1.0966321080000002e-11,15364454,1304804,374378072
199000,2133431469,81194440,1.0961249400000001e-11,15335059,1305644,375683716
199500,2098887917,82903706,1.1192000310000001e-11,15267490,1307916,376991632
200000,4926291891,95365293,1.2874314555e-11,19494864,1303788,378295420
200500,4850767596,91414571,1.2340967085e-11,19567006,20506176,398801596
201000,4951664589,87613389,1.1827807515000002e-11,18401198,39472220,438273816
201500,2170095403,87461617,1.1807318295000002e-11,18444690,39469284,477743100
202000,6613820116,87543920,1.1818429199999999e-11,18560660,39475484,517218584
202500,3392137322,93279027,1.2592668645e-11,18451808,1477972,518696556
203000,3347411128,89237124,1.2047011740000002e-11,17334345,-264290632,254405924
203500,2102729669,81181017,1.0959437295e-11,14898811,1304776,255710700
204000,2101112430,81243452,1.096786602e-11,15240291,1304276,257014976
204500,2095164849,81195253,1.0961359155000001e-11,15361496,1303804,258318780
205000,2092145138,81195857,1.0961440695000002e-11,15381134,1305152,259623932
205500,2087856449,81194000,1.0961190000000002e-11,15320754,1303796,260927728
206000,2077967006,81194244,1.0961222940000002e-11,15328700,1303812,262231540
206500,2065519470,81246210,1.096823835e-11,15329936,1303804,263535344
207000,2094193943,81195257,1.0961359695000002e-11,15361628,1303812,264839156
207500,2082720047,81193663,1.0961144505e-11,15309809,1305188,266144344
208000,2085597991,81192134,1.096093809e-11,15260124,1303312,267447656
208500,2081149584,81246659,1.0968298965000002e-11,15344512,1302804,268750460
209000,2172049661,81196660,1.0961549100000001e-11,15407208,1304812,270055272
209500,2096749845,81192600,1.0961001000000001e-11,15275116,1305556,271360828
210000,2101520206,81188538,1.0960452629999999e-11,15143242,1305304,272666132
210500,2101333429,81199925,1.0961989875e-11,15513323,1305160,273971292
211000,2178609322,81179169,1.0959187815000001e-11,14838746,1303784,275275076
211500,2120487742,81180668,1.0959390180000001e-11,14887487,1304784,276579860
212000,2164300303,81186204,1.096013754e-11,15067396,1303768,277883628
212500,2122716329,81197405,1.0961649675e-11,15431442,1303776,279187404
213000,2133697387,81249110,1.0968629850000001e-11,15424178,1303776,280491180
213500,8784718930,81250004,1.096875054e-11,15453244,1303804,281794984
214000,2111917085,81196579,1.0961538165e-11,15404571,1303756,283098740
214500,2104675370,81196116,1.096147566e-11,15389542,1303784,284402524
215000,2099513577,81197936,1.096172136e-11,15448696,1305284,285707808
215500,2102656965,81199392,1.0961917920000002e-11,15496002,1304284,287012092
216000,2071869886,81246493,1.0968276555e-11,15339142,1304296,288316388
216500,2115550016,81193476,1.0961119260000001e-11,15303746,1303776,289620164
217000,2333372847,81193935,1.0961181225e-11,15318647,1304284,290924448
217500,2314106171,81186933,1.0960235955e-11,15091071,1305188,292229636
218000,2153105157,81232674,1.0966410990000002e-11,14890017,1303280,293532916
218500,2110642082,81181710,1.0959530849999999e-11,14921329,1306160,294839076
219000,2116383502,81180329,1.0959344415000001e-11,14876453,1303276,296142352
219500,2125690478,81192838,1.0961033130000001e-11,15283000,1304260,297446612
220000,2217081331,81245017,1.0968077294999999e-11,15291153,1303784,298750396
220500,2134760848,81200034,1.096200459e-11,15516882,1304312,300054708
221000,2174810158,81193876,1.096117326e-11,15316744,1304804,301359512
221500,2139484202,81197233,1.0961626455e-11,15425668,1304812,302664324
222000,11311918372,81280182,1.0972824570000002e-11,15421402,1303296,303967620
222500,2112758881,81196479,1.0961524665000001e-11,15401319,1306172,305273792
223000,2216959998,81192932,1.096104582e-11,15286059,1303784,306577576
223500,2098613039,81195390,1.096137765e-11,15365936,1303812,307881388
224000,2102345222,81247938,1.096847163e-11,15386080,1303812,309185200
224500,2089884640,81195440,1.09613844e-11,15367566,1303312,310488512
225000,2092955346,81183778,1.095981003e-11,14988553,1303688,311792200
225500,2152235645,81185242,1.096000767e-11,15036131,1305160,313097360
226000,2109249261,81248276,1.096851726e-11,15397072,1304796,314402156
226500,2183202005,81195317,1.0961367795e-11,15363568,1303812,315705968
227000,2108189878,81195068,1.096133418e-11,15355481,1304680,317010648
227500,2216663285,81195377,1.0961375895e-11,15365516,1304812,318315460
228000,2121772425,81197079,1.0961605665000001e-11,15420832,1304804,319620264
228500,2120583009,81248337,1.0968525495e-11,15399071,1305680,320925944
229000,2131879537,81198207,1.0961757945000002e-11,15457501,1304780,322230724
229500,2235212494,81196884,1.096157934e-11,15414506,1304312,323535036
230000,2126368324,81195765,1.0961428275e-11,15378113,1304160,324839196
230500,8743098531,81250708,1.096884558e-11,15476102,1304304,326143500
231000,2108113995,81197082,1.0961606070000001e-11,15420933,1303760,327447260
231500,2094357638,81243849,1.0967919615000001e-11,15253189,1305644,328752904
232000,2101865747,81179192,1.095919092e-11,14839503,1304276,330057180
232500,2097219514,81186666,1.096019991e-11,15082401,1303284,331360464
233000,2091950873,81183313,1.0959747255000001e-11,14973446,1303784,332664248
233500,2089011917,81235918,1.096684893e-11,14995431,1304284,333968532
234000,2089108464,81197038,1.096160013e-11,15419513,1303784,335272316
234500,2242951190,81199338,1.096191063e-11,15494081,1304784,336577100
235000,2161887812,81197062,1.096160337e-11,15420297,1303276,337880376
235500,2199413534,81248347,1.0968526845e-11,15399372,1303304,339183680
236000,2158222583,81197243,1.0961627805000001e-11,15426161,1305276,340488956
236500,2127411901,81195704,1.0961420040000001e-11,15376148,1304304,341793260
237000,2139603967,81196025,1.0961463375e-11,15386562,1304312,343097572
237500,2129598417,81195700,1.09614195e-11,15376027,1304276,344401848
238000,2098155200,81249573,1.0968692355e-11,15439243,1305284,345707132
238500,2126447153,81194701,1.0961284635e-11,15343538,1303768,347010900
239000,8839507745,81256992,1.096969392e-11,15342814,1303784,348314684
239500,2118565166,81195942,1.0961452170000001e-11,15383871,1303272,349617956
240000,2110019026,81192566,1.0960996410000001e-11,15274177,1305160,350923116
240500,2113227178,81180585,1.0959378975e-11,14884777,1303280,352226396
241000,2110721055,81191198,1.0960811730000001e-11,15229702,1303812,353530208
241500,2082172542,81246320,1.09682532e-11,15333493,1304268,354834476
242000,2079004921,81193922,1.096117947e-11,15318234,1304296,356138772
242500,2099262203,81197778,1.0961700030000002e-11,15443546,1304304,357443076
243000,2093262981,81193053,1.0961062155000001e-11,15289969,1305152,358748228
243500,2095998022,81244218,1.096796943e-11,15265204,1304284,360052512
244000,2171559905,81195322,1.0961368470000001e-11,15363730,1304312,361356824
244500,2348682041,81195011,1.0961326485e-11,15353618,1304268,362661092
245000,2173139421,81197793,1.0961702055e-11,15444034,1304804,363965896
245500,2125147781,81247814,1.0968454890000002e-11,15382067,1304160,365270056
246000,2132576642,81181004,1.0959435540000001e-11,14898388,1303776,366573832
246500,2226843907,81182902,1.095969177e-11,14960090,1303296,367877128
247000,2119303099,81195715,1.0961421525000001e-11,15376318,1305536,369182664
247500,2281325295,81181325,1.0959478874999999e-11,14908846,1304304,370486968
248000,2130730412,81181588,1.0959514380000002e-11,14917380,1303304,371790272
248500,11395408800,81239584,1.0967343840000002e-11,14945824,1303296,373093568
249000,2108677217,81183504,1.095977304e-11,14979656,1303804,374397372
249500,2114815928,81181380,1.0959486300000001e-11,14910601,1304680,375702052
250000,2114800504,81181389,1.0959487515000001e-11,14910890,1304304,377006356
250500,2113097626,81227427,1.0965702645000001e-11,14719480,1302812,378309168
251000,2108409138,81177641,1.0958981535e-11,14789094,1304304,379613472
251500,2100153044,81185656,1.0960063560000001e-11,15049592,1304312,380917784
252000,2098904458,81193424,1.0961112240000001e-11,15302051,1305672,382223456
252500,2100861094,81194389,1.0961242515e-11,15333408,1304312,383527768
253000,2087973643,81195738,1.0961424630000001e-11,15377248,1304812,384832580
253500,2346210919,81194561,1.0961265735000001e-11,15338983,1304644,386137224
254000,2195486069,81194431,1.0961248185e-11,15334786,1303804,387441028
254500,2101312456,81194508,1.096125858e-11,15337278,1303304,388744332
255000,2180701320,81246025,1.0968213375e-11,15323933,1305672,390050004
255500,2131724688,81196870,1.0961577450000001e-11,15414031,1304284,391354288
256000,2259300468,81195911,1.0961447985e-11,15382881,1303784,392658072
256500,2122986939,81198849,1.0961844615e-11,15478366,1304312,393962384
257000,3387785237,81244097,1.0967953095000001e-11,15261276,1305652,395268036
257500,8729205313,81231594,1.0966265190000001e-11,14854924,1303812,396571848
258000,2112382579,81181364,1.095948414e-11,14910085,1303784,397875632
258500,2110060894,81185013,1.0959976755000001e-11,15028698,1304284,399179916
259000,2127184378,81179098,1.0959178230000001e-11,14836458,1303812,400483728
259500,2134430694,81186016,1.096011216e-11,15061272,1304284,401788012
260000,2126859100,81250413,1.0968805754999999e-11,15466306,1304784,403092796
260500,2122055594,81199248,1.0961898480000001e-11,15491312,1303812,404396608
261000,2091857542,81193217,1.0961084295000001e-11,15295321,1304284,405700892
261500,2103239225,81197191,1.0961620785000001e-11,15424478,1304296,407005188
262000,2094509183,81250467,1.0968813045e-11,15468272,1304312,408309500
262500,2086760090,81194085,1.0961201475e-11,15323511,1305180,409614680
263000,2087068658,81194689,1.0961283015e-11,15343138,1303796,410918476
263500,2082791089,81194325,1.0961233874999999e-11,15331313,1303264,412221740
264000,2083293923,81197384,1.0961646840000001e-11,15430738,1304304,413526044
264500,2082385569,81249827,1.0968726645e-11,15447488,1311684,414837728
265000,2080047207,81195314,1.096136739e-11,15363468,1328312,416166040
265500,2078360720,81197474,1.096165899e-11,15433664,1328312,417494352
266000,2196179599,81210138,1.096336863e-11,15845244,1328280,418822632
266500,2099224782,81261669,1.0970325315e-11,15832358,1327296,420149928
267000,2142795605,81211881,1.0963603935e-11,15901909,1329180,421479108
267500,2107662697,81210544,1.096342344e-11,15858432,1327296,422806404
268000,2107330250,81212292,1.0963659419999999e-11,15915246,1328296,424134700
268500,2091561102,81262066,1.097037891e-11,15845260,1327804,425462504
269000,2115424043,81212352,1.096366752e-11,15917201,1329188,426791692
269500,2166477523,81211312,1.096352712e-11,15883412,1327804,428119496
270000,8789315809,81268098,1.0971193230000002e-11,15872520,1328296,429447792
270500,2111744448,81210457,1.0963411695e-11,15855628,1328312,430776104
271000,2124689038,81210572,1.0963427220000002e-11,15859338,1328276,432104380
271500,2137967894,81210433,1.0963408455000001e-11,15854834,1328268,433432648
272000,2139173625,81260381,1.0970151435000001e-11,15790491,1329660,434762308
272500,2100100253,81199972,1.096199622e-11,15514847,1327776,436090084
273000,2090204019,81210062,1.096335837e-11,15842771,1328276,437418360
273500,2200822246,81211449,1.0963545615000001e-11,15887842,1328284,438746644
274000,2315815887,81262759,1.0970472465000001e-11,15867778,1327804,440074448
274500,2203422482,81197487,1.0961660745000001e-11,15434098,1327776,441402224
275000,2123022516,81197408,1.096165008e-11,15431529,1327776,442730000
275500,2209131310,81212588,1.096369938e-11,15924870,1326312,444056312
276000,2137826542,81209541,1.0963288035e-11,15825850,1328296,445384608
276500,2118826542,81262854,1.097048529e-11,15870851,1328284,446712892
277000,2124974054,81212945,1.0963747575000001e-11,15936484,1327796,448040688
277500,2218226777,81213590,1.096383465e-11,15957446,1327812,449368500
278000,3539965973,81213793,1.0963862055000002e-11,15964038,1329648,450698148
278500,6615136339,81292084,1.0974431340000001e-11,15808228,1328304,452026452
279000,2083483145,81210473,1.0963413855e-11,15856124,1328304,453354756
279500,2118114596,81209627,1.0963299645000002e-11,15828654,1327812,454682568
280000,2097601944,81204240,1.09625724e-11,15653549,1329680,456012248
280500,2101290980,81211271,1.0963521585000001e-11,15882073,1328688,457340936
281000,2089474217,81247344,1.0968391440000001e-11,15366778,1328812,458669748
281500,2093706404,81204725,1.0962637875e-11,15669342,1329312,459999060
282000,2090589490,81213604,1.096383654e-11,15957882,1329652,461328712
282500,2089630309,81212167,1.0963642545000001e-11,15911196,1327812,462656524
283000,2110358531,81262955,1.0970498925e-11,15874146,1327796,463984320
283500,2205160466,81210355,1.0963397925000001e-11,15852317,1328680,465313000
284000,2124334900,81210647,1.0963437344999999e-11,15861784,1328296,466641296
284500,2231218999,81212826,1.096373151e-11,15932626,1328796,467970092
285000,2125346213,81212434,1.096367859e-11,15919871,1329188,469299280
285500,2145169136,81209267,1.0963251045000001e-11,15816676,1327796,470627076
286000,2123575485,81215476,1.0964089260000002e-11,16018733,1328284,471955360
286500,2121153515,81206637,1.0962895995e-11,15731477,1328152,473283512
287000,8819872343,81272661,1.0971809235e-11,15345728,1327276,474610788
287500,2109009796,81201150,1.0962155250000002e-11,15553151,1327276,475938064
288000,2116177881,81214839,1.0964003265e-11,15998043,1328276,477266340
288500,2076074396,81210210,1.096337835e-11,15847584,1327284,478593624
289000,2130240803,81216907,1.0964282445e-11,16065244,1328304,479921928
289500,2094588382,81266801,1.0971018135e-11,15999148,1328804,481250732
290000,2087600892,81211983,1.0963617705e-11,15905221,1327780,482578512
290500,2087789330,81215648,1.0964112480000001e-11,16024326,1327812,483906324
291000,2083564926,81210893,1.0963470555e-11,15869796,1328784,485235108
291500,2202033724,81259580,1.0970043300000001e-11,15764461,1329256,486564364
292000,2108336840,81211734,1.096358409e-11,15897112,1328804,487893168
292500,2185629721,81208782,1.0963185570000002e-11,15801182,1327304,489220472
293000,2239636387,81210513,1.0963419255e-11,15857448,1328312,490548784
293500,2117228447,81263002,1.097050527e-11,15875684,1329156,491877940
294000,2222442983,81209192,1.0963240920000001e-11,15814515,1327276,493205216
294500,2139349628,81209486,1.0963280610000002e-11,15824075,1329188,494534404
295000,2124889598,81211170,1.0963507950000001e-11,15878800,1328304,495862708
295500,2132465183,81219819,1.0964675565e-11,16159890,1328268,497190976
296000,8714028184,81287474,1.097380899e-11,15827130,1327776,498518752
296500,2106706051,81218064,1.096443864e-11,16102834,1328312,499847064
297000,2104173822,81225453,1.0965436155e-11,16342997,1329164,501176228
297500,2095371086,81220802,1.0964808270000001e-11,16191832,1327268,502503496
298000,2154705484,81278909,1.0972652715e-11,16392342,1328304,503831800
298500,2098137987,81225281,1.0965412935e-11,16337390,1327304,505159104
299000,2089699172,81227178,1.0965669030000002e-11,16399057,1330688,506489792
299500,2092801913,81224962,1.096536987e-11,16327046,1327804,507817596
300000,2086734041,81276864,1.097237664e-11,16326196,1328276,509145872
300500,2108328737,81227008,1.096564608e-11,16393524,1328804,510474676
301000,2209174679,81218695,1.0964523825000002e-11,16123367,1327784,511802460
301500,2078938067,81218541,1.0964503035e-11,16118361,1326780,513129240
302000,2145695502,81225998,1.096550973e-11,16360699,1329644,514458884
302500,2103791185,81268594,1.0971260190000001e-11,16057399,1327776,515786660
303000,2107469159,81215847,1.0964139345e-11,16030806,1328268,517114928
303500,2116398626,81215796,1.0964132459999999e-11,16029141,1326776,518441704
304000,2192270796,81218693,1.0964523555e-11,16123289,1327276,519768980
304500,2268195901,81271674,1.0971675990000002e-11,16157521,1329268,521098248
305000,2284490154,81216725,1.0964257875e-11,16059325,1328284,522426532
305500,9084914505,81270697,1.0971544095e-11,16125774,1327784,523754316
306000,2108195811,81214877,1.0964008395e-11,15999282,1328268,525082584
306500,2097910025,81211838,1.096359813e-11,15900505,1327276,526409860
307000,2096877720,81229004,1.096591554e-11,16458402,1327284,527737144
307500,2098302472,81279359,1.0972713465e-11,16407268,1328784,529065928
308000,2092722213,81228627,1.0965864645e-11,16446138,1328284,530394212
308500,2090012422,81228245,1.0965813075e-11,16433711,1327768,531721980
309000,2088702549,81228099,1.0965793365e-11,16428982,1328268,533050248
309500,2086083599,81227328,1.096568928e-11,16403934,1327784,534378032
310000,2084503361,81283508,1.097327358e-11,16542107,1328784,535706816
310500,2160517483,81228044,1.0965785940000001e-11,16426863,1327776,537034592
311000,2144504875,81228707,1.0965875445000001e-11,16448733,1327280,538361872
311500,2230925934,81226364,1.0965559140000001e-11,16372603,1328784,539690656
312000,2155870757,81278091,1.0972542285e-11,16366068,1328784,541019440
312500,2122037393,81226469,1.0965573315e-11,16376007,1328776,542348216
313000,2122200496,81224763,1.0965343005000002e-11,16320572,1327784,543676000
313500,2123444769,81223854,1.096522029e-11,16291020,1328628,545004628
314000,3411500279,81207832,1.096305732e-11,15770301,1327284,546331912
314500,6635367903,81263757,1.0970607195000002e-11,15900215,1327284,547659196
315000,2108989259,81215655,1.0964113425000002e-11,16024566,1328784,548987980
315500,2109241214,81280847,1.0972914345000001e-11,16455634,1326776,550314756
316000,2094549090,81222102,1.0964983769999999e-11,16234074,1329276,551644032
316500,2098729748,81226919,1.0965634065e-11,16390619,1328680,552972712
317000,2109681059,81226394,1.096556319e-11,16373558,1329296,554302008
317500,2081609974,81276865,1.0972376775e-11,16326222,1327304,555629312
318000,2089185159,81225940,1.09655019e-11,16358825,1328672,556957984
318500,2086632021,81224388,1.096529238e-11,16308362,1326796,558284780
319000,2200954534,81226597,1.0965590595e-11,16380164,1327304,559612084
319500,2229145911,81225022,1.096537797e-11,16328988,1327812,560939896
320000,2200273102,81276299,1.0972300365000001e-11,16307823,1327680,562267576
320500,2508779980,81228796,1.096588746e-11,16451647,1327428,563595004
321000,2175803142,81218332,1.0964474820000001e-11,16111541,1327652,564922656
321500,2127967399,81213354,1.096380279e-11,15949774,1328768,566251424
322000,2136042212,81263029,1.0970508915e-11,15876542,1327768,567579192
322500,2219506942,81216569,1.0964236815e-11,16054252,1327784,568906976
323000,2176205753,81214979,1.0964022165000002e-11,16002160,1328812,570235788
323500,6616335984,81281878,1.097305353e-11,16032538,1327768,571563556
324000,2110794362,81229429,1.0965972915e-11,16472192,1328284,572891840
324500,2100449199,81228492,1.0965846420000001e-11,16441763,1327784,574219624
325000,2105447937,81227298,1.096568523e-11,16402952,1327284,575546908
325500,2097097803,81231126,1.096620201e-11,16527376,1328812,576875720
326000,2094251589,81281507,1.0973003445e-11,16377848,1327268,578202988
326500,2096337626,81222540,1.09650429e-11,16248313,1328680,579531668
327000,2090076555,81224097,1.0965253095000002e-11,16298908,1328312,580859980
327500,2088630947,81221401,1.0964889135000002e-11,16211312,1328312,582188292
328000,2137292229,81280549,1.0972874115e-11,16346715,1328680,583516972
328500,2076868619,81218813,1.0964539755e-11,16127187,1328688,584845660
329000,2115056264,81206697,1.0962904095e-11,15733426,1328804,586174464
329500,2133563554,81207008,1.096294608e-11,15743522,1327812,587502276
330000,2132098092,81208340,1.09631259e-11,15786819,1329188,588831464
330500,2187299852,81285030,1.097347905e-11,16492355,1326776,590158240
331000,2230403881,81227868,1.096576218e-11,16421468,1327768,591486008
331500,2132470418,81225205,1.0965402675e-11,16334925,1328680,592814688
332000,8889947070,81306084,1.097632134e-11,16283158,1327804,594142492
332500,2161749049,81226099,1.0965523364999999e-11,16363982,1328312,595470804
333000,2105462900,81226176,1.096553376e-11,16366472,1327312,596798116
333500,2111746444,81225675,1.0965466125000001e-11,16350195,1328680,598126796
334000,2095350631,81225253,1.0965409155000001e-11,16336486,1328296,599455092
334500,2089959308,81280703,1.0972894905e-11,16351744,1328312,600783404
335000,2090522675,81228319,1.0965823065e-11,16436132,1330564,602113968
335500,2088065806,81212777,1.0963724895000002e-11,15930585,1326436,603440404
336000,2086525453,81213460,1.09638171e-11,15953202,1326784,604767188
336500,2285964631,81288803,1.0973988405000002e-11,16515767,1327776,606094964
337000,2104713121,81229572,1.096599222e-11,16476859,1328268,607423232
337500,2148792060,81231362,1.096623387e-11,16535042,1328784,608752016
338000,2086947172,81227240,1.0965677400000001e-11,16401065,1327284,610079300
338500,2112621795,81229757,1.0966017195e-11,16482866,1327784,611407084
339000,2157303620,81228354,1.0965827790000001e-11,16437258,1328284,612735368
339500,2172949604,81228106,1.096579431e-11,16429224,1327284,614062652
340000,2149979583,81228180,1.09658043e-11,16431619,1327768,615390420
340500,2124556726,81229349,1.0965962115000002e-11,16469602,1326776,616717196
341000,8767330928,81321375,1.0978385625e-11,16442669,1327784,618044980
341500,2103478231,81225318,1.096541793e-11,16338614,1329148,619374128
342000,2100243128,81225296,1.096541496e-11,16337892,1328788,620702916
342500,2090358945,81226273,1.0965546855e-11,16369656,1328804,622031720
343000,2093587282,81220897,1.0964821095000001e-11,16194922,1330564,623362284
343500,2067901120,81216471,1.0964223585000001e-11,16051086,1328312,624690596
344000,2065777773,81226468,1.0965573180000001e-11,16375966,1328304,626018900
344500,2083741860,81227526,1.096571601e-11,16410375,1328664,627347564
345000,2081727189,81228926,1.0965905010000001e-11,16455856,1329312,628676876
345500,2210807119,81277102,1.097240877e-11,16135460,1327776,630004652
346000,2231524421,81225658,1.0965463830000001e-11,16349663,1327276,631331928
346500,2243568742,81225745,1.0965475575000002e-11,16352478,1327284,632659212
347000,2105262943,81223257,1.0965139695000001e-11,16271628,1326784,633985996
347500,2144436341,81284510,1.097340885e-11,16376222,1327796,635313792
348000,2210937696,81227503,1.0965712905e-11,16409181,1328284,636642076
348500,2159286792,81228918,1.096590393e-11,16455602,1328276,637970352
349000,2239596799,81224883,1.0965359205e-11,16324454,1327312,639297664
349500,2128788100,81227153,1.0965665655e-11,16398246,1328804,640626468
350000,8720725085,81287309,1.0973786715e-11,16367992,1328284,641954752
350500,2106976478,81289382,1.097406657e-11,16435338,1328276,643283028
351000,2131027743,81218662,1.0964519370000001e-11,16122283,1328680,644611708
351500,2114048147,81209417,1.0963271295000002e-11,15821832,1327304,645939012
352000,2117595092,81221733,1.0964933955e-11,16222070,1328304,647267316
352500,2085552881,81227363,1.0965694005e-11,16405052,1329152,648596468
353000,2090068532,81284811,1.0973449485000002e-11,16286782,1327812,649924280
353500,2090461261,81226555,1.0965584925e-11,16378808,1328312,651252592
354000,2084273048,81226041,1.0965515535e-11,16362082,1327812,652580404
354500,2114150583,81228087,1.0965791745000001e-11,16428583,1328688,653909092
355000,2145426922,81286850,1.097372475e-11,16353048,1328312,655237404
355500,2251838941,81229856,1.096603056e-11,16486082,1329304,656566708
356000,2147463247,81223902,1.096522677e-11,16292597,1326776,657893484
356500,2134240338,81226238,1.096554213e-11,16368516,1329304,659222788
357000,2124304472,81224075,1.0965250125000001e-11,16298189,1328636,660551424
357500,2144740144,81223276,1.096514226e-11,16272236,1328312,661879736
358000,2130438009,81214488,1.0963955880000002e-11,15986621,1328180,663207916
358500,11258540451,81294919,1.0974814065e-11,15821186,1327804,664535720
359000,2099661233,81225905,1.0965497175000001e-11,16357695,1329672,665865392
359500,2100517871,81225089,1.0965387015e-11,16331152,1327812,667193204
360000,2098380245,81226974,1.096564149e-11,16392426,1328812,668522016
360500,2124763490,81296572,1.0975037220000001e-11,16569329,1329160,669851176
361000,2099492521,81225969,1.0965505815e-11,16359740,1326812,671177988
361500,2087068856,81225077,1.0965385395e-11,16330765,1327780,672505768
362000,2086572657,81226107,1.0965524445e-11,16364255,1328284,673834052
362500,2084689216,81225968,1.096550568e-11,16359721,1327780,675161832
363000,2077797950,81292327,1.0974464145e-11,16431837,1328768,676490600
363500,2081933782,81227473,1.0965708855e-11,16408634,1328812,677819412
364000,2078938519,81225756,1.096547706e-11,16352829,1328284,679147696
364500,2089073350,81224076,1.096525026e-11,16298234,1327784,680475480
365000,2154236414,81288541,1.0973953035e-11,16308804,1327312,681802792
365500,2106424373,81222882,1.096508907e-11,16259428,1328160,683130952
366000,2192942682,81208998,1.0963214730000002e-11,15808216,1328288,684459240
366500,2218700884,81208021,1.0963082835e-11,15776456,1328304,685787544
367000,2148281743,81208489,1.0963146015e-11,15791658,1327812,687115356
367500,2092056896,81286747,1.0973710845e-11,16250488,1328804,688444160
368000,2125466804,81226913,1.0965633255e-11,16390419,1329188,689773348
368500,2129275462,81224302,1.0965280770000001e-11,16305591,1327784,691101132
369000,6603080173,81303670,1.0975995449999999e-11,16383577,1327276,692428408
369500,2108326665,81225809,1.0965484215e-11,16354560,1327804,693756212
370000,2076301153,81227689,1.0965738015e-11,16415668,1328152,695084364
370500,2127488526,81228473,1.0965843855000002e-11,16441142,1329284,696413648
371000,2105614161,81226157,1.0965531195000001e-11,16365876,1328312,697741960
371500,2091099266,81288835,1.0973992725e-11,16318348,1328312,699070272
372000,2088078776,81226313,1.0965552255e-11,16370925,1329160,700399432
372500,2086485611,81854535,1.1050362225e-11,16821119,1333292,701732724
373000,2084410379,95452027,1.2886023645e-11,20871421,1328796,703061520
373500,4800369665,95493924,1.2891679740000001e-11,20893827,1329680,704391200
374000,5045406728,95141278,1.2844072530000002e-11,20849868,2691344,707082544
374500,3357938775,87624778,1.1829345030000002e-11,19840610,39653508,746736052
375000,3357663078,87613656,1.182784356e-11,19881348,39653708,786389760
375500,4839592946,87716024,1.184166324e-11,19745804,39652740,826042500
376000,8729617760,87514621,1.1814473835e-11,19560761,39661196,865703696
376500,2099844620,87684455,1.1837401425e-11,19446105,39654312,905358008
377000,2092168397,87607022,1.182694797e-11,19746464,39661248,945019256
377500,2100413749,91429733,1.2343013955e-11,19877097,13974000,958993256
378000,3324545921,93351723,1.2602482605000002e-11,19123638,1328276,960321532
378500,3325086334,93369081,1.2604825935e-11,19091323,1327760,961649292
379000,2085538596,86254499,1.1644357364999999e-11,19039288,-496886124,464763168
379500,2087923707,81228009,1.0965781215e-11,16426064,1328312,466091480
380000,2082581533,81227396,1.096569846e-11,16406128,1327812,467419292
380500,2081330092,81228707,1.0965875445000001e-11,16448730,1327304,468746596
381000,2077536033,81315328,1.0977569280000002e-11,16286390,1327804,470074400
381500,2096284426,81222687,1.0965062745e-11,16253094,1326776,471401176
382000,2101849089,81224301,1.0965280635e-11,16305412,1329284,472730460
382500,2098431527,81225570,1.0965451950000002e-11,16346790,1326804,474057264
383000,2085198975,81229074,1.0965924989999999e-11,16460684,1329160,475386424
383500,2078875216,81316654,1.0977748290000002e-11,16329517,1328652,476715076
384000,2102741832,81223628,1.0965189780000001e-11,16283676,1327312,478042388
384500,2063028149,81221567,1.0964911545e-11,16216687,1327772,479370160
385000,2156575684,81231543,1.0966258305e-11,16540908,1327776,480697936
385500,2169827797,81330211,1.0979578485000002e-11,16770088,1327304,482025240
386000,2138981426,81229858,1.096603083e-11,16486140,1326776,483352016
386500,2227342916,81241377,1.0967585895e-11,16860518,1327312,484679328
387000,2123275052,81243641,1.0967891535000002e-11,16934079,1327772,486007100
387500,2128503124,81332630,1.097990505e-11,16848733,1329664,487336764
388000,2119333912,81241213,1.0967563755000001e-11,16855183,1328284,488665048
388500,6597673951,81242326,1.096771401e-11,16891368,1328284,489993332
389000,2098951748,81334901,1.0980211635e-11,16922510,1327812,491321144
389500,2089579901,81241089,1.0967547015e-11,16851143,1328180,492649324
390000,2094497607,81237198,1.096702173e-11,16724692,1327796,493977120
390500,2083269965,81245336,1.096812036e-11,16989174,1328280,495305400
391000,2084609731,81232962,1.0966449870000002e-11,16587039,1330036,496635436
391500,2087096771,81300689,1.0975593014999999e-11,15810630,1327812,497963248
392000,2065942088,81209721,1.0963312335000001e-11,15831685,1328680,499291928
392500,2079216229,81213095,1.0963767825000001e-11,15941352,1328312,500620240
393000,2091971647,81226156,1.096553106e-11,16365826,1327812,501948052
393500,2079406549,81317709,1.0977890715e-11,16363788,1327312,503275364
394000,2098261469,81226347,1.0965556845e-11,16371879,1329160,504604524
394500,2084896290,81226653,1.0965598155000002e-11,16381972,1327788,505932312
395000,2105481629,81225613,1.0965457755e-11,16348178,1327804,507260116
395500,2111066248,81227377,1.0965695895e-11,16405518,1328312,508588428
396000,2136707628,81319345,1.0978111575e-11,16416953,1328632,509917060
396500,2180928549,81226835,1.0965622725e-11,16387890,1328284,511245344
397000,8784531358,81335953,1.0980353655000001e-11,16361225,1327252,512572596
397500,2108164481,81226355,1.0965557925e-11,16372292,1327784,513900380
398000,2099874462,81220433,1.0964758455e-11,16179836,1328660,515229040
398500,2097442275,81212177,1.0963643895e-11,15911529,1328276,516557316
399000,2087697357,81212329,1.0963664415e-11,15916469,1327784,517885100
399500,2089590536,81311717,1.0977081795000001e-11,16169048,1327312,519212412
400000,2087977301,81227542,1.096571817e-11,16410877,1328276,520540688
400500,2084416645,81228938,1.096590663e-11,16456238,1328776,521869464
401000,2064226253,81213490,1.096382115e-11,15954200,1326276,523195740
401500,2090626096,81319122,1.097808147e-11,16409716,1328304,524524044
402000,2090450873,81228916,1.096590366e-11,16455532,1329656,525853700
402500,2447661977,81226366,1.096555941e-11,16372674,1328304,527182004
403000,2370824111,81224285,1.0965278475e-11,16305022,1327804,528509808
403500,2098446207,81318240,1.0977962399999999e-11,16381036,1327812,529837620
404000,2121802743,81227555,1.0965719925e-11,16411305,1329652,531167272
404500,2228764811,81226867,1.0965627045e-11,16388940,1328304,532495576
405000,2171178847,81224671,1.0965330585e-11,16317582,1330064,533825640
405500,2153051470,81215486,1.096409061e-11,16019055,1327776,535153416
406000,2109868810,81311444,1.097704494e-11,15862452,1328804,536482220
406500,2109385692,81211957,1.0963614195000001e-11,15904187,1327776,537809996
407000,2103012454,81211633,1.0963570455e-11,15893837,1327768,539137764
407500,2102624905,81227558,1.096572033e-11,16411417,1328784,540466548
408000,2099553535,81228335,1.0965825225000002e-11,16436644,1327804,541794352
408500,2094694512,81317969,1.0977925815e-11,16372221,1327260,543121612
409000,2090231955,81228946,1.096590771e-11,16456515,1328276,544449888
409500,2083164710,81230917,1.0966173795e-11,16520580,1329312,545779200
410000,2085506538,81225326,1.096541901e-11,16338864,1327784,547106984
410500,2084122642,81323236,1.097863686e-11,16543404,1328796,548435780
411000,2106200361,81226253,1.0965544155e-11,16368976,1328276,549764056
411500,2087684875,81225165,1.0965397275e-11,16333643,1327776,551091832
412000,2203011434,81225015,1.0965377025e-11,16328754,1327804,552419636
412500,2177719578,81226572,1.096558722e-11,16379356,1327804,553747440
413000,2190827328,81318475,1.0977994125000002e-11,16388684,1328304,555075744
413500,2207103462,81219702,1.0964659770000001e-11,16156094,1328640,556404384
414000,2118197793,81212054,1.096362729e-11,15907525,1327768,557732152
414500,2127510462,81215433,1.0964083455e-11,16017338,1327784,559059936
415000,11217564908,81313513,1.0977324255e-11,16227406,1327812,560387748
415500,2093666341,81321458,1.0978396830000001e-11,16485640,1327812,561715560
416000,2093900836,81225277,1.0965412395e-11,16337280,1327276,563042836
416500,2095121559,81227380,1.09656963e-11,16405609,1328784,564371620
417000,2087572467,81226269,1.0965546315000001e-11,16369518,1328284,565699904
417500,2083790806,81319055,1.0978072425e-11,16407530,1327304,567027208
418000,2086509522,81227802,1.096575327e-11,16419331,1328680,568355888
418500,2090373909,81227303,1.0965685905000001e-11,16403121,1328276,569684164
419000,2213193453,81225457,1.0965436695000001e-11,16342926,1327776,571011940
419500,2084609694,81226952,1.096563852e-11,16391714,1328776,572340716
420000,2264920378,81318352,1.097797752e-11,16384678,1327312,573668028
420500,2125063089,81228297,1.0965820095000001e-11,16435437,1328276,574996304
421000,2105400540,81226468,1.0965573180000001e-11,16375962,1327796,576324100
421500,2141005410,81218571,1.0964507085e-11,16119321,1328680,577652780
422000,2118272735,81302396,1.0975823460000001e-11,15866120,1327312,578980092
422500,2163353017,81225020,1.09653777e-11,16328903,1328672,580308764
423000,2207334720,81226362,1.0965558870000002e-11,16372532,1327304,581636068
423500,8840897236,81348243,1.0982012805e-11,16462872,1329312,582965380
424000,2103685252,81228207,1.0965807945e-11,16432504,1327796,584293176
424500,2104849246,81225314,1.0965417390000002e-11,16338475,1328688,585621864
425000,2101342919,81226671,1.0965600585000001e-11,16382580,1328812,586950676
425500,2088954490,81230182,1.096607457e-11,16496694,1328304,588278980
426000,2108408809,81320766,1.097830341e-11,16463145,1329268,589608248
426500,2092574782,81225223,1.0965405105e-11,16335516,1326812,590935060
427000,2087928331,81227420,1.09657017e-11,16406903,1329188,592264248
427500,2076859879,81224371,1.0965290085000001e-11,16307818,1327304,593591552
428000,2143138659,81316567,1.0977736545e-11,16326662,1328304,594919856
428500,2088395320,81215881,1.0964143935e-11,16031906,1330056,596249912
429000,2130101844,81206209,1.0962838215e-11,15717574,1327304,597577216
429500,2494964919,81208979,1.0963212165000001e-11,15807572,1327812,598905028
430000,2336205536,81310171,1.0976873085e-11,16118812,1327296,600232324
430500,2238172905,81229529,1.0965986415000001e-11,16475474,1328268,601560592
431000,2125827252,81227768,1.0965748680000001e-11,16418219,1328276,602888868
431500,2236648869,81227064,1.096565364e-11,16395142,1328284,604217152
432000,3403647431,81228782,1.0965885570000001e-11,16451188,1328284,605545436
432500,8715946031,81320870,1.097831745e-11,16466509,1328284,606873720
433000,2073494648,81318869,1.0978047315000002e-11,16401498,1328260,608201980
433500,2120599333,81224937,1.0965366495000001e-11,16326218,1327284,609529264
434000,2090520252,81229870,1.0966032450000001e-11,16486554,1328276,610857540
434500,2086696905,81228158,1.096580133e-11,16430894,1328276,612185816
435000,2089339624,81226913,1.0965633255e-11,16390457,1328276,613514092
435500,2085415411,81229027,1.0965918645000002e-11,16459138,1327768,614841860
436000,2087567731,81221929,1.0964960415e-11,16228452,1328304,616170164
436500,2080217123,81227794,1.0965752190000001e-11,16419068,1328644,617498808
437000,2121692407,81214788,1.096399638e-11,15996374,1328284,618827092
437500,2096956904,81307425,1.0976502375e-11,16029577,1327284,620154376
438000,2139466196,81216808,1.0964269080000001e-11,16062026,1328784,621483160
438500,2150639815,81215237,1.0964056995e-11,16010950,1328312,622811472
439000,2214313362,81215140,1.09640439e-11,16007802,1326812,624138284
439500,2142531472,81310020,1.09768527e-11,16113882,1329152,625467436
440000,2097700987,81217554,1.096436979e-11,16086276,1328276,626795712
440500,2131857083,81222956,1.096509906e-11,16261820,1328796,628124508
441000,11255197806,81326319,1.0979053065000001e-11,15452612,1328288,629452796
441500,2144597528,81198791,1.0961836785000001e-11,15476470,1327796,630780592
442000,2117530459,81209109,1.0963229715e-11,15811809,1328644,632109236
442500,2102918342,81212933,1.0963745955e-11,15936102,1328304,633437540
443000,2097898549,81305249,1.0976208615e-11,15958852,1328304,634765844
443500,2093317176,81214360,1.0963938599999999e-11,15982466,1328312,636094156
444000,2090969333,81214770,1.096399395e-11,15995549,1328680,637422836
444500,2089152383,81212888,1.096373988e-11,15934628,1328312,638751148
445000,2161711369,81304865,1.0976156775e-11,15946358,1327304,640078452
445500,2155754016,81216365,1.0964209275e-11,16047618,1328304,641406756
446000,2170938328,81215479,1.0964089665000002e-11,16018832,1329652,642736408
446500,2103610575,81213683,1.0963847205000001e-11,15960475,1328784,644065192
447000,2098078988,81210775,1.0963454625000002e-11,15865942,1328288,645393480
447500,2093023021,81301947,1.0975762845000002e-11,15851527,1329652,646723132
448000,2116063540,81197679,1.0961686665e-11,15440328,1327804,648050936
448500,2120915340,81194239,1.0961222265000001e-11,15328518,1328284,649379220
449000,2170836261,81203277,1.0962442395000001e-11,15622254,1328284,650707504
449500,8758710775,81302686,1.097586261e-11,15875557,1328780,652036284
450000,2108729283,81203170,1.0962427950000001e-11,15618786,1326812,653363096
450500,2094867448,81309211,1.0976743485e-11,16087596,1329312,654692408
451000,2102021019,81206412,1.096286562e-11,15724148,1327312,656019720
451500,2070535168,81209875,1.0963333125e-11,15836692,1327812,657347532
452000,2103105121,81209189,1.0963240515000001e-11,15814388,1326804,658674336
452500,2083980892,81305312,1.0976217119999999e-11,15960894,1329652,660003988
453000,2086066310,81208705,1.0963175175e-11,15798678,1326304,661330292
453500,2133065428,81209362,1.096326387e-11,15820042,1327812,662658104
454000,2186482093,81213181,1.0963779435e-11,15944154,1328304,663986408
454500,2149146377,81209477,1.0963279395000002e-11,15823765,1328172,665314580
455000,2114308665,81297136,1.097511336e-11,15695163,1327672,666642252
455500,2117482504,81200094,1.096201269e-11,15518833,1328784,667971036
456000,2112900971,81215644,1.0964111940000001e-11,16024199,1328276,669299312
456500,2113977521,81212109,1.0963634715000001e-11,15909052,1328268,670627580
457000,2104222233,81305109,1.0976189715e-11,15954282,1328312,671955892
457500,2115829953,81213530,1.096382655e-11,15955487,1327272,673283164
458000,2152565069,81213979,1.0963887165e-11,15970075,1327784,674610948
458500,6598809719,81304629,1.0976124915e-11,15938692,1327812,675938760
459000,2109593265,81214662,1.0963979370000001e-11,15992270,1328312,677267072
459500,2102236856,81212342,1.0963666170000001e-11,15916883,1327784,678594856
460000,2097204859,81211511,1.0963553985e-11,15889874,1327312,679922168
460500,2109655790,81217495,1.0964361825e-11,16084340,1329276,681251444
461000,2103824019,81305180,1.09761993e-11,15956599,1327768,682579212
461500,2086614964,81215657,1.0964113695e-11,16024602,1327812,683907024
462000,2084478136,81216205,1.0964187675000001e-11,16042419,1329644,685236668
462500,2081014276,81213380,1.09638063e-11,15950612,1327784,686564452
463000,2079218774,81296537,1.0975032495e-11,15675703,1328180,687892632
463500,2081859810,81206760,1.09629126e-11,15735450,1327812,689220444
464000,2083162915,81213193,1.0963781055000002e-11,15944522,1327304,690547748
464500,2083750176,81216753,1.0964261655e-11,16060229,1329172,691876920
465000,2080769696,81199499,1.0961932365000002e-11,15499487,1328272,693205192
465500,2144464733,81298341,1.0975276035e-11,15734346,1326296,694531488
466000,2135821256,81213337,1.0963800495000002e-11,15949234,1328284,695859772
466500,2119036987,81214070,1.096389945e-11,15973054,1327284,697187056
467000,2118128429,81213469,1.0963818315e-11,15953522,1328776,698515832
467500,2106983037,81303947,1.0976032845e-11,15916532,1328768,699844600
468000,2220957668,81211027,1.0963488645000001e-11,15874139,1328280,701172880
468500,2223554011,81210808,1.096345908e-11,15867022,1327268,702500148
469000,2169484976,81211482,1.0963550070000002e-11,15888630,1327768,703827916
469500,2192946906,81212521,1.0963690335e-11,15922702,1327284,705155200
470000,2112462259,81314737,1.0977489494999999e-11,15969476,1327284,706482484
470500,2109935119,81212773,1.0963724355000001e-11,15930893,1326776,707809260
471000,2109058349,81208615,1.0963163025e-11,15795752,1328660,709137920
471500,2103043649,81196129,1.0961477415000001e-11,15389971,1327764,710465684
472000,2098077595,81199749,1.0961966115000002e-11,15507608,1328776,711794460
472500,2095592828,81298291,1.0975269285e-11,15732690,1328284,713122744
473000,2093964360,81212952,1.0963748520000002e-11,15936695,1327776,714450520
473500,2089464642,81211948,1.0963612979999999e-11,15904074,1327812,715778332
474000,2102297749,81210828,1.096346178e-11,15867670,1327788,717106120
474500,2338418874,81302941,1.0975897035000001e-11,15883810,1327312,718433432
475000,2086686547,81210349,1.0963397115000001e-11,15852090,1328312,719761744
475500,2287972451,81215926,1.0964150010000001e-11,16033374,1328796,721090540
476000,2111581447,81211766,1.0963588410000002e-11,15898172,1328304,722418844
476500,2092160409,81302553,1.0975844655e-11,15871222,1327812,723746656
477000,2252543499,81213357,1.0963803195e-11,15949858,1328312,725074968
477500,2127458772,81211802,1.096359327e-11,15899334,1328652,726403620
478000,2141265062,81212886,1.0963739610000002e-11,15934560,1327812,727731432
478500,3362767176,81215238,1.096405713e-11,16011006,1327304,729058736
479000,8700576634,81290021,1.0974152835e-11,15463922,1329564,730388300
479500,2096598534,81288951,1.0974008385e-11,15429154,1327304,731715604
480000,2086377271,81211276,1.0963522259999999e-11,15882220,1327780,733043384
480500,2088568920,81216833,1.0964272455000001e-11,16062852,1329312,734372696
481000,2080780598,81213752,1.0963856520000001e-11,15962709,1327776,735700472
481500,2084474611,81215402,1.096407927e-11,16016028,1327784,737028256
482000,2083006558,81211007,1.0963485945e-11,15873488,1327276,738355532
482500,2087917186,81212151,1.0963640385000002e-11,15910674,1327276,739682808
483000,2076666537,81216765,1.0964263275000001e-11,16060642,1328268,741011076
483500,2162507293,81214194,1.096391619e-11,15977062,1327784,742338860
484000,2106745966,81303134,1.0975923090000001e-11,15890109,1327276,743666136
484500,2113807343,81215518,1.096409493e-11,16020115,1328284,744994420
485000,2091210079,81213298,1.0963795230000001e-11,15947940,1327284,746321704
485500,2083569128,81216359,1.0964208465e-11,16047434,1327312,747649016
486000,2117529134,81214329,1.0963934415e-11,15981477,1328776,748977792
486500,2119128582,81211279,1.0963522664999999e-11,15882345,1329284,750307076
487000,2141484780,81206418,1.096286643e-11,15724367,1329188,751636264
487500,8691591669,81295666,1.097491491e-11,15349655,1327780,752964044
488000,2100734897,81195370,1.0961374949999999e-11,15365306,1327796,754291840
488500,2090250809,81200153,1.0962020655e-11,15520724,1330644,755622484
489000,2091193840,81214565,1.0963966275000001e-11,15989111,1327768,756950252
489500,2099349783,81304005,1.0976040675000002e-11,15918407,1328276,758278528
490000,2068512516,81212729,1.0963718415e-11,15929476,1328296,759606824
490500,2089611127,81217741,1.0964395035000001e-11,16092354,1328812,760935636
491000,2087245975,81212422,1.0963676970000001e-11,15919483,1327276,762262912
491500,2079531690,81211769,1.0963588815e-11,15898262,1328312,763591224
492000,2101188711,81305581,1.0976253435000001e-11,15969635,1329180,764920404
492500,2076177297,81213609,1.0963837215000001e-11,15958074,1329812,766250216
493000,2178351949,81213063,1.0963763505e-11,15940316,1328296,767578512
493500,2121635810,81215344,1.096407144e-11,16014450,1327804,768906316
494000,2240468947,81314702,1.097748477e-11,16265738,1330528,770236844
494500,2112790366,81211929,1.0963610415000001e-11,15903466,1326812,771563656
495000,2123382292,81211112,1.096350012e-11,15876900,1327304,772890960
495500,2206930271,81215813,1.0964134755e-11,16029676,1328312,774219272
496000,8707161491,81339692,1.098085842e-11,15291740,1328804,775548076
496500,2104555287,81193612,1.0961137620000002e-11,15308156,1327812,776875888
497000,2090410719,81195007,1.0961325945000002e-11,15353481,1328152,778204040
497500,2093490757,81196414,1.0961515890000002e-11,15399222,1328812,779532852
498000,2118968668,81195721,1.0961422335e-11,15376710,1329296,780862148
498500,2072212312,81288459,1.0973941965000002e-11,15413151,1328672,782190820
499000,2063673157,81195444,1.096138494e-11,15367706,1328312,783519132
499500,2083156495,81197379,1.0961646165e-11,15430588,1328804,784847936
500000,2369475640,81197061,1.0961603235e-11,15420247,1329188,786177124
500500,2124416107,81404589,1.0989619515e-11,16307140,1328812,787505936
501000,2158667142,81312057,1.0977127695e-11,16277378,1328296,788834232
501500,2194341605,81312032,1.097712432e-11,16276566,1328796,790163028
502000,2137333724,81329735,1.0979514225e-11,16851915,1329268,791492296
502500,2122416784,81419280,1.0991602800000002e-11,16784610,1327804,792820100
503000,2114858006,81328190,1.0979305650000002e-11,16801681,1329284,794149384
503500,2123265841,81322425,1.0978527375000001e-11,16614334,1327776,795477160
504000,2145357354,81324059,1.0978747965e-11,16667419,1330268,796807428
504500,2130219185,81324823,1.0978851105000001e-11,16692260,1328796,798136224
505000,2166821539,81418198,1.0991456729999999e-11,16749433,1327772,799463996
505500,2102684562,81329820,1.0979525700000001e-11,16854662,1329652,800793648
506000,2109047538,81326464,1.097907264e-11,16745600,1329804,802123452
506500,2078057420,81324603,1.0978821405e-11,16684724,1328312,803451764
507000,2105044189,81416798,1.099126773e-11,16703940,1329564,804781328
507500,2092630858,81305563,1.0976251005e-11,16066319,1328284,806109612
508000,2094592168,81316400,1.0977714e-11,16418508,1328812,807438424
508500,2087378213,81327105,1.0979159174999999e-11,16766434,1328796,808767220
509000,2086620440,81326236,1.097904186e-11,16738179,1330652,810097872
509500,2090978259,81418621,1.0991513835e-11,16763196,1329268,811427140
510000,2084341638,81328996,1.097941446e-11,16827900,1329304,812756444
510500,2079573617,81330644,1.097963694e-11,16881440,1329144,814085588
511000,2114104480,81326306,1.097905131e-11,16740476,1328312,815413900
511500,2075203082,81327391,1.0979197785e-11,16775734,1327312,816741212
512000,2127532607,81326546,1.097908371e-11,16748252,1328296,818069508
512500,2114403585,81324965,1.0978870275000002e-11,16696896,1329640,819399148
513000,2116281272,81326846,1.097912421e-11,16758000,1328812,820727960
513500,2193641177,81326848,1.0979124480000001e-11,16758096,1328304,822056264
514000,2114733622,81421020,1.09918377e-11,16841140,1330056,823386320
514500,2201099391,81341580,1.09811133e-11,17236872,1328312,824714632
515000,11364784437,81451951,1.0996013385e-11,17250908,1327812,826042444
515500,2077143412,81335840,1.09803384e-11,17050328,1328312,827370756
516000,2111494041,81326862,1.097912637e-11,16758546,1328276,828699032
516500,2120126087,81331502,1.0979752770000001e-11,16909324,1328768,830027800
517000,2088102487,81435716,1.099382166e-11,17318754,1327284,831355084
517500,2089156352,81345482,1.098164007e-11,17363688,1329276,832684360
518000,2080522936,81344777,1.0981544895e-11,17340779,1328284,834012644
518500,2182515148,81344298,1.0981480230000001e-11,17325199,1328776,835341420
519000,2137340692,81435061,1.0993733235000001e-11,17297065,1327768,836669188
519500,2156517635,81343105,1.0981319175e-11,17286444,1328776,837997964
520000,2141108791,81340954,1.098102879e-11,17216517,1327776,839325740
520500,2141393093,81343302,1.098134577e-11,17292818,1328276,840654016
521000,2114144274,81340823,1.0981011105e-11,17212250,1328276,841982292
521500,2174808061,81432409,1.0993375215e-11,17211299,1329284,843311576
522000,2109900579,81336506,1.098042831e-11,17071957,1329680,844641256
522500,2121341612,81326670,1.0979100450000001e-11,16752290,1329296,845970552
523000,11282440674,81460251,1.0997133885e-11,16627391,1328276,847298828
523500,2093739365,81326677,1.0979101395e-11,16752530,1328784,848627612
524000,2096484342,81324243,1.0978772805e-11,16673427,1328276,849955888
524500,2090427990,81334624,1.0980174240000001e-11,17010780,1327812,851283700
525000,2087744829,81432025,1.0993323375e-11,17198825,1329284,852612984
525500,2089045409,81343558,1.0981380330000001e-11,17301146,1326776,853939760
526000,2085356215,81339316,1.0980807660000001e-11,17163303,1327776,855267536
526500,2085407956,81338025,1.0980633375e-11,17121340,1327296,856594832
527000,2079695202,81342153,1.0981190655000001e-11,17255504,1327312,857922144
527500,2114010201,81432377,1.0993370895000002e-11,17210242,1327796,859249940
528000,2164435942,81343046,1.098131121e-11,17284526,1329652,860579592
528500,2131718585,81340180,1.09809243e-11,17191386,1328796,861908388
529000,2083102716,81341732,1.098113382e-11,17241802,1327804,863236192
529500,2134301915,81432386,1.0993372110000002e-11,17210544,1328296,864564488
530000,2198693118,81335091,1.0980237285000002e-11,17025969,1329180,865893668
530500,2095969327,81331666,1.097977491e-11,16914675,1330152,867223820
531000,2114999577,81343385,1.0981356975000001e-11,17295525,1329276,868553096
531500,8777441593,81479883,1.0999784205e-11,17265002,1328312,869881408
532000,2115871300,81343795,1.0981412325e-11,17308841,1330688,871212096
532500,2108137241,81342379,1.0981221165000002e-11,17262826,1328312,872540408
533000,2117195774,81342669,1.0981260315e-11,17272250,1328312,873868720
533500,2090297185,81341379,1.0981086165e-11,17230337,1329144,875197864
534000,2085941697,81341486,1.098110061e-11,17233808,1328804,876526668
534500,2087895597,81342263,1.0981205505000002e-11,17259056,1328312,877854980
535000,2082460118,81341274,1.0981071990000001e-11,17226933,1328688,879183668
535500,2071328245,81344428,1.098149778e-11,17329432,1329284,880512952
536000,2092375746,81436653,1.0993948155000002e-11,17349214,1328268,881841220
536500,2088497838,81340911,1.0981022985e-11,17215118,1328660,883169880
537000,2109961001,81324329,1.0978784415000001e-11,16676221,1328268,884498148
537500,2143067078,81331318,1.097972793e-11,16903342,1328276,885826424
538000,2123481269,81331472,1.097974872e-11,16908375,1329284,887155708
538500,2226758209,81420598,1.099178073e-11,16827431,1328268,888483976
539000,2211253016,81344832,1.0981552320000001e-11,17342557,1327760,889811736
539500,2091736085,81344584,1.0981518840000002e-11,17334515,1328776,891140512
540000,8765248793,81483093,1.1000217555e-11,17369756,1328784,892469296
540500,2101036016,81347216,1.098187416e-11,17420023,1329284,893798580
541000,2099421223,81340967,1.0981030545000001e-11,17216954,1329804,895128384
541500,2102291441,81340558,1.098097533e-11,17203648,1328284,896456668
542000,2095771954,81340673,1.0980990855e-11,17207385,1327780,897784448
542500,2087446055,81431978,1.099331703e-11,17197272,1327804,899112252
543000,2078862334,81343838,1.098141813e-11,17310252,1328268,900440520
543500,2085579200,81343489,1.0981371015000001e-11,17298927,1328776,901769296
544000,2109636931,81340390,1.098095265e-11,17197765,1328280,903097576
544500,2107437624,81432465,1.0993382775e-11,17213122,1328304,904425880
545000,2082583427,81337237,1.0980526995e-11,17095715,1329672,905755552
545500,2097845119,81328113,1.0979295255e-11,16799190,1328276,907083828
546000,2148186085,81338228,1.0980660780000001e-11,17127940,1328304,908412132
546500,2135066801,81336490,1.0980426150000001e-11,17071446,1328288,909740420
547000,2101109500,81432646,1.0993407210000001e-11,17219006,1328796,911069216
547500,2031706171,81343201,1.0981332135000001e-11,17289567,1330188,912399404
548000,2116062934,81339392,1.098081792e-11,17165766,1327804,913727208
548500,2119758117,81337459,1.0980556965e-11,17102918,1327784,915054992
549000,2191116326,81340552,1.0980974520000002e-11,17203456,1328804,916383796
549500,4832345567,81432515,1.0993389525000002e-11,17214736,1328812,917712608
550000,2105972901,81342216,1.0981199160000001e-11,17257550,1327812,919040420
550500,2093601041,81436807,1.0993968945e-11,17354222,1329160,920369580
551000,2110241966,81323074,1.0978614990000001e-11,16635434,1328776,921698356
551500,2119403266,81339721,1.0980862335e-11,17176466,1329312,923027668
552000,2093406701,81342979,1.0981302165e-11,17282327,1329688,924357356
552500,2081459095,81343728,1.098140328e-11,17306684,1329312,925686668
553000,2083762460,81435403,1.0993779405e-11,17308585,1329636,927016304
553500,2087924685,81342589,1.0981249515e-11,17269656,1329312,928345616
554000,2085625670,81344897,1.0981561095000002e-11,17344686,1327812,929673428
554500,2084612954,81341856,1.098115056e-11,17245840,1327812,931001240
555000,2081235564,81343345,1.0981351575000001e-11,17294224,1327312,932328552
555500,2080369061,81436593,1.0993940055e-11,17347287,1330160,933658712
556000,2080353305,81343743,1.0981405305000002e-11,17307150,1328784,934987496
556500,2147111654,81342580,1.09812483e-11,17268924,1327776,936315272
557000,2239312972,81338954,1.098075879e-11,17151529,1328152,937643424
557500,2115654756,81420064,1.099170864e-11,16810070,1328284,938971708
558000,2232976686,81328580,1.09793583e-11,16814374,1328284,940299992
558500,2132556749,81329303,1.0979455905000001e-11,16837869,1328260,941628252
559000,2184071334,81343828,1.098141678e-11,17309927,1327776,942956028
559500,2239637168,81424568,1.0992316680000001e-11,16956441,1328284,944284312
560000,3523582120,81345047,1.0981581344999999e-11,17349557,1328768,945613080
560500,6580220245,81438153,1.0994150655e-11,17397987,1328284,946941364
561000,2110191552,81345506,1.098164331e-11,17364466,1329304,948270668
561500,2101520660,81342503,1.0981237905000001e-11,17266854,1327812,949598480
562000,2096174911,81339436,1.098082386e-11,17167201,1328780,950927260
562500,2089875262,81342133,1.0981187955000001e-11,17254832,1329284,952256544
563000,2092742744,81432233,1.0993351455000001e-11,17205569,1328280,953584824
563500,2091173179,81345131,1.0981592685000001e-11,17352278,1328812,954913636
564000,2086980524,81343005,1.0981305675e-11,17283187,1328276,956241912
564500,2090523758,81343638,1.0981391130000001e-11,17303748,1328312,957570224
565000,2084289819,81346235,1.0981741725e-11,17388147,1328780,958899004
565500,3310389117,81431188,1.0993210380000001e-11,17171595,1329152,960228156
566000,2085277513,81323140,1.0978623900000001e-11,16637570,1327304,961555460
566500,2103647268,81324496,1.0978806960000001e-11,16681624,1328804,962884264
567000,2081794751,81325590,1.0978954650000001e-11,16717192,1328312,964212576
567500,2087090329,81432745,1.0993420575e-11,17222225,1330144,965542720
568000,2085101380,81342995,1.0981304325000001e-11,17282842,1329280,966872000
568500,2080228727,81341290,1.0981074150000002e-11,17227442,1328312,968200312
569000,2077066708,81341324,1.0981078740000002e-11,17228078,1327804,969528116
569500,2131571389,81343960,1.09814346e-11,17314231,1329180,970857296
570000,2213605736,81429190,1.0992940650000002e-11,17106686,1327312,972184608
570500,2127696941,81345770,1.098167895e-11,17373043,1328276,973512884
571000,2089089666,81343314,1.0981347390000001e-11,17293236,1328760,974841644
571500,2103633971,81343525,1.0981375875e-11,17300074,1329296,976170940
572000,2111555684,81432945,1.0993447575000001e-11,17228717,1329680,977500620
572500,2104942166,81335651,1.0980312885000002e-11,17044163,1329180,978829800
573000,2103449973,81325829,1.0978986915e-11,16724960,1328788,980158588
573500,8711864185,81467874,1.0998162990000002e-11,17172916,1329652,981488240
574000,2102169962,81342689,1.0981263015e-11,17272906,1328804,982817044
574500,2097642806,81342130,1.0981187550000001e-11,17254740,1329304,984146348
575000,2113460823,81344937,1.0981566495000002e-11,17345973,1329680,985476028
575500,2091850723,81345213,1.0981603755000002e-11,17354929,1326928,986802956
576000,2090590402,81434321,1.0993633335e-11,17273436,1329312,988132268
576500,2087049108,81342963,1.0981300005000001e-11,17281798,1327812,989460080
577000,2085462174,81342087,1.0981181745000001e-11,17253347,1328268,990788348
577500,2085334404,81339012,1.0980766620000001e-11,17153426,1328784,992117132
578000,2075398609,81342830,1.098128205e-11,17277504,1329812,993446944
578500,2228533239,81431898,1.099330623e-11,17194693,1327776,994774720
579000,2112313468,81342317,1.0981212795e-11,17260811,1329268,996103988
579500,2108029260,81341643,1.0981121805000002e-11,17238908,1328276,997432264
580000,2106416700,81341211,1.0981063485000001e-11,17224879,1328776,998761040
580500,2120029324,81428427,1.0992837645000002e-11,17081879,1329680,1000090720
581000,2124935124,81333217,1.0979984295000001e-11,16965058,1329776,1001420496
581500,2280138838,81332845,1.0979934075000002e-11,16952374,1328812,1002749308
582000,2455146787,81327738,1.097924463e-11,16787015,1329652,1004078960
582500,3527979652,81324275,1.0978777125e-11,16674465,1328276,1005407236
583000,6598918460,81438730,1.0994228549999999e-11,17009810,1329312,1006736548
583500,2103373640,81341742,1.098113517e-11,17242120,1328776,1008065324
584000,2089370530,81341779,1.0981140165e-11,17243325,1328776,1009394100
584500,2086403720,81345320,1.09816182e-11,17358415,1329688,1010723788
585000,2090319652,81342708,1.098126558e-11,17273517,1328276,1012052064
585500,2080878650,81343678,1.098139653e-11,17305040,1328784,1013380848
586000,2086001530,81434462,1.099365237e-11,17178780,1327768,1014708616
586500,2083938819,81342622,1.0981253970000002e-11,17270738,1327812,1016036428
587000,2082462319,81342196,1.0981196460000001e-11,17256884,1327312,1017363740
587500,2115109891,81341876,1.098115326e-11,17246484,1331036,1018694776
588000,2154806888,81326131,1.0979027685e-11,16734772,1328812,1020023588
588500,2100140248,81420201,1.0991727135e-11,16715316,1328804,1021352392
589000,2177594670,81325524,1.0978945740000001e-11,16715042,1329644,1022682036
589500,2117815763,81340049,1.0980906615e-11,17187106,1328312,1024010348
590000,2110880371,81345024,1.098157824e-11,17348782,1329304,1025339652
590500,2101060036,81437800,1.0994103e-11,17287272,1328304,1026667956
591000,2141117306,81344753,1.0981541655000002e-11,17340003,1328784,1027996740
591500,3466804476,81340110,1.098091485e-11,17189086,1328776,1029325516
592000,8712881173,81462905,1.0997492175e-11,17180176,1328284,1030653800
592500,2100975769,81340564,1.098097614e-11,17203860,1328284,1031982084
593000,2099133704,81337036,1.0980499860000001e-11,17089184,1327768,1033309852
593500,2095583553,81341345,1.0981081575e-11,17229226,1327804,1034637656
594000,2085325577,81437473,1.0994058855e-11,17176799,1328284,1035965940
594500,2132388888,81343082,1.098131607e-11,17285668,1328768,1037294708
595000,2094317379,81340149,1.0980920115e-11,17190369,1327776,1038622484
595500,2209570805,81339909,1.0980887715e-11,17182566,1328656,1039951140
596000,2197266859,81324663,1.0978829505e-11,16687069,1328776,1041279916
596500,2100967187,81428158,1.099280133e-11,16874694,1329768,1042609684
597000,2101831339,81339267,1.0980801045e-11,17161686,1328812,1043938496
597500,2109958262,81338784,1.098073584e-11,17145986,1328304,1045266800
598000,2103644355,81337751,1.0980596385000001e-11,17112437,1327776,1046594576
598500,2161497170,81435457,1.0993786695000001e-11,17111902,1328304,1047922880
599000,2117334730,81339238,1.0980797130000001e-11,17160757,1328276,1049251156
599500,2106929119,81339908,1.098088758e-11,17182512,1329284,1050580440
600000,2099298428,81341219,1.0981064565e-11,17225143,1329272,1051909712
600500,8711829715,81479075,1.0999675125000001e-11,17259131,1328264,1053237976
601000,2098601300,81338307,1.0980671445e-11,17130491,1328784,1054566760
601500,2105684302,81340195,1.0980926325000001e-11,17191850,1328312,1055895072
602000,2097595583,81336664,1.0980449640000002e-11,17077091,1329188,1057224260
602500,2084655466,81338419,1.0980686565000002e-11,17134120,1329304,1058553564
603000,2089728889,81435317,1.0993767795000001e-11,17107356,1328812,1059882376
603500,2086948057,81325732,1.0978973820000002e-11,16721808,1330556,1061212932
604000,2089681182,81323560,1.0978680600000001e-11,16651228,1328812,1062541744
604500,2078707708,81320791,1.0978306785000001e-11,16561234,1327804,1063869548
605000,2075291470,81435552,1.0993799520000001e-11,17114997,1330172,1065199720
605500,2090420638,81341781,1.0981140435000002e-11,17243411,1326936,1066526656
606000,2094853737,81329552,1.097948952e-11,16845958,1328304,1067854960
606500,2080660662,81328818,1.0979390430000001e-11,16821473,1328284,1069183244
607000,2114002023,81326901,1.0979131635e-11,16759808,1328276,1070511520
607500,2235093858,81328525,1.0979350875000001e-11,16812573,1329276,1071840796
608000,2107072073,81329307,1.0979456445000002e-11,16837996,1328796,1073169592
608500,2114886943,81329019,1.0979417565000001e-11,16828627,1329784,1074499376
609000,2173291036,81329874,1.097953299e-11,16856422,1329312,1075828688
609500,8726217297,81429237,1.0992946994999999e-11,16810561,1328776,1077157464
610000,2100986562,81327436,1.0979203860000001e-11,16777190,1328296,1078485760
610500,2108748379,81430860,1.0993166100000001e-11,16863319,1327768,1079813528
611000,2107057753,81325356,1.097892306e-11,16709580,1329296,1081142824
611500,2117490599,81337191,1.0980520785000001e-11,17094222,1328304,1082471128
612000,2083966290,81343858,1.098142083e-11,17310898,1327812,1083798940
612500,2084933339,81443538,1.099487763e-11,17275357,1329188,1085128128
613000,2083659137,81340010,1.098090135e-11,17185830,1327312,1086455440
613500,2083506464,81343970,1.098143595e-11,17314540,1328812,1087784252
614000,2089547263,81342392,1.098122292e-11,17263264,1327312,1089111564
614500,2088696997,81343987,1.0981438245000002e-11,17315107,1329660,1090441224
615000,2091474143,81442527,1.0994741145000001e-11,17242482,1329312,1091770536
615500,2146700932,81345448,1.098163548e-11,17362594,1329812,1093100348
616000,2088926764,81343861,1.0981421235e-11,17310991,1328760,1094429108
616500,2143326912,81343399,1.0981358865e-11,17295986,1328284,1095757392
617000,2165783768,81445049,1.0995081615e-11,17324442,1328276,1097085668
617500,2175426280,81337811,1.0980604485000001e-11,17114364,1329160,1098414828
618000,2161400622,81325232,1.097890632e-11,16705562,1327268,1099742096
618500,8728369901,81447571,1.0995422085e-11,16751393,1328776,1101070872
619000,2102357706,81330992,1.0979683920000002e-11,16892093,1328784,1102399656
619500,2096764026,81343983,1.0981437705000001e-11,17314960,1327760,1103727416
620000,2088488297,81329652,1.097950302e-11,16849216,1328284,1105055700
620500,2090151501,81448723,1.0995577605e-11,17344627,1327776,1106383476
621000,2063707522,81339003,1.0980765405000001e-11,17153106,1327784,1107711260
621500,2098008926,81342911,1.0981292985e-11,17280117,1328772,1109040032
622000,2103549164,81341194,1.098106119e-11,17224322,1328812,1110368844
622500,2157267600,81342196,1.0981196460000001e-11,17256885,1328780,1111697624
623000,2112208362,81445868,1.0995192180000002e-11,17251865,1328764,1113026388
623500,2074638858,81342680,1.09812618e-11,17272622,1329284,1114355672
624000,2103294282,81340585,1.0980978975000001e-11,17204522,1328276,1115683948
624500,2106654427,81339906,1.098088731e-11,17182462,1328284,1117012232
625000,2117782840,81444758,1.0995042329999999e-11,17215762,1327304,1118339536
625500,2153322580,81344373,1.0981490355000001e-11,17327640,1329284,1119668820
626000,2217489282,81335597,1.0980305595000001e-11,17042433,1328680,1120997500
626500,8830322419,81464496,1.099770696e-11,16844918,1329804,1122327304
627000,2097745548,81325345,1.0978921575e-11,16709242,1327804,1123655108
627500,2096478900,81326792,1.0979116919999999e-11,16756255,1329680,1124984788
628000,2087090181,81344688,1.098153288e-11,17337896,1329312,1126314100
628500,2092474061,81342775,1.0981274625e-11,17275706,1328812,1127642912
629000,2089098165,81448252,1.0995514020000002e-11,17329347,1329688,1128972600
629500,2087350145,81343728,1.098140328e-11,17306664,1329284,1130301884
630000,2079587413,81342986,1.098130311e-11,17282558,1328304,1131630188
630500,2083249029,81346008,1.098171108e-11,17380790,1329160,1132959348
631000,2136856722,81446173,1.0995233355e-11,17261770,1328276,1134287624
631500,2115352845,81339968,1.098089568e-11,17183804,1328304,1135615928
632000,2102359957,81340600,1.0980981e-11,17205003,1329680,1136945608
632500,2200704182,81330586,1.0979629110000001e-11,16879548,1329556,1138275164
633000,2311899401,81308913,1.0976703255e-11,16175206,1329304,1139604468
633500,2147206942,81428706,1.0992875310000001e-11,16594859,1329180,1140933648
634000,2156870134,81326119,1.0979026065000002e-11,16734378,1328804,1142262452
634500,2117267843,81322500,1.0978537500000001e-11,16616756,1329296,1143591748
635000,8764394446,81477993,1.0999529055e-11,16807258,1330160,1144921908
635500,2098253371,81335511,1.0980293985000001e-11,17039613,1329276,1146251184
636000,2101357396,81324806,1.097884881e-11,16691723,1327784,1147578968
636500,2092579123,81328215,1.0979309025000001e-11,16802516,1329260,1148908228
637000,2084779429,81329607,1.0979496945000001e-11,16847756,1329312,1150237540
637500,2110959321,81433150,1.0993475250000002e-11,16739292,1328776,1151566316
638000,2085953747,81328075,1.0979290125e-11,16797953,1328776,1152895092
638500,2080449144,81327344,1.0979191440000001e-11,16774206,1329312,1154224404
639000,2072952858,81327806,1.0979253809999999e-11,16789202,1329312,1155553716
639500,2095364659,81434331,1.0993634685e-11,16777667,1328784,1156882500
640000,2227656183,81318864,1.0978046640000001e-11,16498604,1328660,1158211160
640500,2153748886,81316384,1.097771184e-11,16417997,1327768,1159538928
641000,2202820122,81322003,1.0978470405000001e-11,16600618,1328312,1160867240
641500,2140313588,81309918,1.097683893e-11,16207848,1328796,1162196036
642000,2111098566,81417060,1.09913031e-11,16216356,1329312,1163525348
642500,2372213399,81310293,1.0976889555e-11,16220038,1328312,1164853660
643000,2095804489,81325490,1.0978941150000002e-11,16713929,1330160,1166183820
643500,2285125592,81323232,1.0978636320000001e-11,16640548,1327796,1167511616
644000,3570329676,81456893,1.0996680555e-11,16696471,1327284,1168838900
644500,2127981877,81325239,1.0978907265000001e-11,16705770,1328312,1170167212
645000,2141198791,81327903,1.0979266905e-11,16792362,1328788,1171496000
645500,2106283929,81325410,1.097893035e-11,16711355,1329188,1172825188
646000,2100548788,81321821,1.0978445835e-11,16594716,1328304,1174153492
646500,2095434452,81432829,1.0993431915e-11,16629628,1329296,1175482788
647000,2092786087,81324457,1.0978801695e-11,16680382,1331028,1176813816
647500,2092235959,81305514,1.0976244390000001e-11,16064726,1328812,1178142628
648000,2084965886,81307822,1.097655597e-11,16139736,1329312,1179471940
648500,2083920191,81419842,1.0991678670000001e-11,16207556,1330160,1180802100
649000,2073388139,81320899,1.0978321365000002e-11,16564726,1328312,1182130412
649500,2076362070,81325208,1.0978903080000001e-11,16704790,1329812,1183460224
650000,2150325980,81324226,1.0978770510000001e-11,16672863,1329688,1184789912
650500,2130111172,81326833,1.0979122455e-11,16757580,1328804,1186118716
651000,2115692373,81433870,1.099357245e-11,16663465,1328784,1187447500
651500,2102133189,81321589,1.0978414515e-11,16587149,1328688,1188776188
652000,2090073353,81323990,1.097873865e-11,16665200,1329804,1190105992
652500,2109319376,81323601,1.0978686135e-11,16652550,1328304,1191434296
653000,2097809118,81433844,1.0993568940000001e-11,16662630,1327796,1192762092
653500,3357270534,81324541,1.0978813035e-11,16683102,1330564,1194092656
654000,6593012958,81432663,1.0993409505000001e-11,16624250,1327312,1195419968
654500,2102374166,81332959,1.0979949465e-11,16956676,1328296,1196748264
655000,2108586425,81341931,1.0981160685e-11,17248274,1328312,1198076576
655500,2091473746,81340468,1.098096318e-11,17200744,1327796,1199404372
656000,2091476263,81343504,1.098137304e-11,17299397,1328260,1200732632
656500,2087259782,81454838,1.0996403130000001e-11,17245025,1328688,1202061320
657000,2084834670,81341040,1.0981040400000002e-11,17219336,1329304,1203390624
657500,2088452496,81341451,1.0981095885e-11,17232658,1327804,1204718428
658000,2083550283,81344538,1.098151263e-11,17332997,1330680,1206049108
658500,2110829926,81453380,1.09962063e-11,17198308,1328812,1207377920
659000,2088887348,81340922,1.098102447e-11,17215490,1327788,1208705708
659500,2251635474,81341186,1.0981060110000001e-11,17224066,1327812,1210033520
660000,2104311352,81341537,1.0981107495000002e-11,17235465,1329160,1211362680
660500,2108595632,81344334,1.0981485090000002e-11,17326373,1327420,1212690100
661000,2095351187,81439878,1.0994383530000002e-11,16759499,1329652,1214019752
661500,2108634285,81308401,1.0976634135e-11,16158565,1329660,1215349412
662000,2114596842,81308417,1.0976636295000001e-11,16159074,1328804,1216678216
662500,8717992984,81476041,1.0999265535000002e-11,16465956,1327304,1218005520
663000,2104992012,81325632,1.0978960320000002e-11,16718550,1329152,1219334672
663500,2092410421,81324119,1.0978756065000001e-11,16669386,1328304,1220662976
664000,2093613702,81326677,1.0979101395e-11,16752524,1328804,1221991780
664500,2090172110,81327211,1.0979173484999999e-11,16769877,1330180,1223321960
665000,2112619744,81443825,1.0994916375000001e-11,16887786,1329312,1224651272
665500,2064558913,81325501,1.0978942635e-11,16714310,1328304,1225979576
666000,2082714592,81326852,1.097912502e-11,16758205,1328776,1227308352
666500,2085151091,81322662,1.097855937e-11,16622033,1330188,1228638540
667000,2087939142,81434852,1.099370502e-11,16596156,1328812,1229967352
667500,2079164321,81323668,1.097869518e-11,16654717,1329680,1231297032
668000,2077715100,81326138,1.0979028630000001e-11,16734991,1330152,1232627184
668500,2083569142,81323500,1.09786725e-11,16649280,1328296,1233955480
669000,2076726373,81334744,1.098019044e-11,17013992,1329304,1235284784
669500,2081343642,81456862,1.0996676370000001e-11,17212267,1329688,1236614472
670000,2088331826,81341311,1.0981076985e-11,17228128,1328812,1237943284
670500,2102495744,81347494,1.0981911690000001e-11,17429077,1329784,1239273068
671000,2123698143,81337385,1.0980546975e-11,17100525,1329276,1240602344
671500,2171379790,81454716,1.099638666e-11,17142513,1328680,1241931024
672000,2120274736,81338917,1.0980753795e-11,17150336,1329312,1243260336
672500,2137356278,81341693,1.0981128555e-11,17240538,1328804,1244589140
673000,2280820146,81338947,1.0980757845e-11,17151289,1328152,1245917292
673500,2188370074,81342376,1.0981220760000002e-11,17262742,1329312,1247246604
674000,3382602679,81462397,1.0997423595e-11,17392149,1329680,1248576284
674500,2099573319,81341099,1.0981048365000001e-11,17221223,1329680,1249905964
675000,2110225234,81340092,1.0980912420000001e-11,17188510,1327812,1251233776
675500,2107260613,81338262,1.0980665370000001e-11,17129024,1328784,1252562560
676000,2094021718,81445379,1.0995126165000001e-11,16839050,1330660,1253893220
676500,2074920822,81328481,1.0979344935000001e-11,16811153,1328272,1255221492
677000,2068978021,81342432,1.0981228320000001e-11,17264572,1329296,1256550788
677500,2082689188,81342737,1.0981269495e-11,17274485,1329680,1257880468
678000,2328868942,81457716,1.0996791660000001e-11,17240016,1327812,1259208280
678500,2121463772,81343424,1.098136224e-11,17296804,1328312,1260536592
679000,2140372194,81344683,1.0981532205000001e-11,17337718,1328812,1261865404
679500,2086828015,81345072,1.0981584720000002e-11,17350343,1329180,1263194584
680000,2115089545,81459043,1.0996970805000002e-11,17283149,1328284,1264522868
680500,2113691827,81346907,1.0981832445e-11,17409998,1328804,1265851672
681000,2223838552,81342320,1.09812132e-11,17260905,1327252,1267178924
681500,2102668195,81339755,1.0980866925e-11,17176826,1328312,1268507236
682000,2158813890,81330329,1.0979594415e-11,16871224,1330028,1269837264
682500,9148074711,81458865,1.0996946775000002e-11,16791086,1328304,1271165568
683000,2102817778,81446861,1.0995326235e-11,16788020,1327796,1272493364
683500,2076045011,81328835,1.0979392725e-11,16822645,1330180,1273823544
684000,2107089910,81326036,1.097901486e-11,16731688,1327812,1275151356
684500,2091077804,81328759,1.0979382465e-11,16820190,1329312,1276480668
685000,2086191112,81326788,1.0979116380000002e-11,16756120,1328796,1277809464
685500,2085445754,82596854,1.1150575290000001e-11,16887729,1332756,1279142220
686000,2085201090,95525416,1.289593116e-11,21360592,1327784,1280470004
686500,2081627151,95532668,1.289691018e-11,21525300,1329284,1281799288
687000,2078942280,95542417,1.2898226295000001e-11,21924349,1328784,1283128072
687500,2086503616,95531006,1.2896685810000001e-11,21606058,1328284,1284456356
688000,6546258012,95665856,1.2914890560000001e-11,21914667,1327784,1285784140
688500,4804258389,91455702,1.234651977e-11,21860978,22200732,1307984872
689000,4929796032,87735489,1.1844291015000001e-11,21037468,39660660,1347645532
689500,3417123071,87762418,1.184792643e-11,20960995,39650704,1387296236
690000,3392807752,87897444,1.186615494e-11,20933555,39656872,1426953108
690500,8726182849,87872673,1.1862810855e-11,20953389,39657520,1466610628
691000,2095986463,87791268,1.1851821180000002e-11,20907403,39653260,1506263888
691500,2089604156,87701995,1.1839769325000001e-11,20744788,39653596,1545917484
692000,2090262951,87715672,1.184161572e-11,20738818,39654948,1585572432
692500,2087388148,87892292,1.186545942e-11,20713910,39655232,1625227664
693000,2084063469,87747616,1.184592816e-11,20430508,39655856,1664883520
693500,2083610340,91090949,1.2297278115e-11,20160656,17239192,1682122712
694000,2085270654,93320171,1.2598223085000001e-11,19783483,1329312,1683452024
694500,2077663860,93283153,1.2593225655000001e-11,19547603,1329688,1684781712
695000,3325326267,93742110,1.265518485e-11,19762020,1327812,1686109524
695500,3310442767,93419397,1.2611618595000001e-11,19990807,1329312,1687438836
696000,3314276927,93402111,1.2609284985e-11,20016361,1328276,1688767112
696500,2073459208,82294551,1.1109764385e-11,20093965,-827452268,861314844
697000,2086607772,81341433,1.0981093455000001e-11,17232103,1327768,862642612
697500,2079652314,81339669,1.0980855315000001e-11,17174757,1327768,863970380
698000,2085656916,81340778,1.098100503e-11,17210792,1328276,865298656
698500,2085859755,81342430,1.098122805e-11,17264501,1328760,866627416
699000,2079517970,81505392,1.100322792e-11,17301213,1329772,867957188
699500,2119706927,81340116,1.098091566e-11,17189273,1328784,869285972
700000,2071899681,81340209,1.0980928215e-11,17192310,1328276,870614248
700500,2111522140,81338686,1.098072261e-11,17142805,1328652,871942900
701000,2073235886,81490440,1.1001209400000001e-11,16815286,1328812,873271712
701500,2095788764,81339943,1.0980892305e-11,17183657,1328296,874600008
702000,2107403078,81338713,1.0980726255e-11,17143682,1327312,875927320
702500,2115012198,81340308,1.0980941580000002e-11,17195545,1327784,877255104
703000,2142735636,81341326,1.0981079010000001e-11,17228599,1328268,878583372
703500,8963090952,81617129,1.1018312415000002e-11,17250967,1329264,879912636
704000,2079170144,81340503,1.0980967905e-11,17201848,1327796,881240432
704500,2112553140,81342950,1.098129825e-11,17281395,1328268,882568700
705000,2098884786,81342255,1.0981204425e-11,17258802,1329312,883898012
705500,2092927055,81341161,1.0981056735e-11,17223262,1327804,885225816
706000,2078161092,81339041,1.0980770535000001e-11,17154354,1327804,886553620
706500,2086463434,81342433,1.0981228455e-11,17264578,1327812,887881432
707000,2084904651,81340772,1.098100422e-11,17210618,1328312,889209744
707500,2084110590,81341567,1.0981111545000001e-11,17236431,1329660,890539404
708000,2088450417,81500544,1.100257344e-11,17143672,1328312,891867716
708500,2084748039,81339016,1.0980767160000002e-11,17153523,1329680,893197396
709000,2077753815,81334838,1.098020313e-11,17017754,1327804,894525200
709500,2076173289,81348985,1.0982112975000001e-11,17477527,1330180,895855380
710000,2100056715,81498570,1.100230695e-11,17079504,1328804,897184184
710500,2252717901,81328656,1.097936856e-11,16816854,1328796,898512980
711000,2152978948,81332732,1.0979918820000001e-11,16949290,1328312,899841292
711500,2087630251,81343431,1.0981363185e-11,17297018,1329304,901170596
712000,2112196185,81341838,1.098114813e-11,17245249,1329652,902500248
712500,2167043572,81503035,1.1002909725000001e-11,17224614,1328812,903829060
713000,2153184790,81341957,1.0981164195000002e-11,17249130,1327304,905156364
713500,2123032283,81341383,1.0981086705e-11,17230294,1328296,906484660
714000,11319220824,81583488,1.101377088e-11,17209579,1329688,907814348
714500,2096961552,81341944,1.0981162440000001e-11,17248700,1328804,909143152
715000,2087239807,81342963,1.0981300005000001e-11,17281822,1327312,910470464
715500,2088936190,81334265,1.0980125775e-11,16999141,1329180,911799644
716000,2089112722,81490331,1.1001194685000001e-11,16811719,1328284,913127928
716500,2085195416,81326107,1.0979024445000001e-11,16733988,1328276,914456204
717000,2084601832,81338016,1.098063216e-11,17121034,1327776,915783980
717500,2075364537,81344454,1.098150129e-11,17330268,1329784,917113764
718000,2133438348,81345295,1.0981614825e-11,17357617,1328280,918442044
718500,2240823724,81503499,1.1002972365e-11,17239707,1328284,919770328
719000,2141913404,81345456,1.0981636560000001e-11,17362843,1328764,921099092
719500,2102247009,81342884,1.098128934e-11,17279240,1328276,922427368
720000,2106951318,81344085,1.0981451475e-11,17318297,1328276,923755644
720500,2112845697,81507825,1.1003556375e-11,17380305,1328284,925083928
721000,2118061155,81341552,1.098110952e-11,17235975,1329272,926413200
721500,2178624836,81343649,1.0981392615e-11,17304109,1329284,927742484
722000,4871784362,81342441,1.0981229535000001e-11,17264859,1329276,929071760
722500,8723943052,81634807,1.1020698945000001e-11,17299557,1328260,930400020
723000,2098147200,81341927,1.0981160145e-11,17248128,1327312,931727332
723500,2093443413,81342402,1.098122427e-11,17263576,1328768,933056100
724000,2083041844,81339698,1.0980859230000001e-11,17175709,1329660,934385760
724500,2087746007,81486339,1.1000655765e-11,16681989,1327784,935713544
725000,2082497470,81331825,1.0979796375000002e-11,16919834,1327812,937041356
725500,2084513290,81348009,1.0981981215000001e-11,17445808,1329304,938370660
726000,2082829339,81342302,1.0981210770000001e-11,17260330,1329776,939700436
726500,2081775834,81344952,1.098156852e-11,17346462,1329784,941030220
727000,2147822615,81502876,1.1002888260000002e-11,17219450,1327804,942358024
727500,2256436219,81344819,1.0981550565e-11,17342129,1328280,943686304
728000,2316486615,81346008,1.098171108e-11,17380779,1330188,945016492
728500,2228050498,81346374,1.098176049e-11,17392662,1328276,946344768
729000,2110414368,81505142,1.100319417e-11,17293093,1327780,947672548
729500,2208091078,81344602,1.098152127e-11,17335090,1328304,949000852
730000,2376477443,81344413,1.0981495755e-11,17328929,1328276,950329128
730500,2284609411,81341069,1.0981044315e-11,17220271,1327772,951656900
731000,3432638475,81341624,1.098111924e-11,17238292,1328304,952985204
731500,8724358305,81666404,1.102496454e-11,17274558,1328304,954313508
732000,2105433690,81332794,1.097992719e-11,16951337,1329172,955642680
732500,2091533175,81326982,1.0979142570000001e-11,16762420,1328312,956970992
733000,2090408169,81327203,1.0979172405e-11,16769612,1330148,958301140
733500,2091880865,81331706,1.0979780310000001e-11,16915950,1329312,959630452
734000,2087181393,81503722,1.100300247e-11,17246943,1328772,960959224
734500,2089179316,81342196,1.0981196460000001e-11,17256905,1328280,962287504
735000,2084450191,81342881,1.0981288935e-11,17279148,1328296,963615800
735500,2079899868,81347436,1.098190386e-11,17427187,1330152,964945952
736000,2099561370,81343984,1.098143784e-11,17315006,1328812,966274764
736500,2075955265,81504895,1.1003160825e-11,17285064,1327812,967602576
737000,2172651529,81342761,1.0981272735e-11,17275263,1329152,968931728
737500,2109389706,81344046,1.0981446210000001e-11,17317024,1328804,970260532
738000,2176835565,81341809,1.0981144215000001e-11,17244304,1328312,971588844
738500,2109682709,81509192,1.100374092e-11,17424732,1330556,972919400
739000,2114783755,81325300,1.0978915500000001e-11,16707571,1328272,974247672
739500,2090970176,81327694,1.097923869e-11,16785582,1328312,975575984
740000,3360162241,81328300,1.0979320499999999e-11,16805262,1328312,976904296
740500,8708476357,81583572,1.101378222e-11,17212281,1329680,978233976
741000,2086717795,81335008,1.098022608e-11,17023263,1328776,979562752
741500,2092629995,81342647,1.0981257345000001e-11,17271552,1328296,980891048
742000,2093958148,81344257,1.0981474695e-11,17323881,1329672,982220720
742500,2065278515,81506204,1.1003337540000002e-11,17327626,1328804,983549524
743000,2097605902,81344691,1.0981533285e-11,17337976,1329804,984879328
743500,2084366275,81344846,1.098155421e-11,17343003,1329688,986209016
744000,2087643369,81343935,1.0981431225e-11,17313388,1328312,987537328
744500,2074856421,81343381,1.0981356435e-11,17295414,1328804,988866132
745000,2187988222,81516441,1.1004719535e-11,17660306,1330036,990196168
745500,2159355654,81338796,1.0980737460000001e-11,17146395,1328420,991524588
746000,2086486350,81323434,1.097866359e-11,16647118,1328784,992853372
746500,2139105690,81325649,1.0978962615e-11,16719127,1327776,994181148
747000,2179523682,81502251,1.1002803885e-11,17199146,1328776,995509924
747500,2127864890,81341396,1.0981088460000002e-11,17230904,1328784,996838708
748000,2100862617,81344804,1.098154854e-11,17341643,1328784,998167492
748500,2116834334,81342384,1.098122184e-11,17262999,1329276,999496768
749000,8701870740,81571422,1.1012141970000001e-11,17343387,1329260,1000826028
749500,2102096986,81339916,1.0980888660000001e-11,17182801,1327776,1002153804
750000,2097292591,81344029,1.0981443915e-11,17316459,1329284,1003483088
750500,2089078777,81346769,1.0981813815e-11,17405518,1329784,1004812872
751000,2092178866,81339119,1.0980781065000002e-11,17156875,1328776,1006141648
751500,2080600633,81499753,1.1002466655000001e-11,17117738,1327312,1007468960
752000,2086534986,81339033,1.0980769455e-11,17154080,1328268,1008797228
752500,2135104683,81341937,1.0981161495e-11,17248466,1328812,1010126040
753000,2081802232,81342113,1.0981185255e-11,17254198,1327812,1011453852
753500,2082325066,81490448,1.100121048e-11,16815548,1330528,1012784380
754000,2097761400,81321949,1.0978463115000001e-11,16598866,1328284,1014112664
754500,2138487690,81331826,1.097979651e-11,16919860,1327804,1015440468
755000,2126943623,81335239,1.0980257265e-11,17030777,1327784,1016768252
755500,2140879860,81334869,1.0980207315e-11,17018750,1327812,1018096064
756000,2108519537,81503147,1.1002924845000001e-11,17228248,1328804,1019424868
756500,2107491696,81341185,1.0981059975000001e-11,17224034,1328796,1020753664
757000,2150068127,81340719,1.0980997065e-11,17208891,1329688,1022083352
757500,2145091594,81340299,1.0980940365e-11,17195242,1328812,1023412164
758000,2113706548,81504052,1.1003047020000001e-11,17257674,1327804,1024739968
758500,3367888068,81343137,1.0981323495e-11,17287462,1328312,1026068280
759000,8707685294,81499072,1.1002374720000001e-11,17095825,1328688,1027396968
759500,2096654025,81343579,1.0981383165e-11,17301818,1328804,1028725772
760000,2087685046,81341468,1.0981098180000002e-11,17233244,1329296,1030055068
760500,2096837281,81335259,1.0980259965000001e-11,17031435,1332440,1031387508
761000,2067775822,81488246,1.1000913210000001e-11,16743968,1328784,1032716292
761500,2085352388,81339434,1.0980823590000001e-11,17167122,1328752,1034045044
762000,2085982144,81341883,1.0981154205000001e-11,17246700,1327776,1035372820
762500,2081218782,81344511,1.0981508985000001e-11,17332115,1328784,1036701604
763000,2104786561,81341403,1.0981089404999999e-11,17231108,1327784,1038029388
763500,2085651606,81507037,1.1003449995e-11,17354691,1329284,1039358672
764000,2142774885,81347005,1.0981845674999999e-11,17412941,1328776,1040687448
764500,2124790751,81344819,1.0981550565e-11,17342118,1329276,1042016724
765000,2233062112,81341686,1.098112761e-11,17240322,1327776,1043344500
765500,2151464832,81511371,1.1004035085000001e-11,17495519,1329284,1044673784
766000,2093320870,81341776,1.098113976e-11,17243239,1328284,1046002068
766500,2120127710,81343687,1.0981397745e-11,17305337,1328776,1047330844
767000,2119940967,81340454,1.098096129e-11,17200258,1327284,1048658128
767500,4951863224,81539297,1.1007805095e-11,17351198,1328312,1049986440
768000,2110406336,81342375,1.0981220625000002e-11,17262706,1328796,1051315236
768500,2109437463,81337221,1.0980524835000002e-11,17095217,1329136,1052644372
769000,2095906619,81327242,1.0979177670000002e-11,16770877,1328776,1053973148
769500,2098647073,81346378,1.098176103e-11,17392790,1328804,1055301952
770000,2130061722,81505966,1.100330541e-11,17319863,1328776,1056630728
770500,2118070030,81342895,1.0981290825000002e-11,17279614,1328284,1057959012
771000,2082462721,81326603,1.0979091405000001e-11,16750118,1329276,1059288288
771500,2084353628,81331476,1.097974926e-11,16908502,1328784,1060617072
772000,2080027465,81505577,1.1003252895e-11,17307246,1329312,1061946384
772500,2084701254,81342076,1.098118026e-11,17252989,1328276,1063274660
773000,2078542452,81342613,1.0981252755000001e-11,17270430,1328812,1064603472
773500,2113466526,81342890,1.098129015e-11,17279452,1328304,1065931776
774000,2270577421,81339494,1.0980831690000001e-11,17169084,1327312,1067259088
774500,2076917450,81503192,1.1002930920000002e-11,17229728,1328312,1068587400
775000,2113374236,81341458,1.0981096830000001e-11,17232900,1328268,1069915668
775500,2111499127,81345417,1.0981631295e-11,17361558,1328804,1071244472
776000,2118211874,81337432,1.0980553320000001e-11,17102040,1327812,1072572284
776500,2088593987,81502556,1.1002845060000001e-11,17208794,1328312,1073900596
777000,2118189672,81332054,1.097982729e-11,16927279,1328688,1075229284
777500,3392009528,81341357,1.0981083195e-11,17229637,1329172,1076558456
778000,3381738688,81326921,1.0979134335e-11,16760457,1328776,1077887232
778500,2105674269,81488912,1.1001003120000001e-11,16765622,1328312,1079215544
779000,2102646901,81326251,1.0979043885000002e-11,16738686,1328788,1080544332
779500,2110796082,81341820,1.09811457e-11,17244648,1329648,1081873980
780000,2117923316,81343556,1.098138006e-11,17301096,1328804,1083202784
780500,2108304773,81507820,1.10035557e-11,17380120,1329304,1084532088
781000,2086522697,81339528,1.0980836280000001e-11,17170168,1328312,1085860400
781500,2087267158,81339462,1.0980827370000001e-11,17168040,1328812,1087189212
782000,2108299063,81338338,1.098067563e-11,17131490,1329660,1088518872
782500,2180357871,81338552,1.0980704520000001e-11,17138456,1327276,1089846148
783000,2102894691,81339579,1.0980843165e-11,17171824,1328812,1091174960
783500,2224240806,81343533,1.0981376955000002e-11,17300328,1331028,1092505988
784000,2212515734,81322919,1.0978594065000001e-11,16630388,1327768,1093833756
784500,2210998598,81326596,1.097909046e-11,16749872,1328312,1095162068
785000,2118123528,81487205,1.1000772675e-11,16710134,1328296,1096490364
785500,2150566922,81341697,1.0981129095000001e-11,17240662,1328312,1097818676
786000,2136256390,81341477,1.0981099395e-11,17233508,1328776,1099147452
786500,3351097861,81340418,1.0980956429999999e-11,17199110,1328784,1100476236
787000,8784473751,81615600,1.1018106e-11,17201293,1327768,1101804004
787500,2142627152,81340972,1.098103122e-11,17217114,1328784,1103132788
788000,2110649234,81340490,1.098096615e-11,17201455,1329276,1104462064
788500,2095234161,81340979,1.0981032165e-11,17217337,1327284,1105789348
789000,2087820371,81502515,1.1002839525000001e-11,17207419,1327784,1107117132
789500,2093638404,81341177,1.0981058895000001e-11,17223784,1328784,1108445916
790000,2090951843,81341085,1.0981046475e-11,17220769,1328768,1109774684
790500,2079352968,81347309,1.0981886715e-11,17423068,1328796,1111103480
791000,2083506295,81339958,1.0980894330000002e-11,17184155,1329780,1112433260
791500,2141968112,81503188,1.1002930380000002e-11,17229592,1328804,1113762064
792000,2102406370,81340551,1.0980974385000001e-11,17203411,1329680,1115091744
792500,2106497144,81342564,1.098124614e-11,17268860,1328812,1116420556
793000,2188024846,81356409,1.0983115215e-11,17718800,1329160,1117749716
793500,2166116551,81518860,1.10050461e-11,17738912,1327776,1119077492
794000,2158445214,81358548,1.098340398e-11,17788312,1327776,1120405268
794500,2181428141,81355777,1.0983029895e-11,17698264,1327768,1121733036
795000,2107498710,81358060,1.09833381e-11,17772473,1328784,1123061820
795500,3365687122,81360131,1.0983617685e-11,17839776,1327796,1124389616
796000,6601502843,81516674,1.100475099e-11,17667872,1328284,1125717900
796500,2099591680,81357868,1.098331218e-11,17766216,1328812,1127046712
797000,2093410060,81516672,1.1004750720000001e-11,17667827,1328772,1128375484
797500,2111320489,81358265,1.0983365775e-11,17779140,1329296,1129704780
798000,2085085016,81358880,1.0983448800000001e-11,17799113,1329652,1131034432
798500,2087621521,81356578,1.098313803e-11,17724302,1328804,1132363236
799000,2089817988,81520158,1.100522133e-11,17781117,1329276,1133692512
799500,2084053985,81347176,1.0981868760000001e-11,17418753,1329180,1135021692
800000,2079801119,81335997,1.0980359595000001e-11,17055422,1327812,1136349504
800500,2224283002,81344965,1.0981570275000001e-11,17346896,1328312,1137677816
801000,2096509798,81356484,1.098312534e-11,17721248,1328296,1139006112
801500,2083540750,81518924,1.1005054740000001e-11,17740674,1329280,1140335392
802000,2102698662,81356192,1.098308592e-11,17711755,1329680,1141665072
802500,2125105034,81353581,1.0982733435e-11,17626888,1327312,1142992384
803000,2135918406,81357758,1.0983297330000001e-11,17762638,1328312,1144320696
803500,2109426666,81519253,1.1005099155e-11,17751706,1327812,1145648508
804000,2118033730,81356480,1.09831248e-11,17721098,1330160,1146978668
804500,11289498347,81536569,1.1007436815e-11,17788518,1327804,1148306472
805000,2098578031,81358729,1.0983428415000002e-11,17794200,1328812,1149635284
805500,2087486678,81353129,1.0982672415000001e-11,17612210,1328812,1150964096
806000,2086316138,81341020,1.09810377e-11,17218684,1329276,1152293372
806500,2089093458,81504590,1.1003119650000002e-11,17275159,1328276,1153621648
807000,2077753019,81358683,1.0983422205e-11,17792715,1328272,1154949920
807500,2085078177,81355914,1.098304839e-11,17702709,1328284,1156278204
808000,2089821464,81358284,1.0983368340000002e-11,17779748,1329304,1157607508
808500,2080248955,81357006,1.098319581e-11,17738204,1328312,1158935820
809000,2113581950,81520143,1.1005219305e-11,17780625,1329276,1160265096
809500,2122386469,81358215,1.0983359025000002e-11,17777489,1328280,1161593376
810000,2092581263,81359140,1.09834839e-11,17807562,1328276,1162921652
810500,2101257037,81362164,1.098389214e-11,17905856,1328768,1164250420
811000,2166312082,81514648,1.1004477480000001e-11,17602056,1329276,1165579696
811500,2116338498,81354181,1.0982814435000002e-11,17646416,1328776,1166908472
812000,2136102247,81355320,1.09829682e-11,17683412,1328312,1168236784
812500,2115657306,81356215,1.0983089025000001e-11,17712493,1329660,1169566444
813000,2101185718,81350266,1.098228591e-11,17519162,1329656,1170896100
813500,8731420301,81502503,1.1002837905e-11,17207320,1329304,1172225404
814000,2133724590,81504080,1.1003050800000001e-11,17258258,1328812,1173554216
814500,2120886657,81356017,1.0983062295e-11,17706082,1329144,1174883360
815000,2088744641,81357115,1.0983210525e-11,17741757,1328784,1176212144
815500,2081499788,81365634,1.0984360590000001e-11,18018618,1328768,1177540912
816000,2083542455,81356774,1.0983164490000002e-11,17730682,1327812,1178868724
816500,2081791662,81519974,1.100519649e-11,17775130,1328288,1180197012
817000,2082461510,81360403,1.0983654405e-11,17848622,1329804,1181526816
817500,2088964299,81356869,1.0983177315e-11,17733767,1329680,1182856496
818000,2084592896,81358497,1.0983397095e-11,17786676,1328796,1184185292
818500,2080183472,81521168,1.1005357679999999e-11,17813936,1329312,1185514604
819000,2085023673,81359094,1.098347769e-11,17806081,1329672,1186844276
819500,2074450368,81358802,1.098343827e-11,17796570,1328304,1188172580
820000,2082584854,81354907,1.0982912445e-11,17670007,1329672,1189502252
820500,2148187824,81345035,1.0981579725e-11,17349146,1328304,1190830556
821000,2132180078,81503569,1.1002981815000001e-11,17241984,1328784,1192159340
821500,2094757375,81340940,1.0981026900000002e-11,17216080,1328788,1193488128
822000,2167775150,81341605,1.0981116675000001e-11,17237681,1328688,1194816816
822500,2110363075,81355099,1.0982938365e-11,17676218,1327788,1196144604
823000,2111607065,81517744,1.100489544e-11,17702644,1328288,1197472892
823500,2129303835,81353116,1.098267066e-11,17611782,1328312,1198801204
824000,3408732981,81359055,1.0983472425000001e-11,17804803,1330688,1200131892
824500,2108601311,81355770,1.098302895e-11,17698046,1328796,1201460688
825000,2104947329,81518376,1.100498076e-11,17723205,1330664,1202791352
825500,2099648944,81365879,1.0984393665000001e-11,18026572,1327784,1204119136
826000,2074478058,81359149,1.0983485115e-11,17807872,1328284,1205447420
826500,2072684576,81360504,1.098366804e-11,17851508,1327812,1206775232
827000,2091611216,81354532,1.098286182e-11,17657789,1329672,1208104904
827500,2087356609,81504689,1.1003133015000001e-11,17278373,1328776,1209433680
828000,2107466892,81341630,1.098112005e-11,17238485,1327776,1210761456
828500,2127050609,81353220,1.0982684700000001e-11,17615181,1327772,1212089228
829000,2155219349,81358235,1.0983361725e-11,17778145,1328256,1213417484
829500,2320091264,81522208,1.100549808e-11,17847734,1327812,1214745296
830000,2087043805,81357575,1.0983272625e-11,17756689,1327284,1216072580
830500,2107858984,81359240,1.09834974e-11,17810826,1328784,1217401364
831000,2110704864,81359377,1.0983515895e-11,17815270,1329312,1218730676
831500,2143574580,81520496,1.1005266960000002e-11,17792100,1328312,1220058988
832000,2123177195,81360893,1.0983720555000001e-11,17864538,1327804,1221386792
832500,11250917801,81551368,1.100943468e-11,17743502,1329160,1222715952
833000,2102062660,81354675,1.0982881125000002e-11,17662450,1329312,1224045264
833500,2106066829,81359300,1.0983505500000001e-11,17812768,1328284,1225373548
834000,2120054590,81358060,1.09833381e-11,17772480,1328304,1226701852
834500,2088436043,81522548,1.100554398e-11,17858804,1330056,1228031908
835000,2088371986,81345521,1.0981645335e-11,17364940,1329304,1229361212
835500,2089330299,81362246,1.098390321e-11,17908510,1328312,1230689524
836000,2078030759,81356039,1.0983065265000002e-11,17706794,1328312,1232017836
836500,2071790093,81349479,1.0982179665000001e-11,17493568,1329804,1233347640
837000,2097348674,81504301,1.1003080635000001e-11,17265751,1329688,1234677328
837500,2111812805,81357249,1.0983228615000001e-11,17746126,1328804,1236006132
838000,2245754848,81359136,1.098348336e-11,17807438,1328304,1237334436
838500,2089021535,81360444,1.098365994e-11,17849955,1331152,1238665588
839000,2154828105,81519188,1.1005090380000001e-11,17749163,1328768,1239994356
839500,2125593837,81360257,1.0983634695e-11,17843878,1328812,1241323168
840000,2127640499,81358174,1.0983353490000001e-11,17776181,1329680,1242652848
840500,2091219619,81360586,1.0983679110000001e-11,17854576,1328296,1243981144
841000,4905480251,81537594,1.100757519e-11,17821838,1328776,1245309920
841500,2101622765,81354648,1.098287748e-11,17661579,1329652,1246639572
842000,2105128833,81343943,1.0981432305000002e-11,17313676,1328776,1247968348
842500,2099382144,81341878,1.0981153530000001e-11,17246562,1329284,1249297632
843000,2094331792,81342112,1.098118512e-11,17254166,1328276,1250625908
843500,2089058715,81505828,1.100328678e-11,17315386,1328744,1251954652
844000,2094375877,81356345,1.0983106575000001e-11,17716736,1329284,1253283936
844500,2096868119,81358795,1.0983437325e-11,17796363,1328284,1254612220
845000,2091231729,81358178,1.0983354030000002e-11,17776294,1328752,1255940972
845500,2075768185,81522475,1.1005534125e-11,17856417,1327276,1257268248
846000,2127000249,81357092,1.0983207420000002e-11,17741009,1328784,1258597032
846500,2090664231,81356673,1.0983150855000002e-11,17727404,1328312,1259925344
847000,2110588031,81358758,1.098343233e-11,17795161,1329284,1261254628
847500,2187916133,81357674,1.0983285990000001e-11,17759912,1328804,1262583432
848000,2121217543,81518590,1.100500965e-11,17730162,1328276,1263911708
848500,2128677114,81355941,1.0983052035e-11,17703600,1328776,1265240484
849000,2091957743,81354414,1.098284589e-11,17653962,1327804,1266568288
849500,8760745696,81598436,1.101578886e-11,17695379,1329260,1267897548
850000,2099412502,81348048,1.098198648e-11,17447077,1328688,1269226236
850500,2086928856,81342613,1.0981252755000001e-11,17270448,1328312,1270554548
851000,2088337484,81353084,1.098266634e-11,17610767,1329784,1271884332
851500,2086690555,81355515,1.0982994525000001e-11,17689335,1329680,1273214012
852000,2104849174,81521098,1.100534823e-11,17811656,1329312,1274543324
852500,2064452547,81356673,1.0983150855000002e-11,17727378,1328280,1275871604
853000,2087097408,81356369,1.0983109815e-11,17717527,1330180,1277201784
853500,2076477864,81355061,1.0982933235000001e-11,17675006,1327804,1278529588
854000,2071882440,81355243,1.0982957805e-11,17680902,1328304,1279857892
854500,2135440740,81519805,1.1005173675e-11,17769656,1328312,1281186204
855000,2090162781,81356336,1.098310536e-11,17716454,1330144,1282516348
855500,2122425849,81358860,1.0983446100000001e-11,17798480,1327812,1283844160
856000,2114047662,81358387,1.0983382245000001e-11,17783086,1328776,1285172936
856500,2112869115,81518616,1.100501316e-11,17730993,1330528,1286503464
857000,2116707711,81339214,1.098079389e-11,17159986,1327812,1287831276
857500,2112490108,81348836,1.098209286e-11,17472682,1329304,1289160580
858000,2113374430,81360848,1.098371448e-11,17863088,1328804,1290489384
858500,8714002875,81617993,1.1018429055e-11,17804993,1329180,1291818564
859000,2099269282,81360331,1.0983644685e-11,17846286,1328304,1293146868
859500,2090828858,81358353,1.0983377655000002e-11,17781986,1328312,1294475180
860000,2122222935,81359845,1.0983579075000001e-11,17830469,1329680,1295804860
860500,2067609934,81363419,1.0984061565e-11,17946628,1329812,1297134672
861000,2090111052,81523823,1.1005716105000001e-11,17900224,1328276,1298462948
861500,2086678591,81360654,1.098368829e-11,17856785,1330188,1299793136
862000,2083076064,81355853,1.0983040155e-11,17700748,1327804,1301120940
862500,2081076290,81359530,1.098353655e-11,17820242,1329312,1302450252
863000,2075657828,81519469,1.1005128315000001e-11,17758720,1327812,1303778064
863500,2158240733,81345146,1.0981594710000001e-11,17352767,1330020,1305108084
864000,2093458739,81340854,1.098101529e-11,17212824,1328804,1306436888
864500,2162730597,81342655,1.0981258425e-11,17271804,1329304,1307766192
865000,2127911905,81353776,1.098275976e-11,17633246,1327312,1309093504
865500,2115991734,81522247,1.1005503345000002e-11,17849007,1329688,1310423192
866000,2213921253,81362408,1.098392508e-11,17913789,1328784,1311751976
866500,2119110407,81357805,1.0983303675e-11,17764189,1328660,1313080636
867000,2268781558,81353829,1.0982766915000001e-11,17634970,1327804,1314408440
867500,5136967477,81520710,1.1005295850000001e-11,17799048,1329312,1315737752
868000,2084589585,81359629,1.0983549915e-11,17823454,1328796,1317066548
868500,2139580845,81356846,1.0983174210000002e-11,17733006,1328660,1318395208
869000,2101036325,81359059,1.0983472965e-11,17804926,1329312,1319724520
869500,2099316831,81520225,1.1005230375e-11,17783284,1328304,1321052824
870000,2093512603,81345136,1.098159336e-11,17352426,1329564,1322382388
870500,2088106513,81344191,1.0981465785e-11,17321718,1329784,1323712172
871000,2088400261,81353941,1.0982782035000001e-11,17638609,1328276,1325040448
871500,2081289995,81518941,1.1005057035000001e-11,17741554,1327804,1326368252
872000,2084824292,81356601,1.0983141135000002e-11,17725053,1328672,1327696924
872500,2080949129,81357175,1.0983218625e-11,17743706,1329312,1329026236
873000,2081012400,81357490,1.0983261150000001e-11,17753950,1328288,1330354524
873500,2074505233,81359310,1.098350685e-11,17813086,1328296,1331682820
874000,2169530005,81522347,1.1005516845000001e-11,17852251,1330180,1333013000
874500,2137901720,81361447,1.0983795345e-11,17882538,1329304,1334342304
875000,2102703332,81358784,1.098343584e-11,17795978,1328312,1335670616
875500,2098574577,81352107,1.0982534445000002e-11,17578978,1328804,1336999420
876000,2173225522,81511229,1.1004015915e-11,17490914,1329116,1338328536
876500,2099114867,81343110,1.0981319850000001e-11,17286153,1328688,1339657224
877000,2192943725,81360700,1.09836945e-11,17858270,1327804,1340985028
877500,2088074970,81359978,1.098359703e-11,17834804,1327812,1342312840
878000,3366332610,81360374,1.0983650490000001e-11,17847686,1328796,1343641636
878500,8705577295,81523295,1.1005644825000002e-11,17883057,1330672,1344972308
879000,2095953501,81521170,1.100535795e-11,17813992,1327796,1346300104
879500,2085852339,81362925,1.0983994875e-11,17930576,1328776,1347628880
880000,2116985414,81362231,1.0983901185000001e-11,17908020,1328796,1348957676
880500,2111983582,81361592,1.098381492e-11,17887263,1329180,1350286856
881000,2101701954,81522407,1.1005524945e-11,17854196,1328284,1351615140
881500,2080472795,81359030,1.098346905e-11,17803981,1330180,1352945320
882000,2082418676,81354740,1.0982889900000001e-11,17664552,1329656,1354274976
882500,2081973996,81339921,1.0980889335e-11,17182964,1328312,1355603288
883000,2098347970,81341260,1.09810701e-11,17226476,1328812,1356932100
883500,2101649237,81518903,1.1005051905e-11,17740329,1329680,1358261780
884000,2114063622,81359506,1.0983533310000001e-11,17819460,1329304,1359591084
884500,2105582679,81356629,1.0983144915000001e-11,17725952,1328312,1360919396
885000,2112321838,81355288,1.0982963880000001e-11,17682390,1329136,1362248532
885500,2158759623,81516407,1.1004714945e-11,17659214,1327804,1363576336
886000,2141163312,81359062,1.098347337e-11,17805039,1329268,1364905604
886500,2135493964,81357062,1.0983203369999999e-11,17740037,1330688,1366236292
887000,11234367875,81566822,1.101152097e-11,17719824,1329804,1367566096
887500,2098518175,81358290,1.098336915e-11,17779942,1329312,1368895408
888000,2092508245,81356107,1.0983074445000001e-11,17708995,1329652,1370225060
888500,2089006886,81346184,1.098173484e-11,17386484,1330556,1371555616
889000,2064010538,81484212,1.100036862e-11,16612388,1328804,1372884420
889500,2096661365,81325769,1.0978978815000002e-11,16723007,1330172,1374214592
890000,2082474283,81335612,1.0980307620000001e-11,17042896,1328304,1375542896
890500,2342349549,81334995,1.0980224325e-11,17022838,1328296,1376871192
891000,2100682594,81501112,1.100265012e-11,17162116,1328784,1378199976
891500,2181087224,81337459,1.0980556965e-11,17102944,1327312,1379527288
892000,2152106229,81338716,1.0980726660000001e-11,17143775,1329680,1380856968
892500,2162062419,81339460,1.0980827100000001e-11,17167974,1327812,1382184780
893000,2145594665,81338892,1.098075042e-11,17149512,1328812,1383513592
893500,2132319968,81500124,1.100251674e-11,17130006,1327804,1384841396
894000,2149748375,81338504,1.098069804e-11,17136911,1328172,1386169568
894500,2164973052,81339641,1.0980851535000001e-11,17173854,1328296,1387497864
895000,3336551861,81340336,1.0980945360000001e-11,17196424,1329288,1388827152
895500,2110579551,81516060,1.10046681e-11,17121991,1329188,1390156340
896000,2110575154,81324757,1.0978842195e-11,16690121,1327784,1391484124
896500,2108931143,81325696,1.0978968960000001e-11,16720648,1329652,1392813776
897000,2091419941,81327259,1.0979179965e-11,16771432,1328312,1394142088
897500,2097583205,81340263,1.0980935505e-11,17194076,1328812,1395470900
898000,2069030432,81504121,1.1003056335e-11,17259922,1328304,1396799204
898500,2106487402,81341252,1.0981069020000001e-11,17226217,1329672,1398128876
899000,2105086149,81343084,1.098131634e-11,17285728,1328812,1399457688
899500,2109219056,81340408,1.0980955080000002e-11,17198766,1328312,1400786000
900000,2088940729,81502602,1.100285127e-11,17210555,1329664,1402115664
900500,2168808176,81342785,1.0981275975000001e-11,17276036,1328812,1403444476
901000,2120964309,81336402,1.098041427e-11,17068578,1327776,1404772252
901500,2097221883,81343167,1.0981327545000001e-11,17287869,1328776,1406101028
902000,2151363004,81342769,1.0981273815e-11,17275516,1327776,1407428804
902500,2148515166,81503936,1.100303136e-11,17253893,1329644,1408758448
903000,2130181451,81347445,1.0981905075e-11,17427489,1329272,1410087720
903500,2098459161,81358809,1.0983439215000001e-11,17796820,1328768,1411416488
904000,2134960870,81358243,1.0983362805000001e-11,17778420,1327776,1412744264
904500,8737462670,81520039,1.1005205265000002e-11,17777241,1328264,1414072528
905000,2102648644,81345444,1.0981634940000001e-11,17362453,1328776,1415401304
905500,2098910843,81513089,1.1004267015e-11,17551365,1329268,1416730572
906000,2095555243,81356339,1.0983105765000001e-11,17716534,1329288,1418059860
906500,2086484582,81358286,1.098336861e-11,17779802,1328768,1419388628
907000,2089143256,81357663,1.0983284505e-11,17759557,1329272,1420717900
907500,2086864786,81517608,1.1004877080000001e-11,17698231,1328284,1422046184
908000,2077245998,81359923,1.0983589605000001e-11,17833010,1327784,1423373968
908500,2074751883,81359550,1.098353925e-11,17820903,1328760,1424702728
909000,2098860012,81357218,1.0983224430000001e-11,17745099,1328768,1426031496
909500,2190547537,81354815,1.0982900025000002e-11,17667014,1327276,1427358772
910000,2105799301,81518800,1.1005038000000001e-11,17736974,1329312,1428688084
910500,2102236353,81361316,1.098377766e-11,17878289,1329764,1430017848
911000,2102873432,81351315,1.0982427525e-11,17553244,1329660,1431347508
911500,2154455497,81347064,1.0981853640000001e-11,17415084,1328296,1432675804
912000,2125576725,81340510,1.098096885e-11,17202078,1329304,1434005108
912500,2117044272,81504288,1.100307888e-11,17265355,1328768,1435333876
913000,2178148763,81341921,1.0981159335000001e-11,17247952,1328776,1436662652
913500,2306205406,81352328,1.0982564280000002e-11,17586162,1328284,1437990936
914000,2125749415,81355705,1.0983020175e-11,17695323,1329284,1439320220
914500,6596850566,81583403,1.1013759405e-11,17732740,1328776,1440648996
915000,2112296986,81357449,1.0983255615e-11,17752608,1327804,1441976800
915500,2138999304,81358998,1.098346473e-11,17802961,1328284,1443305084
916000,2089143073,81354426,1.0982847510000001e-11,17654358,1327812,1444632896
916500,2090669042,81517015,1.1004797025e-11,17678962,1329312,1445962208
917000,2080607455,81355700,1.09830195e-11,17695766,1327284,1447289492
917500,2085624915,81354729,1.0982888415e-11,17664226,1327284,1448616776
918000,2080944205,81356776,1.0983164760000001e-11,17730742,1329284,1449946060
918500,2087750876,81356206,1.098308781e-11,17712198,1328284,1451274344
919000,2081960298,81518992,1.100506392e-11,17743225,1328780,1452603124
919500,2082849695,81353373,1.0982705355000001e-11,17620156,1329660,1453932784
920000,2126488549,81339984,1.098089784e-11,17184985,1327784,1455260568
920500,2067883585,81346755,1.0981811925000002e-11,17405054,1329812,1456590380
921000,2082590269,81517694,1.100488869e-11,17701021,1328284,1457918664
921500,2116751500,81357410,1.098325035e-11,17751349,1329276,1459247940
922000,2075414693,81357784,1.0983300840000001e-11,17763496,1328776,1460576716
922500,2099904040,81359572,1.0983542220000001e-11,17821623,1329284,1461906000
923000,2114112628,81356654,1.098314829e-11,17726780,1329276,1463235276
923500,2096324962,81517144,1.100481444e-11,17683176,1328276,1464563552
924000,2200956951,81358734,1.0983429090000001e-11,17794381,1329284,1465892836
924500,3365077127,81356684,1.098315234e-11,17727750,1327812,1467220648
925000,3381025100,81520592,1.1005279920000001e-11,17795215,1329284,1468549932
925500,2153097986,81362234,1.0983901590000001e-11,17908127,1328280,1469878212
926000,2095954673,81355829,1.0983036915000002e-11,17699948,1328296,1471206508
926500,2101082924,81355332,1.0982969820000002e-11,17683176,1328312,1472534820
927000,2095929731,81356155,1.0983080925e-11,17710564,1328276,1473863096
927500,2091955994,81514347,1.1004436845e-11,17592250,1326784,1475189880
928000,2085799218,81351450,1.0982445750000002e-11,17557647,1329660,1476519540
928500,2082920617,81338644,1.0980716940000001e-11,17141444,1328284,1477847824
929000,2076572358,81348045,1.0981986075e-11,17446976,1328312,1479176136
929500,2081644193,81517200,1.1004822e-11,17684980,1328812,1480504948
930000,2105896003,81356384,1.098311184e-11,17717984,1327768,1481832716
930500,2206968289,81359896,1.0983585960000002e-11,17832119,1328784,1483161500
931000,2114734667,81356131,1.0983077685e-11,17709786,1327804,1484489304
931500,2124118231,81355415,1.0982981025e-11,17686506,1328304,1485817608
932000,2132989208,81355909,1.0983047715e-11,17702555,1328284,1487145892
932500,2119606886,81356033,1.0983064455e-11,17706606,1328784,1488474676
933000,2183880230,81355876,1.0983043259999999e-11,17701504,1328304,1489802980
933500,11260941574,81615499,1.1018092365e-11,17723951,1328280,1491131260
934000,2097605503,81359217,1.0983494295e-11,17810084,1328304,1492459564
934500,2089895118,81360347,1.0983646845e-11,17846807,1329680,1493789244
935000,2064944977,81356222,1.098308997e-11,17712725,1328284,1495117528
935500,2069078590,81519446,1.1005125210000001e-11,17757975,1329280,1496446808
936000,2086035759,81346020,1.0981712700000002e-11,17381181,1329188,1497775996
936500,2085222293,81339035,1.0980769725000001e-11,17154156,1328284,1499104280
937000,2083303915,81342727,1.0981268145000001e-11,17274140,1329776,1500434056
937500,2077763614,81339142,1.098078417e-11,17157636,1328284,1501762340
938000,2117525267,81507939,1.1003571765e-11,17384000,1328276,1503090616
938500,2173496974,81358500,1.09833975e-11,17786781,1328784,1504419400
939000,2083178898,81358069,1.0983339315000002e-11,17772119,1328276,1505747676
939500,2141834267,81358720,1.09834272e-11,17793898,1328284,1507075960
940000,2109757372,81520527,1.1005271145000002e-11,17793103,1328784,1508404744
940500,2105787861,81359708,1.0983560580000001e-11,17826008,1328312,1509733056
941000,2222859511,81355152,1.098294552e-11,17677943,1329276,1511062332
941500,2126994225,81356211,1.0983088485000002e-11,17712385,1329276,1512391608
942000,3370464285,81356591,1.0983139785e-11,17724713,1328276,1513719884
942500,8765744009,81632000,1.102032e-11,17734269,1329276,1515049160
943000,2100996561,81356870,1.0983177450000001e-11,17733791,1327776,1516376936
943500,2087957594,81354090,1.098280215e-11,17643429,1326784,1517703720
944000,2093710944,81359790,1.098357165e-11,17828678,1328768,1519032488
944500,2091446964,81523732,1.100570382e-11,17897249,1329136,1520361624
945000,2083031400,81352584,1.098259884e-11,17594486,1328268,1521689892
945500,2108495058,81359498,1.0983532230000001e-11,17819212,1328812,1523018704
946000,2087208924,81346090,1.0981722150000001e-11,17383434,1328812,1524347516
946500,2080000310,81349319,1.0982158065e-11,17488376,1328812,1525676328
947000,2092976449,81511981,1.1004117435000002e-11,17515348,1329276,1527005604
947500,2186908753,81345536,1.098164736e-11,17365435,1328780,1528334384
948000,2101629668,81346385,1.0981761975e-11,17393026,1328760,1529663144
948500,2112463275,81344124,1.0981456740000002e-11,17319553,1327780,1530990924
949000,2107030252,81508912,1.100370312e-11,17415615,1329284,1532320208
949500,2126159899,81345735,1.0981674225000002e-11,17371910,1328804,1533649012
950000,2116371847,81347927,1.0981970145e-11,17443148,1328768,1534977780
950500,2117996563,81343402,1.098135927e-11,17296080,1328276,1536306056
951000,11274003059,81614183,1.1017914705e-11,17155236,1328804,1537634860
951500,2098550333,81341968,1.098116568e-11,17248832,1328812,1538963672
952000,2095756956,81355947,1.0983052845e-11,17703803,1330180,1540293852
952500,2069453798,81341809,1.0981144215000001e-11,17244303,1328268,1541622120
953000,2068811283,81520024,1.100520324e-11,17776753,1329772,1542951892
953500,2088270071,81359810,1.098357435e-11,17829355,1329672,1544281564
954000,2083702918,81354537,1.0982862495000002e-11,17657964,1328312,1545609876
954500,2085739192,81357036,1.098319986e-11,17739196,1328784,1546938660
955000,2084197454,81354852,1.0982905020000001e-11,17668198,1328796,1548267456
955500,2081303143,81519704,1.100516004e-11,17766339,1330188,1549597644
956000,2066289591,81358965,1.0983460275e-11,17801884,1330312,1550927956
956500,2095275078,81356971,1.0983191085e-11,17737066,1327804,1552255760
957000,2097080066,81355118,1.0982940930000001e-11,17676854,1330048,1553585808
957500,2149254035,81339553,1.0980839655e-11,17170999,1327772,1554913580
958000,2102854918,81501615,1.1002718025000002e-11,17178472,1328304,1556241884
958500,2116543517,81341694,1.098112869e-11,17240584,1328812,1557570696
959000,2116359354,81342986,1.098130311e-11,17282559,1329188,1558899884
959500,2203968899,81355721,1.0983022335000001e-11,17696448,1328312,1560228196
960000,2164433928,81357738,1.098329463e-11,17762008,1327796,1561555992
960500,11325475664,81680537,1.1026872495e-11,17733886,1329312,1562885304
961000,2144908267,81356689,1.0983153015000001e-11,17727923,1328284,1564213588
961500,2106863533,81355940,1.09830519e-11,17703587,1328276,1565541864
962000,2090834303,81354038,1.098279513e-11,17641739,1327768,1566869632
962500,2092183217,81517588,1.1004874380000001e-11,17697576,1328776,1568198408
963000,2088046749,81356143,1.0983079305e-11,17710176,1328784,1569527192
963500,2082396415,81354413,1.0982845755e-11,17653938,1327804,1570854996
964000,2151147758,81356937,1.0983186495e-11,17735323,1328260,1572183256
964500,2178839059,81356166,1.098308241e-11,17710913,1327784,1573511040
965000,2083938343,81512258,1.100415483e-11,17524364,1329160,1574840200
965500,2253570441,81342621,1.0981253835000001e-11,17270694,1328796,1576168996
966000,2221885252,81355900,1.0983046500000001e-11,17702250,1327812,1577496808
966500,2106859288,81355946,1.098305271e-11,17703762,1328804,1578825612
967000,2120948448,81518513,1.1004999255e-11,17727664,1328812,1580154424
967500,2128441811,81357084,1.098320634e-11,17740729,1328284,1581482708
968000,2238669199,81358220,1.09833597e-11,17777678,1328776,1582811484
968500,4855817596,81356751,1.0983161385e-11,17729936,1328812,1584140296
969000,8793897344,81665406,1.1024829810000002e-11,17768096,1328804,1585469100
969500,2099674231,81356577,1.0983137895e-11,17724276,1327804,1586796904
970000,2098093975,81356580,1.09831383e-11,17724372,1328312,1588125216
970500,2091982990,81358308,1.098337158e-11,17780534,1329284,1589454500
971000,2100661476,81357108,1.0983209580000001e-11,17741543,1329276,1590783776
971500,2088524470,81515850,1.100463975e-11,17641104,1328312,1592112088
972000,2083310627,81359201,1.0983492134999999e-11,17809562,1328804,1593440892
972500,2084652529,81356236,1.098309186e-11,17713179,1329644,1594770536
973000,2078603055,81353927,1.0982780145000001e-11,17638153,1330188,1596100724
973500,2085954822,81512850,1.1004234750000001e-11,17543608,1329304,1597430028
974000,2084232844,81361487,1.0983800745e-11,17883852,1329304,1598759332
974500,2077186820,81358393,1.0983383055e-11,17783303,1329152,1600088484
975000,2081257858,81343421,1.0981361835e-11,17296714,1329268,1601417752
975500,2083091407,81354361,1.0982838735000001e-11,17652264,1327812,1602745564
976000,2068471372,81518852,1.1005045020000001e-11,17738658,1328312,1604073876
976500,2065404667,81357580,1.0983273300000001e-11,17756200,1327812,1605401688
977000,2095600786,81356020,1.09830627e-11,17706152,1327812,1606729500
977500,2105507719,81357202,1.098322227e-11,17744577,1329688,1608059188
978000,2086829614,81518461,1.1004992235000001e-11,17725950,1327812,1609387000
978500,2127471491,81355408,1.0982980080000001e-11,17686280,1327812,1610714812
979000,2088428441,81358053,1.0983337155000001e-11,17772232,1328312,1612043124
979500,2112404893,81355163,1.0982947005000002e-11,17678323,1329188,1613372312
980000,11222521047,81622497,1.1019037095e-11,17425437,1329688,1614702000
980500,2098013685,81353423,1.0982712105e-11,17621774,1329304,1616031304
981000,2101085148,81344700,1.09815345e-11,17338262,1329312,1617360616
981500,2101862538,81357028,1.098319878e-11,17738941,1329784,1618690400
982000,2084316628,81356408,1.098311508e-11,17718789,1328284,1620018684
982500,2084540519,81520059,1.1005207965e-11,17777880,1328284,1621346968
983000,2089122237,81358964,1.098346014e-11,17801836,1327784,1622674752
983500,2088596063,81362520,1.0983940200000002e-11,17917430,1329776,1624004528
984000,2072639422,81359351,1.0983512385000001e-11,17814413,1328760,1625333288
984500,2097119115,81519453,1.1005126155e-11,17758215,1328276,1626661564
985000,2108985182,81355643,1.0983011805e-11,17693927,1328284,1627989848
985500,2174718165,81359825,1.0983576375000001e-11,17829842,1329284,1629319132
986000,2107058532,81357248,1.098322848e-11,17746090,1329304,1630648436
986500,2184852261,81356928,1.098318528e-11,17735686,1329304,1631977740
987000,2110896847,81355338,1.0982970630000002e-11,17684000,1328312,1633306052
987500,2161813661,81356791,1.0983166785e-11,17731208,1328312,1634634364
988000,2092801446,81354293,1.0982829555e-11,17650048,1328796,1635963160
988500,3363723101,81346937,1.0981836495e-11,17410985,1329688,1637292848
989000,8705472181,81598482,1.1015795070000001e-11,17170190,1328812,1638621660
989500,2094230091,81345678,1.098166653e-11,17370046,1327812,1639949472
990000,2079117222,81359367,1.0983514545000002e-11,17814937,1329784,1641279256
990500,2070419651,81360333,1.0983644955000001e-11,17846340,1329812,1642609068
991000,2068841680,81515928,1.100465028e-11,17643632,1329784,1643938852
991500,2081489872,81354910,1.098291285e-11,17670094,1329312,1645268164
992000,2084021765,81352517,1.0982589795e-11,17592315,1329688,1646597852
992500,2084608537,81353854,1.098277029e-11,17635760,1329312,1647927164
993000,2072505634,81355945,1.0983052575e-11,17703732,1328304,1649255468
993500,2093157798,81515621,1.1004608835000001e-11,17633665,1329188,1650584656
994000,2105304980,81351866,1.0982501910000002e-11,17571174,1327796,1651912452
994500,2219728753,81354125,1.0982806875e-11,17644568,1328312,1653240764
995000,2091435178,81352648,1.0982607479999999e-11,17596560,1328304,1654569068
995500,2120409352,81517742,1.100489517e-11,17702582,1331064,1655900132
996000,2153964730,81335978,1.098035703e-11,17054797,1329132,1657229264
996500,2107305382,81341439,1.0981094265e-11,17232271,1328780,1658558044
997000,2126201901,81345868,1.098169218e-11,17376224,1329304,1659887348
997500,8817339152,81581556,1.1013510060000001e-11,17672732,1328276,1661215624
998000,2100513890,81354753,1.0982891654999999e-11,17664988,1328768,1662544392
998500,2086641108,81352522,1.098259047e-11,17592485,1328284,1663872676
999000,2090193392,81353990,1.098278865e-11,17640193,1328776,1665201452
999500,2083929672,81513632,1.1004340320000001e-11,17569014,1327768,1666529220
1000000,2102485049,81354281,1.0982827935000002e-11,17649664,1328804,1667858024
1000500,2064913656,81352909,1.0982642715e-11,17605077,1328776,1669186800
1001000,2081571906,81353751,1.0982756385e-11,17632410,1328288,1670515088
1001500,2080394750,81343480,1.09813698e-11,17297925,1328784,1671843872
1002000,2084642117,81504705,1.1003135175e-11,17278878,1328812,1673172684
1002500,2109268535,81340744,1.098100044e-11,17209698,1328812,1674501496
1003000,2101915110,81354776,1.098289476e-11,17665748,1328284,1675829780
1003500,2093657609,81353508,1.0982723580000001e-11,17624516,1329812,1677159592
1004000,2106969054,81519077,1.1005075395e-11,17745995,1329180,1678488772
1004500,2193484365,81353163,1.0982677005000001e-11,17613310,1327812,1679816584
1005000,2171339272,81353834,1.0982767590000002e-11,17635110,1328312,1681144896
1005500,2192969032,81361821,1.0983845835000001e-11,17894714,1328784,1682473680
1006000,8714349879,81579921,1.1013289335000002e-11,17619607,1328624,1683802304
1006500,2085703109,81339742,1.0980865170000002e-11,17177146,1328252,1685130556
1007000,2092170249,81337911,1.0980617985e-11,17117632,1328304,1686458860
1007500,2086539956,81342852,1.098128502e-11,17278227,1328280,1687787140
1008000,2081712488,81514876,1.100450826e-11,17609428,1329776,1689116916
1008500,2089199122,81357766,1.098329841e-11,17762922,1328788,1690445704
1009000,2084376204,81358357,1.0983378194999999e-11,17782114,1328296,1691774000
1009500,2079355833,81359833,1.0983577454999999e-11,17830098,1328812,1693102812
1010000,2052265024,81357432,1.098325332e-11,17752072,1328276,1694431088
1010500,2074943081,81520170,1.1005222950000001e-11,17781502,1328312,1695759400
1011000,2462610466,81354626,1.098287451e-11,17660853,1328284,1697087684
1011500,2100518626,81354738,1.098288963e-11,17664510,1328296,1698415980
1012000,2087955074,81358334,1.098337509e-11,17781363,1329264,1699745244
1012500,2111285480,81518611,1.1005012485e-11,17730833,1329160,1701074404
1013000,2118612319,81355128,1.0982942280000002e-11,17677194,1328276,1702402680
1013500,2114126142,81350317,1.0982292795000001e-11,17520809,1328660,1703731340
1014000,2231504322,81338254,1.098066429e-11,17128034,1329304,1705060644
1014500,2220692011,81344492,1.098150642e-11,17331508,1328304,1706388948
1015000,2220676600,81352626,1.0982604510000001e-11,17595849,1328284,1707717232
1015500,6599025471,81359695,1.0983558825e-11,17825610,1328804,1709046036
1016000,2101141395,81516163,1.1004682005e-11,17651266,1328312,1710374348
1016500,2094895342,81359006,1.098346581e-11,17803210,1328312,1711702660
1017000,2085674549,81357406,1.0983249810000002e-11,17751212,1328812,1713031472
1017500,2081735199,81356333,1.0983104955e-11,17716354,1330160,1714361632
1018000,2086452297,81519608,1.100514708e-11,17763222,1328804,1715690436
1018500,2092194994,81356770,1.0983163950000001e-11,17730544,1328304,1717018740
1019000,2063107240,81356054,1.098306729e-11,17707285,1328644,1718347384
1019500,2103938865,81354536,1.0982862360000001e-11,17657923,1328772,1719676156
1020000,2079850450,81358825,1.0983441375e-11,17797328,1328812,1721004968
1020500,2085680195,81522267,1.1005506045e-11,17849664,1328288,1722333256
1021000,2082698920,81354779,1.0982895165e-11,17665820,1330160,1723663416
1021500,2077372545,81339700,1.09808595e-11,17175768,1329304,1724992720
1022000,2101142411,81358797,1.0983437595000001e-11,17796429,1330680,1726323400
1022500,2105877628,81356912,1.098318312e-11,17735150,1327304,1727650704
1023000,2136933556,81357229,1.0983225915000001e-11,17745476,1329304,1728980008
1023500,2107437775,81359785,1.0983570975000001e-11,17828531,1330180,1730310188
1024000,2105810623,81355269,1.0982961315000002e-11,17681758,1328312,1731638500
1024500,2121801909,81357579,1.0983273165000001e-11,17756841,1330180,1732968680
1025000,2094278261,81519760,1.1005167600000001e-11,17768178,1328796,1734297476
1025500,2117839093,81360536,1.098367236e-11,17852953,1328428,1735625904
1026000,4938733031,81356054,1.098306729e-11,17707259,1329276,1736955180
1026500,2104955232,81519662,1.100515437e-11,17764244,1327784,1738282964
1027000,2081783576,81355549,1.0982999115000001e-11,17690871,1329280,1739612244
1027500,2141170955,81357421,1.0983251835000001e-11,17751711,1329284,1740941528
1028000,2109487133,81355484,1.098299034e-11,17688758,1327784,1742269312
1028500,2088330515,81346427,1.0981767645e-11,17394396,1330536,1743599848
1029000,2095734036,81488727,1.1000978145e-11,16759602,1329312,1744929160
1029500,2090724792,81326067,1.0979019045e-11,16732701,1328784,1746257944
1030000,2086996149,81326340,1.09790559e-11,16741554,1328776,1747586720
1030500,2152240461,81334192,1.098011592e-11,16996773,1328272,1748914992
1031000,2299636469,81502727,1.1002868145e-11,17214598,1327784,1750242776
1031500,2108594562,81340425,1.0980957375e-11,17199347,1327276,1751570052
1032000,2111620023,81342549,1.0981244115000001e-11,17268361,1329272,1752899324
1032500,2112940792,81341609,1.0981117215e-11,17237802,1327804,1754227128
1033000,2135203055,81504904,1.1003162040000001e-11,17285354,1330312,1755557440
1033500,2159973918,81342796,1.0981277460000001e-11,17276393,1328776,1756886216
1034000,2224052397,81342392,1.098122292e-11,17263267,1327760,1758213976
1034500,3526146466,81343519,1.0981375065e-11,17299890,1328776,1759542752
1035000,11453818298,81617477,1.1018359395000001e-11,17262282,1329296,1760872048
1035500,2096178234,81343304,1.098134604e-11,17292902,1328312,1762200360
1036000,2089522931,81328613,1.0979362754999999e-11,16815438,1328288,1763528648
1036500,2085914086,81333634,1.098004059e-11,16978630,1327784,1764856432
1037000,2083857511,81510031,1.1003854185e-11,17451979,1329180,1766185612
1037500,2084965750,81345348,1.098162198e-11,17359311,1328272,1767513884
1038000,2075949229,81345880,1.0981693800000001e-11,17376624,1327780,1768841664
1038500,2131230567,81350052,1.0982257020000002e-11,17512190,1329804,1770171468
1039000,2118993350,81511630,1.1004070050000001e-11,17403774,1328812,1771500280
1039500,2098861252,81346961,1.0981839735000002e-11,17411764,1329804,1772830084
1040000,2095574334,81346621,1.0981793835e-11,17400700,1329644,1774159728
1040500,2098727411,81349667,1.0982205045000002e-11,17499689,1329264,1775488992
1041000,2096551334,81338392,1.098068292e-11,17133268,1328804,1776817796
1041500,2112396978,81506583,1.1003388705e-11,17240716,1328812,1778146608
1042000,2115007519,81353840,1.0982768399999999e-11,17635309,1328688,1779475296
1042500,2242346087,81356435,1.0983118725e-11,17719666,1328796,1780804092
1043000,4878426685,81356999,1.0983194865e-11,17737992,1328796,1782132888
1043500,6594482537,81623828,1.101921678e-11,17835911,1329688,1783462576
1044000,2089996050,81359024,1.098346824e-11,17803798,1329764,1784792340
1044500,2084946463,81358459,1.0983391965000002e-11,17785444,1328312,1786120652
1045000,2089193597,81360392,1.098365292e-11,17848255,1329188,1787449840
1045500,2086608720,81523569,1.1005681815e-11,17792750,1329312,1788779152
1046000,2086088216,81355304,1.0982966040000002e-11,17682878,1329632,1790108784
1046500,2081990634,81357032,1.098319932e-11,17739063,1329264,1791438048
1047000,2084162394,81351207,1.0982412945000001e-11,17549752,1329652,1792767700
1047500,2069989246,81342214,1.098119889e-11,17257460,1329268,1794096968
1048000,2083416969,81502469,1.1002833315000001e-11,17106978,1328284,1795425252
1048500,2076512561,81347758,1.098194733e-11,17437649,1328784,1796754036
1049000,2108035472,81356783,1.0983165704999999e-11,17730974,1328284,1798082320
1049500,2126903664,81346738,1.098180963e-11,17404513,1328784,1799411104
1050000,2104802281,81356838,1.098317313e-11,17732751,1328784,1800739888
1050500,2257881294,81521814,1.100544489e-11,17735725,1328276,1802068164
1051000,2111449934,81353570,1.098273195e-11,17626555,1327784,1803395948
1051500,2115777442,81354478,1.098285453e-11,17655086,1328296,1804724244
1052000,8742538163,81607196,1.101697146e-11,17682414,1328304,1806052548
1052500,2102079863,81356230,1.098309105e-11,17713001,1329180,1807381728
1053000,2091701794,81356487,1.0983125745e-11,17721348,1328812,1808710540
1053500,2087571940,81357220,1.0983224700000001e-11,17745157,1330160,1810040700
1054000,2087462142,81355825,1.0983036375000001e-11,17699846,1328312,1811369012
1054500,2123864378,81516830,1.100477205e-11,17474521,1328188,1812697200
1055000,2087507018,81340954,1.098102879e-11,17216534,1328812,1814026012
1055500,2087878541,81346618,1.0981793430000001e-11,17400602,1328304,1815354316
1056000,2081684677,81357504,1.098326304e-11,17754398,1328776,1816683092
1056500,2074227709,81356034,1.098306459e-11,17706631,1329280,1818012372
1057000,2070743863,81523580,1.1005683300000002e-11,17693876,1328776,1819341148
1057500,2081216414,81357270,1.098323145e-11,17746790,1328276,1820669424
1058000,2090120712,81361061,1.0983743235e-11,17869995,1330284,1821999708
1058500,2148528695,81356877,1.0983178395000002e-11,17734034,1329284,1823328992
1059000,2113043594,81523086,1.1005616610000002e-11,17677825,1327772,1824656764
1059500,2161419701,81356690,1.098315315e-11,17727954,1328768,1825985532
1060000,2147920139,81356562,1.098313587e-11,17723780,1327784,1827313316
1060500,2092577932,81358588,1.0983409380000001e-11,17789635,1328268,1828641584
1061000,3388662131,81524033,1.1005744455000002e-11,17708613,1328768,1829970352
1061500,11352285001,81524326,1.100578401e-11,17718135,1328276,1831298628
1062000,2085053389,81354141,1.0982809035e-11,17645090,1328268,1832626896
1062500,2084909816,81356182,1.0983084570000002e-11,17711421,1329276,1833956172
1063000,2090470882,81336854,1.098047529e-11,17083258,1328660,1835284832
1063500,2083964735,81500918,1.1002623929999999e-11,16957374,1327812,1836612644
1064000,2083727380,81341960,1.0981164599999999e-11,17248246,1328304,1837940948
1064500,2081692878,81341534,1.0981107090000002e-11,17235373,1328272,1839269220
1065000,2080920350,81339129,1.0980782415e-11,17157221,1328284,1840597504
1065500,3312537010,81331545,1.0979758575000001e-11,16910727,1329784,1841927288
1066000,2084820142,81505135,1.1003193225e-11,16995180,1328784,1843256072
1066500,2081200395,81341955,1.0981163925000001e-11,17249052,1328812,1844584884
1067000,2088451298,81342161,1.0981191735e-11,17255747,1329164,1845914048
1067500,2086920413,81341637,1.0981120995000002e-11,17238733,1328764,1847242812
1068000,2058647209,81512633,1.1004205455e-11,17238868,1328812,1848571624
1068500,2070205800,81339832,1.098087732e-11,17180057,1328276,1849899900
1069000,2073696329,81339767,1.0980868545000001e-11,17177928,1328312,1851228212
1069500,2091534247,81337778,1.098060003e-11,17113310,1327804,1852556016
1070000,2076415852,81510703,1.1003944905e-11,17176142,1328312,1853884328
1070500,2108235665,81341989,1.0981168515000001e-11,17250166,1328312,1855212640
1071000,2096377313,81330156,1.097957106e-11,16865583,1328664,1856541304
1071500,2134708657,81326985,1.0979142975000001e-11,16762538,1328784,1857870088
1072000,2108022494,81325405,1.0978929675e-11,16711174,1328804,1859198892
1072500,2110202525,81494524,1.1001760740000001e-11,16650340,1329148,1860528040
1073000,4843072788,81338838,1.0980743130000002e-11,17147754,1328312,1861856352
1073500,6586038531,81547455,1.1008906425e-11,17259152,1329312,1863185664
1074000,2100515558,81342452,1.098123102e-11,17265198,1329304,1864514968
1074500,2102105019,81340061,1.0980908235000002e-11,17187509,1330152,1865845120
1075000,2098900061,81342030,1.098117405e-11,17251486,1328804,1867173924
1075500,2084298099,81345588,1.0981654380000001e-11,17367142,1329312,1868503236
1076000,2090718993,81512021,1.1004122835000001e-11,17218992,1328288,1869831524
1076500,2087720926,81342587,1.0981249245000001e-11,17268578,1328804,1871160328
1077000,2086521472,81341810,1.098114435e-11,17244333,1329160,1872489488
1077500,2083940777,81339693,1.0980858555e-11,17175529,1329272,1873818760
1078000,2084446901,81517660,1.1004884100000001e-11,17303041,1329680,1875148440
1078500,2078212523,81343196,1.098133146e-11,17289397,1329672,1876478112
1079000,2110999180,81358902,1.098345177e-11,17799819,1329784,1877807896
1079500,2057370949,81358297,1.0983370095000001e-11,17780158,1328296,1879136192
1080000,2248405014,81358207,1.0983357945e-11,17777234,1328304,1880464496
1080500,2280724704,81532221,1.1006849835e-11,17776275,1327672,1881792168
1081000,2100419397,81356508,1.098312858e-11,17722026,1328776,1883120944
1081500,2305160733,81358296,1.098336996e-11,17780126,1329804,1884450748
1082000,2189577772,81356022,1.098306297e-11,17706225,1328180,1885778928
1082500,2152415240,81530995,1.1006684325e-11,17736412,1328804,1887107732
1083000,2104384431,81356357,1.0983108195000002e-11,17717134,1328312,1888436044
1083500,2117572487,81355448,1.0982985479999999e-11,17687593,1329172,1889765216
1084000,14390318385,81651864,1.102300164e-11,17705164,1328304,1891093520
1084500,2095403610,81352256,1.0982554560000001e-11,17583831,1328688,1892422208
1085000,2084837735,81340853,1.0981015155e-11,17213236,1328804,1893751012
1085500,2087634978,81350087,1.0982261745000001e-11,17513354,1328812,1895079824
1086000,2067103089,81521163,1.1005357005e-11,17416894,1328784,1896408608
1086500,2064505521,81346203,1.0981737405e-11,17387117,1328768,1897737376
1087000,2100535226,81356295,1.0983099825e-11,17715106,1328784,1899066160
1087500,2154970023,81357931,1.0983320685000002e-11,17768260,1329776,1900395936
1088000,2101417303,81531133,1.1006702955e-11,17740915,1329284,1901725220
1088500,2089938351,81354100,1.09828035e-11,17643754,1328268,1903053488
1089000,2212479472,81356093,1.0983072555e-11,17707524,1328804,1904382292
1089500,2100620469,81355039,1.0982930265e-11,17674272,1327784,1905710076
1090000,2164184720,81358859,1.0983445965e-11,17798430,1330276,1907040352
1090500,2184839105,81536886,1.1007479610000001e-11,17828650,1327804,1908368156
1091000,2100523490,81354284,1.0982828340000002e-11,17649748,1327804,1909695960
1091500,2120691328,81355590,1.098300465e-11,17692178,1328768,1911024728
1092000,2169734999,81354676,1.0982881260000001e-11,17662486,1328284,1912353012
1092500,4961467286,81534052,1.1007097020000001e-11,17736538,1329268,1913682280
1093000,2115717778,81350592,1.098232992e-11,17529757,1329660,1915011940
1093500,2108970295,81338716,1.0980726660000001e-11,17143807,1328256,1916340196
1094000,2109012722,81341767,1.0981138545e-11,17242932,1328812,1917669008
1094500,2099105134,81338047,1.0980636345e-11,17122036,1327812,1918996820
1095000,2100896637,81353388,1.098270738e-11,17620624,1328804,1920325624
1095500,2090920107,81361687,1.0983827745e-11,17890328,1327812,1921653436
1096000,2082270698,81356302,1.098310077e-11,17715330,1329304,1922982740
1096500,2085941369,81532986,1.100695311e-11,17701924,1329296,1924312036
1097000,2104156464,81355436,1.098298386e-11,17687170,1328284,1925640320
1097500,2133624346,81358140,1.0983348900000001e-11,17775054,1329160,1926969480
1098000,2103891489,81357946,1.098332271e-11,17768760,1329312,1928298792
1098500,2100809912,81357498,1.098326223e-11,17754202,1328804,1929627596
1099000,2103994191,81353715,1.0982751525e-11,17631251,1328276,1930955872
1099500,2095584461,81356095,1.0983072825000001e-11,17708600,1328312,1932284184
1100000,2141335913,81356188,1.098308538e-11,17711610,1328284,1933612468
1100500,2149130281,81364788,1.098424638e-11,17991117,1328756,1934941224
1101000,2163318356,81517599,1.1004875865e-11,17201819,1327784,1936269008
1101500,3330300233,81349276,1.0982152260000002e-11,17485940,1328796,1937597804
1102000,11502386578,81628127,1.1019797145000002e-11,17767371,1329188,1938926992
1102500,2116139816,81357336,1.0983240360000001e-11,17748952,1328312,1940255304
1103000,2118774825,81356817,1.0983170295e-11,17732072,1327812,1941583116
1103500,2088605682,81357461,1.0983257235e-11,17753010,1328312,1942911428
1104000,2083087615,81357115,1.0983210525e-11,17741757,1329672,1944241100
1104500,2086050732,81356887,1.0983179745e-11,17734338,1328312,1945569412
1105000,2087192196,81356893,1.0983180555e-11,17734534,1328796,1946898208
1105500,2087470241,81359410,1.098352035e-11,17816346,1330148,1948228356
1106000,2077821750,81355094,1.0982937690000002e-11,17676086,1327784,1949556140
1106500,2088964257,81538056,1.1007637559999999e-11,17767491,1329276,1950885416
1107000,2114915546,81352880,1.09826388e-11,17604125,1329660,1952215076
1107500,2168456197,81338449,1.0980690615000001e-11,17135116,1327276,1953542352
1108000,2129197641,81337164,1.098051714e-11,17093337,1328284,1954870636
1108500,2103096264,81347544,1.098191844e-11,17430689,1328784,1956199420
1109000,2155023486,81539286,1.100780361e-11,17807476,1329284,1957528704
1109500,2165609063,81346695,1.0981803825e-11,17403117,1328776,1958857480
1110000,2116263924,81358747,1.0983430845e-11,17794788,1329304,1960186784
1110500,3343315161,81360638,1.098368613e-11,17856256,1328268,1961515052
1111000,8722406138,81681126,1.1026952010000001e-11,17733371,1328268,1962843320
1111500,2093823025,81353997,1.0982789595e-11,17640424,1327796,1964171116
1112000,2093290287,81355752,1.098302652e-11,17697473,1329252,1965500368
1112500,2101658019,81356032,1.0983064320000001e-11,17706546,1327276,1966827644
1113000,2071283331,81358883,1.0983449205e-11,17799215,1329276,1968156920
1113500,2081170662,81535824,1.100733624e-11,17694944,1328312,1969485232
1114000,2088409026,81358151,1.0983350385e-11,17774363,1328276,1970813508
1114500,2085205573,81354919,1.0982914065000002e-11,17670385,1328276,1972141784
1115000,2085252381,81356763,1.0983163005e-11,17730320,1328804,1973470588
1115500,2075702031,81348001,1.0981980135e-11,17445565,1329656,1974800244
1116000,2087629589,81518450,1.1004990750000001e-11,17031086,1328284,1976128528
1116500,2077730252,81338165,1.0980652275000001e-11,17125893,1328784,1977457312
1117000,2097679127,81342333,1.0981214955e-11,17261344,1328796,1978786108
1117500,2174523332,81354332,1.098283482e-11,17651314,1328312,1980114420
1118000,2156674524,81542236,1.100820186e-11,17804133,1329144,1981443564
1118500,2117883872,81353928,1.098278028e-11,17638160,1328284,1982771848
1119000,2214913852,81355931,1.0983050685000001e-11,17703265,1327280,1984099128
1119500,2226068958,81357798,1.098330273e-11,17763962,1327784,1985426912
1120000,2126070920,81359565,1.0983541275e-11,17821386,1328812,1986755724
1120500,2114104986,81547985,1.1008977975e-11,17990977,1329688,1988085412
1121000,6592927470,81360718,1.0983696930000001e-11,17858852,1328796,1989414208
1121500,2109175990,81542344,1.1008216440000001e-11,17807644,1328296,1990742504
1122000,2109519115,81361010,1.098373635e-11,17868341,1329652,1992072156
1122500,2088957243,81354026,1.098279351e-11,17641353,1329680,1993401836
1123000,2086628069,81342149,1.0981190115e-11,17255353,1328776,1994730612
1123500,2088514153,81353487,1.0982720745e-11,17623836,1328804,1996059416
1124000,2086029599,81546619,1.1008793565e-11,17946563,1330672,1997390088
1124500,2086767841,81357716,1.098329166e-11,17761304,1328804,1998718892
1125000,2090228701,81359954,1.0983593790000001e-11,17834010,1328804,2000047696
1125500,2082169071,81362014,1.098387189e-11,17900987,1329660,2001377356
1126000,2080736599,81538497,1.1007697095000001e-11,17682594,1328812,2002706168
1126500,2070429619,81360141,1.0983619035000001e-11,17839034,1329812,2004035980
1127000,2066399597,81359003,1.0983465405e-11,17803112,1330160,2005366140
1127500,2091019506,81354797,1.0982897595e-11,17666431,1328780,2006694920
1128000,2085419442,81356987,1.0983193245000002e-11,17737600,1328312,2008023232
1128500,2148707704,81544986,1.1008573110000001e-11,17794276,1328804,2009352036
1129000,2097544102,81354271,1.0982826585000001e-11,17649316,1330564,2010682600
1129500,2204965187,81344856,1.0981555560000001e-11,17343321,1327764,2012010364
1130000,2161730882,81358896,1.098345096e-11,17799644,1329312,2013339676
1130500,2095599511,81542995,1.1008304325e-11,17729561,1328688,2014668364
1131000,2110929190,81342259,1.0981204965000001e-11,17258947,1329772,2015998136
1131500,11248212412,81567053,1.1011552155e-11,17300781,1327784,2017325920
1132000,2094583488,81356707,1.0983155445000001e-11,17728501,1328284,2018654204
1132500,2091148157,81358208,1.0983358080000001e-11,17777287,1328284,2019982488
1133000,2081976544,81357760,1.0983297600000001e-11,17762708,1328776,2021311264
1133500,2093595682,81542101,1.1008183635e-11,17700513,1328776,2022640040
1134000,2067412315,81355541,1.0982998035000001e-11,17690592,1327276,2023967316
1134500,2063785268,81357959,1.0983324465000001e-11,17769191,1328784,2025296100
1135000,2081194660,81356308,1.098310158e-11,17715546,1328284,2026624384
1135500,2165364689,81358834,1.0983442590000001e-11,17797628,1328284,2027952668
1136000,2086216188,81542785,1.1008275975e-11,17722735,1328776,2029281444
1136500,2149980675,81360099,1.0983613365000002e-11,17838745,1329284,2030610728
1137000,2144833934,81355595,1.0983005325e-11,17692340,1329652,2031940380
1137500,2107983028,81348511,1.0982048985e-11,17462113,1328784,2033269164
1138000,2124472371,81524947,1.1005867845000002e-11,17143020,1327784,2034596948
1138500,2221463363,81340832,1.0981012320000001e-11,17212560,1328784,2035925732
1139000,2142160071,81342284,1.098120834e-11,17258689,1327784,2037253516
1139500,2163059938,81352318,1.098256293e-11,17585851,1328256,2038581772
1140000,3367639849,81359781,1.0983570435e-11,17828398,1329284,2039911056
1140500,8710621890,81550840,1.1009363400000002e-11,17885288,1328784,2041239840
1141000,2098478983,81543092,1.1008317420000002e-11,17633503,1328280,2042568120
1141500,2093838829,81355495,1.0982991825e-11,17689092,1328276,2043896396
1142000,2084240683,81357072,1.098320472e-11,17740343,1328784,2045225180
1142500,2087978454,81354973,1.0982921355e-11,17672131,1327276,2046552456
1143000,2084429871,81356672,1.0983150720000001e-11,17727370,1328276,2047880732
1143500,2086795916,81356620,1.0983143700000001e-11,17725656,1328284,2049209016
1144000,2089295030,81355969,1.0983055815000001e-11,17704516,1328284,2050537300
1144500,2074166325,81357413,1.0983250755e-11,17751447,1328776,2051866076
1145000,2093122863,81357157,1.0983216195000001e-11,17743132,1328284,2053194360
1145500,2100144693,81548390,1.100903265e-11,17805696,1330644,2054525004
1146000,2171957171,81336489,1.0980426015000002e-11,17071400,1328284,2055853288
1146500,2107766728,81343520,1.0981375200000001e-11,17299902,1328804,2057182092
1147000,2107721679,81353357,1.0982703195e-11,17619608,1328304,2058510396
1147500,2109378394,81352808,1.098262908e-11,17601762,1328812,2059839208
1148000,2123442526,81546299,1.1008750365e-11,17737720,1328784,2061167992
1148500,2147205610,81356184,1.098308484e-11,17711500,1328276,2062496268
1149000,11248908411,81599933,1.1015990955e-11,17635045,1328276,2063824544
1149500,2091519772,81354287,1.0982828745000002e-11,17649834,1328812,2065153356
1150000,2095178857,81352960,1.0982649600000002e-11,17606699,1328776,2066482132
1150500,2083036338,81358911,1.0983452985e-11,17800114,1328812,2067810944
1151000,2088948933,81543117,1.1008320795000001e-11,17634314,1328784,2069139728
1151500,2095666705,81352888,1.0982639880000002e-11,17603280,1328812,2070468540
1152000,2095454412,81352976,1.0982651760000001e-11,17607231,1328672,2071797212
1152500,2081278764,81351135,1.0982403225e-11,17547400,1328812,2073126024
1153000,2210207764,81351308,1.0982426580000001e-11,17553016,1328304,2074454328
1153500,2097870279,81528265,1.1006315775000001e-11,17052401,1328680,2075783008
1154000,2133395569,81335902,1.098034677e-11,17052347,1329688,2077112696
1154500,2079276620,81337914,1.098061839e-11,17117722,1328804,2078441500
1155000,2103888145,81346532,1.0981781820000001e-11,17397812,1329804,2079771304
1155500,2104143562,81552507,1.1009588445000001e-11,17840248,1329660,2081100964
1156000,2120695504,81355339,1.0982970765e-11,17684044,1328276,2082429240
1156500,2188512849,81357808,1.098330408e-11,17764272,1329312,2083758552
1157000,2224718981,81356356,1.0983108060000001e-11,17717102,1329776,2085088328
1157500,3477545365,81356562,1.098313587e-11,17723774,1328312,2086416640
1158000,4877200546,81548251,1.1009013885e-11,17701944,1328768,2087745408
1158500,2107648956,81357034,1.098319959e-11,17739128,1329276,2089074684
1159000,2097624579,81547473,1.1008908855000001e-11,17676671,1328272,2090402956
1159500,2088757452,81356602,1.0983141270000002e-11,17725070,1327296,2091730252
1160000,2093951930,81354266,1.098282591e-11,17649174,1328776,2093059028
1160500,2087415035,81361407,1.0983789945e-11,17881247,1328784,2094387812
1161000,2086249638,81352641,1.0982606535000002e-11,17596349,1330160,2095717972
1161500,2065243419,81536397,1.1007413595000001e-11,17316688,1329296,2097047268
1162000,2092832285,81343050,1.098131175e-11,17284643,1329188,2098376456
1162500,2082900240,81341091,1.0981047285e-11,17220968,1328304,2099704760
1163000,2085118520,81344162,1.0981461870000002e-11,17320783,1327784,2101032544
1163500,2082937415,81341708,1.0981130580000001e-11,17241028,1327812,2102360356
1164000,2075606957,81533424,1.1007012240000002e-11,17218958,1328304,2103688660
1164500,2075807736,81342192,1.098119592e-11,17256771,1329688,2105018348
1165000,2163125025,81340347,1.0980946845000001e-11,17196788,1327804,2106346152
1165500,2075896637,81344172,1.098146322e-11,17321106,1328304,2107674456
1166000,2166327800,81533441,1.1007014535e-11,17121396,1328304,2109002760
1166500,2085160027,81349428,1.098217278e-11,17491926,1328312,2110331072
1167000,2116085557,81358806,1.0983438810000001e-11,17796726,1329152,2111660224
1167500,2150680835,81359625,1.0983549375e-11,17823342,1329296,2112989520
1168000,2181935421,81551050,1.1009391750000002e-11,17693706,1328312,2114317832
1168500,3455634758,81359704,1.0983560040000001e-11,17825913,1330180,2115648012
1169000,8837996920,81610606,1.1017431810000001e-11,17723994,1328304,2116976316
1169500,2098791884,81359148,1.0983484980000001e-11,17807816,1329812,2118306128
1170000,2094270524,81358592,1.098340992e-11,17789771,1328680,2119634808
1170500,2100458485,81355843,1.0983038805e-11,17700399,1326436,2120961244
1171000,2093062014,81356566,1.0983136410000001e-11,17723914,1328776,2122290020
1171500,2065279053,81551652,1.100947302e-11,17713246,1328804,2123618824
1172000,2068956522,81355187,1.0982950245000001e-11,17679086,1328276,2124947100
1172500,2086364274,81344260,1.09814751e-11,17323973,1330036,2126277136
1173000,2087559569,81324791,1.0978846785000001e-11,16691216,1328312,2127605448
1173500,2070737551,81519462,1.100512737e-11,16667060,1328760,2128934208
1174000,2075885375,81330138,1.0979568630000001e-11,16864998,1328312,2130262520
1174500,2090992020,81341788,1.098114138e-11,17243624,1328312,2131590832
1175000,2098623602,81330716,1.097964666e-11,16883774,1328284,2132919116
1175500,2114445320,81344598,1.098152073e-11,17334955,1328784,2134247900
1176000,2115593009,81534915,1.1007213525e-11,17169296,1327284,2135575184
1176500,2105775534,81341265,1.0981070775e-11,17225516,1328304,2136903488
1177000,2118318143,81342626,1.0981254509999999e-11,17270872,1327312,2138230800
1177500,2100384492,81340113,1.0980915255e-11,17189184,1328304,2139559104
1178000,4905110475,81344148,1.098145998e-11,17320347,1330188,2140889292
1178500,8695151232,81578272,1.1013066720000002e-11,17189146,1328812,2142218104
1179000,2093968834,81539219,1.1007794565e-11,17209976,1329312,2143547416
1179500,2093214816,81342820,1.0981280700000001e-11,17277178,1328288,2144875704
1180000,2087252679,81340400,1.0980954e-11,17198500,1330556,2146206260
1180500,2085937197,81323504,1.097867304e-11,16649403,1328276,2147534536
1181000,2083533885,81520001,1.1005200135000001e-11,16585366,1327812,2148862348
1181500,2096667597,81324109,1.0978754715e-11,16669052,1328812,2150191160
1182000,2088353410,81338984,1.098076284e-11,17152505,1329652,2151520812
1182500,2083243338,81338237,1.0980661995000001e-11,17128236,1327784,2152848596
1183000,2077135986,81341153,1.0981055655000002e-11,17222984,1329296,2154177892
1183500,2077370694,81539799,1.1007872865e-11,17228788,1328304,2155506196
1184000,2149388247,81341780,1.0981140300000001e-11,17243359,1329652,2156835848
1184500,2157511746,81338889,1.0980750015e-11,17149402,1328312,2158164160
1185000,2107787238,81342077,1.0981180395e-11,17253022,1328804,2159492964
1185500,2149308698,81545247,1.1008608345e-11,17405852,1328812,2160821776
1186000,2100401211,81345196,1.098160146e-11,17354383,1328776,2162150552
1186500,2129018030,81338385,1.0980681975e-11,17133026,1327284,2163477836
1187000,2110330590,81342296,1.098120996e-11,17260123,1329276,2164807112
1187500,2144255377,81339526,1.0980836010000001e-11,17170121,1329660,2166136772
1188000,14334669082,81742734,1.103526909e-11,16729031,1328784,2167465556
1188500,2094043799,81344222,1.098146997e-11,17322730,1328268,2168793824
1189000,2092907251,81345147,1.0981594845000002e-11,17351658,1329276,2170123100
1189500,2085803739,81343248,1.0981338480000002e-11,17291083,1327784,2171450884
1190000,2091773431,81546073,1.1008719855000002e-11,17333506,1328768,2172779652
1190500,2085967119,81344844,1.098155394e-11,17342951,1328284,2174107936
1191000,2062769632,81342479,1.0981234665000002e-11,17266096,1328312,2175436248
1191500,2090913231,81341599,1.0981115865000001e-11,17237471,1328268,2176764516
1192000,2107983829,81341371,1.0981085085e-11,17230086,1327804,2178092320
1192500,2076412530,81544442,1.100849967e-11,17280480,1328260,2179420580
1193000,2104711112,81342048,1.098117648e-11,17252069,1327776,2180748356
1193500,2080858169,81342123,1.0981186605e-11,17254519,1328284,2182076640
1194000,2136055339,81341335,1.0981080225e-11,17228907,1327776,2183404416
1194500,2114092254,81543444,1.1008364940000001e-11,17248038,1328784,2184733200
1195000,2231999402,81343228,1.098133578e-11,17290441,1328268,2186061468
1195500,2137843183,81344948,1.098156798e-11,17346334,1328776,2187390244
1196000,2100198299,81333448,1.098001548e-11,16972587,1329680,2188719924
1196500,11303638461,81674690,1.1026083150000002e-11,16928974,1328304,2190048228
1197000,2092946812,81333328,1.097999928e-11,16968674,1328312,2191376540
1197500,2088684592,81327615,1.0979228025e-11,16782993,1330152,2192706692
1198000,2088894592,81323013,1.0978606755e-11,16633445,1328772,2194035464
1198500,2081299311,81532756,1.1006922060000001e-11,16900684,1329304,2195364768
1199000,2082935889,81342493,1.0981236555e-11,17266538,1328804,2196693572
1199500,2098793568,81342640,1.09812564e-11,17271322,1329304,2198022876
1200000,2076590208,81338569,1.0980706815e-11,17139017,1328188,2199351064
1200500,2079860031,81343065,1.0981313775e-11,17285144,1328812,2200679876
1201000,2116581125,81544060,1.10084481e-11,17268084,1328284,2202008160
1201500,2159103150,81340595,1.0980980325e-11,17203700,1328296,2203336456
1202000,2082836034,81339639,1.0980851265000002e-11,17173780,1327296,2204663752
1202500,2106000313,81342127,1.0981187145000001e-11,17254653,1330172,2205993924
1203000,2136750678,81547557,1.1008920195e-11,17282535,1329680,2207323604
1203500,2221867809,81341253,1.0981069155000002e-11,17226250,1327812,2208651416
1204000,2135623153,81356686,1.0983152610000001e-11,17727815,1329680,2209981096
1204500,2112089658,81359950,1.098359325e-11,17833878,1329304,2211310400
1205000,3358849619,81357491,1.0983261285e-11,17753970,1328812,2212639212
1205500,8715414117,81708455,1.1030641425e-11,17857658,1328812,2213968024
1206000,2100246391,81358517,1.0983399795e-11,17787318,1328796,2215296820
1206500,2088469960,81357459,1.0983256965e-11,17752944,1328284,2216625104
1207000,2083134052,81358197,1.0983356595000001e-11,17776932,1328804,2217953908
1207500,2081248915,81561137,1.1010753495000001e-11,17723884,1328312,2219282220
1208000,2084897551,81357079,1.0983205665e-11,17740589,1328276,2220610496
1208500,2083583621,81355675,1.0983016125e-11,17694954,1328784,2221939280
1209000,2103232010,81353896,1.0982775960000002e-11,17637148,1328284,2223267564
1209500,2076329134,81357359,1.0983243465e-11,17749693,1329284,2224596848
1210000,2103772766,81562593,1.1010950055e-11,17771190,1328276,2225925124
1210500,2218491493,81363133,1.0984022955000001e-11,17937345,1329280,2227254404
1211000,2154036155,81350534,1.098232209e-11,17527887,1329152,2228583556
1211500,2086007008,81338599,1.0980710865e-11,17139993,1329276,2229912832
1212000,2102529429,81546173,1.1008733355000001e-11,17237566,1327812,2231240644
1212500,2086345825,81341777,1.0981139895000001e-11,17243278,1328296,2232568940
1213000,2110572251,81359025,1.0983468375e-11,17803819,1328188,2233897128
1213500,2114724797,81359629,1.0983549915e-11,17823464,1328784,2235225912
1214000,11243016532,81711483,1.1031050205e-11,17786252,1329304,2236555216
1214500,2098596712,81360039,1.0983605265e-11,17836784,1328776,2237883992
1215000,2097152887,81362324,1.098391374e-11,17911038,1328804,2239212796
1215500,2088919207,81360337,1.0983645495e-11,17846462,1329652,2240542448
1216000,2084491410,81354389,1.0982842515000001e-11,17653148,1328304,2241870752
1216500,2091748156,81566181,1.1011434435e-11,17788572,1329304,2243200056
1217000,2058818869,81356496,1.098312696e-11,17721648,1329652,2244529708
1217500,2076173712,81356258,1.098309483e-11,17713908,1329312,2245859020
1218000,2211983507,81352727,1.0982618145e-11,17599132,1329148,2247188168
1218500,2104320728,81550237,1.1009281995e-11,17270426,1328812,2248516980
1219000,2091122601,81341004,1.098103554e-11,17218135,1330688,2249847668
1219500,2104064408,81348469,1.0982043315000002e-11,17460774,1327804,2251175472
1220000,2085171675,81359821,1.0983575835e-11,17829712,1328304,2252503776
1220500,2103977252,81359725,1.0983562875e-11,17826596,1329656,2253833432
1221000,2195943878,81347918,1.098196893e-11,17442846,1328784,2255162216
1221500,2103609915,81355807,1.0983033945e-11,17699252,1328804,2256491020
1222000,2115116175,81358664,1.098341964e-11,17792099,1330188,2257821208
1222500,2216953360,81355997,1.0983059595000001e-11,17705434,1327812,2259149020
1223000,11272167635,81584382,1.101389157e-11,17705336,1328812,2260477832
1223500,2087422757,81563508,1.1011073580000001e-11,17701727,1329680,2261807512
1224000,2085025974,81361090,1.098374715e-11,17870940,1328312,2263135824
1224500,2089103294,81363885,1.0984124475000001e-11,17961779,1329688,2264465512
1225000,2082012500,81354299,1.0982830365e-11,17650222,1327312,2265792824
1225500,2084278691,81563674,1.101109599e-11,17707101,1330160,2267122984
1226000,2081591485,81341523,1.0981105605e-11,17235001,1330260,2268453244
1226500,2084452258,81343343,1.0981351305e-11,17292993,1329284,2269782528
1227000,2085374925,81357372,1.098324522e-11,17750110,1328784,2271111312
1227500,2082451292,81357430,1.0983253050000001e-11,17751979,1328784,2272440096
1228000,2084508558,81571193,1.1012111055000001e-11,17852243,1329276,2273769372
1228500,2054230159,81358428,1.098338778e-11,17784417,1328272,2275097644
1229000,2162300567,81360051,1.0983606885e-11,17837171,1329276,2276426920
1229500,2131355724,81357841,1.0983308535e-11,17765347,1328280,2277755200
1230000,2212094526,81573588,1.101243438e-11,17930083,1329784,2279084984
1230500,2074069000,81360151,1.0983620385e-11,17840437,1328784,2280413768
1231000,2111774162,81356796,1.098316746e-11,17731388,1328796,2281742564
1231500,2085545658,81358403,1.0983384405e-11,17783604,1329812,2283072376
1232000,2109385679,81358279,1.0983367665e-11,17779588,1327312,2284399688
1232500,2094796031,81568702,1.101177477e-11,17771316,1330152,2285729840
1233000,3382407330,81347135,1.0981863225000001e-11,17417412,1330120,2287059960
1233500,11272335978,81613882,1.101787407e-11,17185532,1328804,2288388764
1234000,2111382257,81340824,1.0981011240000001e-11,17212288,1327804,2289716568
1234500,2108505678,81357869,1.0983312315e-11,17766276,1330160,2291046728
1235000,2088364747,81355702,1.098301977e-11,17695846,1328812,2292375540
1235500,2081490585,81571875,1.1012203125e-11,17874415,1328280,2293703820
1236000,2085912363,81360509,1.0983668715e-11,17852056,1328788,2295032608
1236500,2076544277,81359164,1.0983487139999999e-11,17808362,1328804,2296361412
1237000,2151225174,81358055,1.0983337425e-11,17772291,1329680,2297691092
1237500,2089816050,81568750,1.101178125e-11,17772840,1328804,2299019896
1238000,2100392149,81358765,1.0983433275000001e-11,17795392,1328304,2300348200
1238500,2178199549,81356573,1.0983137355e-11,17724136,1327296,2301675496
1239000,2079482857,81358154,1.098335079e-11,17774337,1329188,2303004684
1239500,2114990021,81355572,1.0983002220000001e-11,17691612,1327812,2304332496
1240000,2127458234,81567470,1.101160845e-11,17632043,1329180,2305661676
1240500,2117280443,81345691,1.0981668285000001e-11,17370474,1328312,2306989988
1241000,2215636680,81341144,1.098105444e-11,17222689,1328276,2308318264
1241500,3349605237,81342337,1.0981215495000001e-11,17261478,1327776,2309646040
1242000,8797438302,81599699,1.1015959365000001e-11,17290219,1329268,2310975308
1242500,2101306585,81357003,1.0983195405e-11,17738110,1327768,2312303076
1243000,2070394429,81572727,1.1012318145000002e-11,17802902,1327284,2313630360
1243500,2112703163,81360931,1.0983725685000001e-11,17865776,1329260,2314959620
1244000,2102356104,81360869,1.0983717315e-11,17863768,1328768,2316288388
1244500,2085398536,81357790,1.0983301650000002e-11,17763702,1328284,2317616672
1245000,2078582126,81360428,1.098365778e-11,17849413,1328276,2318944948
1245500,2080527365,81579809,1.1013274215e-11,18033060,1328784,2320273732
1246000,2078305097,81358730,1.098342855e-11,17794250,1327784,2321601516
1246500,2078418337,81359200,1.0983492e-11,17809516,1329304,2322930820
1247000,2091237429,81357530,1.098326655e-11,17755237,1328280,2324259100
1247500,2090092937,81571568,1.101216168e-11,17765228,1328776,2325587876
1248000,2119876166,81356349,1.0983107115e-11,17716870,1328796,2326916672
1248500,2173393995,81349148,1.098213498e-11,17482833,1330152,2328246824
1249000,2109481406,81339560,1.0980840600000001e-11,17171209,1327784,2329574608
1249500,2111800101,81342931,1.0981295685000001e-11,17280786,1328768,2330903376
1250000,2113271329,81565207,1.1011302944999999e-11,17558507,1327272,2332230648
1250500,2195766050,81360303,1.0983640905e-11,17845359,1327768,2333558416
1251000,3362059628,81337765,1.0980598275e-11,17112897,1328776,2334887192
1251500,8692697805,81694774,1.102879449e-11,17441672,1327796,2336214988
1252000,2098822689,81356190,1.098308565e-11,17711695,1329680,2337544668
1252500,2086252869,81356176,1.0983083760000002e-11,17711222,1329296,2338873964
1253000,2092413767,81356100,1.09830735e-11,17708752,1328788,2340202752
1253500,2087267029,81354865,1.0982906775e-11,17668641,1329188,2341531940
1254000,2064577766,81574296,1.101252996e-11,17754640,1329312,2342861252
1254500,2104483739,81356962,1.098318987e-11,17736788,1328312,2344189564
1255000,2084034069,81359199,1.0983491865e-11,17809477,1329188,2345518752
1255500,2087072506,81359422,1.098352197e-11,17816743,1328652,2346847404
1256000,2073875225,81343099,1.0981318365e-11,17286220,1328276,2348175680
1256500,2099539168,81338789,1.0980736515e-11,17146173,1327276,2349502956
1257000,2132576375,81341751,1.0981136385e-11,17242421,1328776,2350831732
1257500,2101095100,81341453,1.0981096155000001e-11,17232743,1328284,2352160016
1258000,2102998359,81352494,1.0982586690000001e-11,17591577,1327776,2353487792
1258500,2111252807,81573857,1.1012470695e-11,17740378,1328284,2354816076
1259000,2169024716,81354949,1.0982918115000001e-11,17671374,1327784,2356143860
1259500,2127853542,81357668,1.0983285180000001e-11,17759716,1328312,2357472172
1260000,3363691066,81357044,1.098320094e-11,17739434,1328776,2358800948
1260500,11244403131,81619318,1.1018607930000001e-11,17808778,1327312,2360128260
1261000,2094987858,81570469,1.1012013315e-11,17630296,1328804,2361457064
1261500,2128311810,81354683,1.0982882205e-11,17662703,1328772,2362785836
1262000,2118725805,81354263,1.0982825505e-11,17649050,1328288,2364114124
1262500,2091140642,81355212,1.098295362e-11,17679890,1328304,2365442428
1263000,2087729211,81359807,1.0983573945e-11,17829246,1328304,2366770732
1263500,2087484482,81575343,1.1012671305e-11,17788692,1327812,2368098544
1264000,2086348913,81346710,1.0981805850000001e-11,17402354,1330548,2369429092
1264500,2085744609,81343972,1.098143622e-11,17314593,1329264,2370758356
1265000,2086335732,81357045,1.0983201075000001e-11,17739474,1328812,2372087168
1265500,2105113494,81580766,1.1013403409999999e-11,17865716,1328312,2373415480
1266000,2101241019,81355839,1.0983038265e-11,17700268,1328304,2374743784
1266500,2088320799,81358452,1.0983391020000001e-11,17785205,1327772,2376071556
1267000,2114597719,83465093,1.1267787555e-11,17806244,1333400,2377404956
1267500,4836269965,95788425,1.2931437375000001e-11,22428615,1329180,2378734136
1268000,4824291695,95555507,1.2899993445000002e-11,22273587,1329312,2380063448
1268500,4905893498,95784515,1.2930909525e-11,22375072,1327804,2381391252
1269000,8719904046,95559131,1.2900482685e-11,22384462,1330180,2382721432
1269500,2111404814,95787648,1.2931332480000002e-11,22438369,1329312,2384050744
1270000,2090713933,95552690,1.289961315e-11,22344362,1327312,2385378056
1270500,2089333818,95559456,1.290052656e-11,22481096,1328796,2386706852
1271000,2085689277,95553816,1.2899765160000002e-11,22304656,1328660,2388035512
1271500,2087459647,95763440,1.2928064400000001e-11,21743189,1328276,2389363788
1272000,2083326878,95541371,1.2898085085e-11,21840926,1328284,2390692072
1272500,2086401218,88429783,1.1938020705e-11,21947995,36460336,2427152408
1273000,2085718431,87730253,1.1843584155e-11,20899123,39658608,2466811016
1273500,2083666472,87802941,1.1853397035e-11,21316824,39648940,2506459956
1274000,2086007298,88021643,1.1882921805e-11,21398901,39650416,2546110372
1274500,2081991065,87745150,1.1845595250000002e-11,21365782,39659476,2585769848
1275000,2083885739,87775768,1.184972868e-11,21316326,39650240,2625420088
1275500,2084996043,87747988,1.184597838e-11,21424307,39657188,2665077276
1276000,2092235137,87801893,1.1853255555e-11,21249535,39651240,2704728516
1276500,2089047027,88035753,1.1884826655e-11,21277106,39654876,2744383392
1277000,2083859999,87738813,1.1844739755e-11,21295618,39657300,2784040692
1277500,2077609803,87716066,1.184166891e-11,21117327,39647336,2823688028
1278000,4772341927,87724292,1.184277942e-11,21309196,39650684,2863338712
1278500,3446182929,88010588,1.188142938e-11,21153317,39656756,2902995468
1279000,3372748151,87800252,1.1853034020000001e-11,21206127,39651560,2942647028
1279500,3335443483,88051980,1.1887017300000001e-11,21099998,39657652,2982304680
1280000,3346919046,87722198,1.184249673e-11,20625184,39654256,3021958936
1280500,4809882411,87764104,1.184815404e-11,20977703,39656576,3061615512
1281000,3444250071,87744100,1.18454535e-11,21282682,39661000,3101276512
1281500,8707734354,90488726,1.221597801e-11,21353810,25733312,3127009824
1282000,2092150729,93393637,1.2608140995e-11,20532867,1329160,3128338984
1282500,2089413187,93314293,1.2597429555000001e-11,20442409,1327804,3129666788
1283000,2084640388,93337761,1.2600597735e-11,20509469,1328804,3130995592
1283500,2088095748,93307625,1.2596529375e-11,20488552,1327812,3132323404
1284000,2087529904,93515837,1.2624637995e-11,20528842,1329652,3133653056
1284500,3314226218,93902032,1.267677432e-11,20532832,1328784,3134981840
1285000,3318727002,93427557,1.2612720195e-11,20524032,1329812,3136311652
1285500,3329916510,93427329,1.2612689415000002e-11,20569257,1329688,3137641340
1286000,3318707968,93374517,1.2605559795000002e-11,20013090,1329268,3138970608
1286500,3318348085,93452270,1.261605645e-11,19898828,1328812,3140299420
1287000,2081272491,82169599,1.1092895865000001e-11,20467072,-1559279020,1581020400
1287500,2081420977,81658227,1.1023860644999999e-11,17803496,1328812,1582349212
1288000,2073767612,81357098,1.098320823e-11,17741210,1328296,1583677508
1288500,2080547583,81355917,1.0983048795e-11,17702822,1329628,1585007136
1289000,2074736404,81357080,1.0983205800000001e-11,17740616,1328812,1586335948
1289500,2083053018,81356584,1.098313884e-11,17724482,1328804,1587664752
1290000,2083843609,81656168,1.102358268e-11,17736607,1329160,1588993912
1290500,2083777901,81361897,1.0983856095e-11,17897160,1328784,1590322696
1291000,2088829443,81355743,1.0983025305e-11,17697158,1328296,1591650992
1291500,2066814771,81358480,1.09833948e-11,17786103,1328276,1592979268
1292000,2097883644,81652045,1.1023026075e-11,17602590,1329612,1594308880
1292500,2070248640,81339626,1.0980849510000001e-11,17173362,1328312,1595637192
1293000,2118386431,81341541,1.0981108035e-11,17235601,1328756,1596965948
1293500,2089333407,81347774,1.0981949490000002e-11,17438183,1328284,1598294232
1294000,2098427908,81359402,1.098351927e-11,17816090,1329284,1599623516
1294500,2065903902,81658805,1.1023938675000001e-11,17822293,1328784,1600952300
1295000,2081144573,81360325,1.0983643875e-11,17846086,1329276,1602281576
1295500,2124867048,81362078,1.098388053e-11,17903051,1328784,1603610360
1296000,2093245157,81355636,1.098301086e-11,17693694,1328776,1604939136
1296500,2105520829,81653974,1.102328649e-11,17665290,1327804,1606266940
1297000,2129444945,81359349,1.0983512115e-11,17814374,1328804,1607595744
1297500,6667440652,81357798,1.098330273e-11,17763939,1330180,1608925924
1298000,2114336630,81653987,1.1023288245000001e-11,17665688,1327776,1610253700
1298500,2133747242,81358058,1.098333783e-11,17772388,1329304,1611583004
1299000,2105935270,81359345,1.0983511575e-11,17814221,1328312,1612911316
1299500,2099575044,81357388,1.098324738e-11,17750616,1327304,1614238620
1300000,2095727573,81642505,1.1021738175e-11,17292539,1330016,1615568636
1300500,2096812890,81343724,1.098140274e-11,17306536,1329284,1616897920
1301000,2089202301,81356283,1.0983098205000002e-11,17714698,1329784,1618227704
1301500,2080467963,81348502,1.0982047770000001e-11,17461834,1328812,1619556516
1302000,2121293519,81352350,1.0982567250000001e-11,17586881,1328180,1620884696
1302500,2124610785,81651326,1.102292901e-11,17579236,1328304,1622213000
1303000,2105072816,81354056,1.098279756e-11,17642328,1329312,1623542312
1303500,2142022270,81354421,1.0982846835000001e-11,17654211,1329688,1624872000
1304000,2117806285,81353766,1.0982758410000001e-11,17632906,1327312,1626199312
1304500,2191026398,81651006,1.1022885810000001e-11,17568810,1328804,1627528116
1305000,2129667678,81352634,1.098260559e-11,17596134,1328312,1628856428
1305500,2139812496,81361675,1.0983826125000001e-11,17889965,1330644,1630187072
1306000,4868119040,81351376,1.098243576e-11,17555243,1328284,1631515356
1306500,11366603169,81942986,1.1062303110000001e-11,17333778,1330036,1632845392
1307000,2090363985,81325972,1.0979006220000001e-11,16729622,1328804,1634174196
1307500,2081970366,81342414,1.0981225890000001e-11,17263967,1328784,1635502980
1308000,2087958438,81340010,1.098090135e-11,17185832,1328304,1636831284
1308500,2084866771,81639084,1.1021276340000002e-11,17181374,1328796,1638160080
1309000,2084037129,81338244,1.0980662940000002e-11,17128467,1327768,1639487848
1309500,2097511441,81341811,1.0981144485000001e-11,17244379,1329284,1640817132
1310000,2066207345,81341147,1.0981054845e-11,17222793,1328276,1642145408
1310500,2132895975,81348612,1.0982062620000001e-11,17465391,1328776,1643474184
1311000,2096931278,81640174,1.1021423490000001e-11,17216614,1328776,1644802960
1311500,2186590288,81341930,1.098116055e-11,17248252,1328776,1646131736
1312000,2187486948,81340642,1.098098667e-11,17206382,1329312,1647461048
1312500,2128538009,81340704,1.098099504e-11,17208396,1328312,1648789360
1313000,2128285894,81639349,1.1021312115e-11,17189983,1327780,1650117140
1313500,2103351390,81345088,1.098158688e-11,17350862,1328812,1651445952
1314000,2110828373,81342297,1.0981210095000001e-11,17260165,1328688,1652774640
1314500,2102440870,81333907,1.0980077445e-11,16987479,1329152,1654103792
1315000,6601437595,81331185,1.0979709975e-11,16899038,1329776,1655433568
1315500,3363872963,81701321,1.1029678335e-11,17259189,1328284,1656761852
1316000,2106446871,81325325,1.0978918874999999e-11,16708592,1329312,1658091164
1316500,2102194792,81325281,1.0978912935000002e-11,16707146,1327812,1659418976
1317000,2091392732,81623943,1.1019232305e-11,16689260,1327304,1660746280
1317500,2072365365,81340192,1.0980925920000001e-11,17191765,1329188,1662075468
1318000,2067106399,81339692,1.098085842e-11,17175496,1327312,1663402780
1318500,2087398995,81340721,1.0980997335000002e-11,17208940,1328276,1664731056
1319000,2082714201,81640718,1.102149693e-11,17234472,1328312,1666059368
1319500,2089271525,81342534,1.098124209e-11,17267861,1329172,1667388540
1320000,2104411850,81338775,1.0980734625e-11,17145707,1328768,1668717308
1320500,2102699388,81344545,1.0981513575000001e-11,17333222,1327812,1670045120
1321000,2135667000,81340298,1.0980940230000001e-11,17195210,1328776,1671373896
1321500,2224303979,81637320,1.10210382e-11,17124022,1329312,1672703208
1322000,2105486626,81339124,1.098078174e-11,17157064,1330556,1674033764
1322500,2106121218,81338078,1.098064053e-11,17123064,1328312,1675362076
1323000,2111898629,81337513,1.0980564255e-11,17104684,1328804,1676690880
1323500,2113641638,81653662,1.1023244370000001e-11,17654967,1330688,1678021568
1324000,2116698723,81354525,1.0982860875000002e-11,17657576,1328296,1679349864
1324500,4886391618,81355498,1.098299223e-11,17689216,1328804,1680678668
1325000,4818330849,81683321,1.1027248335e-11,17646631,1328188,1682006856
1325500,2108168149,81365241,1.0984307535000001e-11,18005839,1329784,1683336640
1326000,2102172961,81357475,1.0983259125e-11,17753461,1328776,1684665416
1326500,2113988686,81357143,1.0983214305e-11,17742651,1328276,1685993692
1327000,2103615958,81654023,1.1023293104999999e-11,17666869,1328268,1687321960
1327500,2089595229,81357732,1.098329382e-11,17761808,1328804,1688650764
1328000,2079960336,81358401,1.0983384135e-11,17783540,1328304,1689979068
1328500,2083745419,81359436,1.0983523860000002e-11,17817194,1328276,1691307344
1329000,2083773179,81349491,1.0982181285000002e-11,17493964,1329660,1692637004
1329500,2080505285,81640290,1.102143915e-11,17220556,1328276,1693965280
1330000,2081006440,81348637,1.0982065995000001e-11,17466210,1327776,1695293056
1330500,2081883619,81359913,1.0983588255e-11,17832691,1327776,1696620832
1331000,2084220894,81357464,1.098325764e-11,17753116,1328804,1697949636
1331500,2071288371,81654968,1.1023420680000002e-11,17697594,1327812,1699277448
1332000,2090364134,81357548,1.0983268980000001e-11,17755824,1328768,1700606216
1332500,2087638091,81356410,1.098311535e-11,17718846,1327312,1701933528
1333000,2187406297,81356952,1.0983188520000002e-11,17736441,1330136,1703263664
1333500,2111534758,81357641,1.0983281535e-11,17758861,1328268,1704591932
1334000,2108449494,81652649,1.1023107615000001e-11,17622218,1327312,1705919244
1334500,2112978348,81355920,1.09830492e-11,17702919,1328268,1707247512
1335000,2196590940,81357700,1.09832895e-11,17760773,1328772,1708576284
1335500,3353347212,81360104,1.0983614040000001e-11,17838890,1328304,1709904588
1336000,14303792697,81984013,1.1067841755000001e-11,17694714,1328312,1711232900
1336500,2175157913,81356128,1.098307728e-11,17709464,1328804,1712561704
1337000,2090282441,81341304,1.098107604e-11,17227880,1331556,1713893260
1337500,2084713844,81339734,1.098086409e-11,17176886,1328312,1715221572
1338000,2082937055,81638744,1.1021230440000001e-11,17170302,1328304,1716549876
1338500,2085849024,81352084,1.0982531340000002e-11,17578254,1327804,1717877680
1339000,2085790323,81355886,1.098304461e-11,17701817,1329688,1719207368
1339500,2077970658,81358835,1.0983442725000001e-11,17797654,1328812,1720536180
1340000,2090919283,81359470,1.0983528450000002e-11,17818285,1330180,1721866360
1340500,2213495063,81360021,1.0983602835e-11,17836208,1328284,1723194644
1341000,2184777428,81361896,1.098385596e-11,17897155,1329276,1724523920
1341500,2083757337,81359698,1.098355923e-11,17825711,1327768,1725851688
1342000,2109737029,81357763,1.0983298005e-11,17762813,1328784,1727180472
1342500,2331371172,81660671,1.1024190585e-11,17882926,1328776,1728509248
1343000,2131351647,81361371,1.0983785085e-11,17880059,1329284,1729838532
1343500,2117730746,81357472,1.098325872e-11,17753375,1327284,1731165816
1344000,6578443201,81369485,1.0984880475000001e-11,18143779,1329680,1732495496
1344500,8779692292,81985172,1.1067998220000001e-11,17732378,1328776,1733824272
1345000,2126842673,81358033,1.0983334455000001e-11,17771579,1328760,1735153032
1345500,2128575133,81362108,1.098388458e-11,17904009,1330768,1736483800
1346000,2111025550,81359055,1.0983472425000001e-11,17804793,1330132,1737813932
1346500,2093578692,81357108,1.0983209580000001e-11,17741521,1329264,1739143196
1347000,2085439829,81654732,1.102338882e-11,17689919,1328276,1740471472
1347500,2085505656,81355386,1.098297711e-11,17685552,1329304,1741800776
1348000,2088486915,81357350,1.098324225e-11,17749394,1328804,1743129580
1348500,2076410560,81355968,1.0983055680000001e-11,17704465,1328284,1744457864
1349000,2105593292,81357877,1.0983313395e-11,17766308,1328304,1745786168
1349500,2179056535,81657882,1.102381407e-11,17792290,1329312,1747115480
1350000,2091693294,81357101,1.0983208635e-11,17741298,1328284,1748443764
1350500,2158483778,81360097,1.0983613095e-11,17838670,1328804,1749772568
1351000,2147976563,81343222,1.098133497e-11,17290245,1328784,1751101352
1351500,2109797347,81652225,1.1023050375e-11,17608456,1328312,1752429664
1352000,2110772669,81359389,1.0983517515e-11,17815657,1329172,1753758836
1352500,2111341498,81356254,1.098309429e-11,17713778,1328312,1755087148
1353000,3351608347,81358328,1.098337428e-11,17781184,1328304,1756415452
1353500,6687486754,81657608,1.102377708e-11,17783396,1328812,1757744264
1354000,2128110493,81359968,1.0983595679999999e-11,17834477,1329688,1759073952
1354500,2098522730,81358067,1.0983339045e-11,17772700,1327804,1760401756
1355000,2100373674,81657343,1.1023741305e-11,17774780,1327804,1761729560
1355500,2098316594,81359263,1.0983500505000002e-11,17811550,1328804,1763058364
1356000,2094351835,81356870,1.0983177450000001e-11,17733786,1328812,1764387176
1356500,2087119176,81357839,1.0983308265e-11,17765272,1328804,1765715980
1357000,2089601586,81655667,1.1023515045000001e-11,17720296,1328804,1767044784
1357500,2081856653,81348650,1.0982067750000002e-11,17466638,1329152,1768373936
1358000,2078276965,81338619,1.0980713565000002e-11,17140633,1327784,1769701720
1358500,2099152750,81338420,1.0980686700000001e-11,17134174,1328312,1771030032
1359000,2105995294,81348349,1.0982027115e-11,17456866,1328812,1772358844
1359500,2083595452,81653934,1.102328109e-11,17663997,1329276,1773688120
1360000,2159149337,81349626,1.0982199510000002e-11,17498352,1328312,1775016432
1360500,2259890441,81360799,1.0983707865000001e-11,17861496,1329312,1776345744
1361000,2151920319,81357396,1.0983248460000001e-11,17750894,1329804,1777675548
1361500,2310486725,81358786,1.098343611e-11,17795830,1327812,1779003360
1362000,5266522061,81659310,1.102400685e-11,17838699,1330180,1780333540
1362500,8734763849,81772875,1.1039338125e-11,17639805,1328280,1781661820
1363000,2097897471,81356013,1.0983061755e-11,17705940,1328304,1782990124
1363500,2092115032,81359460,1.0983527100000001e-11,17817968,1328304,1784318428
1364000,2080509026,81359168,1.098348768e-11,17808478,1328304,1785646732
1364500,2089378967,81360474,1.0983663990000001e-11,17850925,1329160,1786975892
1365000,2081852380,81650654,1.1022838290000002e-11,17557395,1330164,1788306056
1365500,2085228999,81343250,1.0981338750000001e-11,17291148,1328812,1789634868
1366000,2091666960,81339123,1.0980781604999999e-11,17156998,1328804,1790963672
1366500,2076114839,81341209,1.0981063215000001e-11,17224802,1328804,1792292476
1367000,2073366748,81352883,1.0982639205e-11,17604211,1329172,1793621648
1367500,2087499243,81654399,1.1023343865e-11,17679092,1328784,1794950432
1368000,2139361204,81355125,1.0982941875000002e-11,17677068,1327296,1796277728
1368500,2115125079,81357891,1.0983315285e-11,17766982,1328312,1797606040
1369000,2104892351,81354087,1.0982801744999999e-11,17643333,1329180,1798935220
1369500,2106112257,81657349,1.1023742115e-11,17774976,1328296,1800263516
1370000,2106834378,81357743,1.0983295305000001e-11,17762170,1328812,1801592328
1370500,2164422429,81363455,1.0984066425000001e-11,17947807,1330188,1802922516
1371000,2125021837,81357119,1.0983211065e-11,17741883,1328260,1804250776
1371500,2118728039,81355726,1.0983023010000002e-11,17696602,1328276,1805579052
1372000,11309183269,81955541,1.1063998035e-11,17741810,1328660,1806907712
1372500,2100520485,81343875,1.0981423125e-11,17311441,1328784,1808236496
1373000,2096642726,81361316,1.098377766e-11,17878268,1329304,1809565800
1373500,2115974429,81360179,1.0983624165e-11,17841343,1328784,1810894584
1374000,2067090039,81659567,1.1024041545e-11,17846786,1329276,1812223860
1374500,2088119624,81360348,1.0983646980000001e-11,17846812,1328268,1813552128
1375000,2085273346,81358132,1.098334782e-11,17774812,1328784,1814880912
1375500,2073344968,81363909,1.0984127715e-11,17962557,1328284,1816209196
1376000,2071894981,81358668,1.0983420180000001e-11,17792216,1328796,1817537992
1376500,2089202808,81657501,1.1023762635e-11,17779921,1329780,1818867772
1377000,2073823936,81357508,1.0983263580000001e-11,17754530,1327812,1820195584
1377500,2084081178,81357744,1.098329544e-11,17762204,1328796,1821524380
1378000,2094331411,81357486,1.098326061e-11,17753824,1328304,1822852684
1378500,2079198496,81361229,1.0983765915e-11,17875448,1329648,1824182332
1379000,2097948743,81656618,1.102364343e-11,17751212,1327812,1825510144
1379500,2250135182,81358970,1.098346095e-11,17802050,1329268,1826839412
1380000,2084814596,81351713,1.0982481255e-11,17566179,1329688,1828169100
1380500,2112904996,81352207,1.0982547945000001e-11,17582257,1329268,1829498368
1381000,2117658214,81353979,1.0982787165e-11,17639842,1328812,1830827180
1381500,6632267500,81639836,1.102137786e-11,17205816,1328304,1832155484
1382000,3347043159,81640970,1.1021530950000001e-11,17242657,1329660,1833485144
1382500,2110170750,81343842,1.0981418670000001e-11,17310386,1328296,1834813440
1383000,2103145841,81356110,1.0983074850000002e-11,17709094,1329260,1836142700
1383500,2103220967,81358343,1.0983376305000001e-11,17781650,1328312,1837471012
1384000,2073590492,81358396,1.098338346e-11,17783380,1327296,1838798308
1384500,2100159355,81658545,1.1023903575e-11,17813843,1328652,1840126960
1385000,2082067857,81353339,1.0982700765000002e-11,17619044,1328276,1841455236
1385500,2085473584,81361801,1.0983843135e-11,17894066,1328312,1842783548
1386000,2080375289,81358227,1.0983360645e-11,17777898,1328284,1844111832
1386500,2159278328,81655198,1.102345173e-11,17704746,1328312,1845440144
1387000,2114378234,81354824,1.098290124e-11,17667312,1330056,1846770200
1387500,2163056224,81335700,1.09803195e-11,17045784,1328804,1848099004
1388000,2103588703,81337676,1.0980586260000001e-11,17110000,1328296,1849427300
1388500,2162622369,81342023,1.0981173105e-11,17251265,1330172,1850757472
1389000,2116210833,81653959,1.1023284465e-11,17664794,1329304,1852086776
1389500,2115508329,81355828,1.0983036780000001e-11,17699938,1328296,1853415072
1390000,2111265973,81354140,1.0982808900000002e-11,17645079,1328680,1854743752
1390500,3476587586,81362954,1.098399879e-11,17931526,1328284,1856072036
1391000,14271779171,82014516,1.107195966e-11,17713657,1328784,1857400820
1391500,2126878807,81354523,1.0982860605e-11,17657515,1328276,1858729096
1392000,2088253981,81352665,1.0982609775e-11,17597142,1328284,1860057380
1392500,2089350630,81356383,1.0983111705000002e-11,17717965,1328284,1861385664
1393000,2082926050,81656126,1.102357701e-11,17735229,1328784,1862714448
1393500,2084771625,81354530,1.0982861550000001e-11,17657749,1327784,1864042232
1394000,2082167656,81356055,1.0983067425e-11,17707317,1329284,1865371516
1394500,2074442147,81349999,1.0982249865e-11,17510468,1329656,1866701172
1395000,2079138162,81336334,1.098040509e-11,17066375,1327764,1868028936
1395500,2079158283,81649051,1.1022621885e-11,17505279,1328784,1869357720
1396000,2078903133,81354757,1.0982892195e-11,17665112,1328296,1870686016
1396500,2078284197,81354900,1.0982911500000001e-11,17669774,1328312,1872014328
1397000,2075757519,81353205,1.0982682675000002e-11,17614671,1328784,1873343112
1397500,2071643341,81653716,1.102325166e-11,17656904,1328304,1874671416
1398000,2167265221,81355832,1.0983037320000002e-11,17700051,1328776,1876000192
1398500,2102441885,81356031,1.0983064185e-11,17706515,1329280,1877329472
1399000,2099153893,81356251,1.0983093885000002e-11,17713344,1328776,1878658248
1399500,2100937636,81355745,1.0983025575e-11,17697236,1329788,1879988036
1400000,2129313773,81657875,1.1023813125000001e-11,17792074,1330112,1881318148
1400500,2128035776,81356946,1.0983187710000002e-11,17736251,1328268,1882646416
1401000,2133686787,81356362,1.098310887e-11,17717296,1328760,1883975176
1401500,3442431233,81353842,1.098276867e-11,17635396,1328304,1885303480
1402000,8810764802,81684347,1.1027386845e-11,17679974,1330556,1886634036
1402500,2104283684,81336623,1.0980444105000001e-11,17075758,1328796,1887962832
1403000,2105298363,81637257,1.1021029695000001e-11,17121984,1327296,1889290128
1403500,2073632065,81341447,1.0981095345e-11,17232549,1329672,1890619800
1404000,2114495133,81360177,1.0983623895000002e-11,17841258,1330296,1891950096
1404500,2107912116,81356257,1.0983094695e-11,17713874,1327796,1893277892
1405000,2078671157,81657363,1.1023744005e-11,17775413,1330688,1894608580
1405500,2085147716,81358346,1.0983376710000001e-11,17781760,1328784,1895937364
1406000,2288523805,81345397,1.0981628595e-11,17360919,1329276,1897266640
1406500,2102398183,81344840,1.09815534e-11,17342828,1327812,1898594452
1407000,2165015255,81345966,1.098170541e-11,17379406,1328812,1899923264
1407500,2271491130,81645768,1.1022178680000001e-11,17398583,1329268,1901252532
1408000,2091593280,81345532,1.0981646820000002e-11,17365298,1327768,1902580300
1408500,2176594019,81347452,1.0981906020000002e-11,17427719,1330280,1903910580
1409000,2185475383,81353252,1.098268902e-11,17616201,1328784,1905239364
1409500,2174482696,81359028,1.098346878e-11,17803918,1329660,1906569024
1410000,6609314455,81648910,1.102260285e-11,17500714,1327296,1907896320
1410500,11308250120,81827243,1.1046677805e-11,17461893,1328284,1909224604
1411000,2100750673,81339156,1.0980786060000002e-11,17158074,1328812,1910553416
1411500,2090763626,81342845,1.0981284075e-11,17277638,1329268,1911882684
1412000,2086093195,81358057,1.0983337695e-11,17772364,1327796,1913210480
1412500,2086452860,81656318,1.102360293e-11,17741453,1328280,1914538760
1413000,2078463230,81359012,1.0983466620000001e-11,17803396,1328812,1915867572
1413500,2086213329,81360727,1.0983698145000001e-11,17859148,1328648,1917196220
1414000,2084425851,81356890,1.098318015e-11,17734434,1328812,1918525032
1414500,2077391957,81358721,1.0983427335e-11,17793942,1328804,1919853836
1415000,2091514292,81658925,1.1023954875000002e-11,17826184,1329284,1921183120
1415500,2145193006,81364711,1.0984235985e-11,17988619,1330180,1922513300
1416000,2535494326,81355887,1.0983044745e-11,17701842,1328312,1923841612
1416500,2266545000,81357554,1.098326979e-11,17756018,1328312,1925169924
1417000,2360652506,81656203,1.1023587405e-11,17737722,1328812,1926498736
1417500,2109199902,81342934,1.0981296090000001e-11,17280863,1330492,1927829228
1418000,2124817304,81340533,1.0980971955e-11,17202850,1327804,1929157032
1418500,2126523605,81348547,1.0982053844999999e-11,17463289,1328280,1930485312
1419000,4956028798,81359469,1.0983528315000001e-11,17818268,1327812,1931813124
1419500,8826332157,81717228,1.103182578e-11,17776172,1329152,1933142276
1420000,2091409416,81656037,1.1023564995000001e-11,17732324,1327804,1934470080
1420500,2096436470,81360861,1.0983716235e-11,17863505,1329280,1935799360
1421000,2087784175,81353643,1.0982741805e-11,17628922,1328304,1937127664
1421500,2089065510,81356029,1.0983063915000001e-11,17706474,1327812,1938455476
1422000,2076016802,81655837,1.1023537995000002e-11,17725832,1328304,1939783780
1422500,2084383102,81357201,1.0983222135e-11,17744541,1329680,1941113460
1423000,2063431154,81356612,1.098314262e-11,17725400,1328312,1942441772
1423500,2101801297,81359485,1.0983530475e-11,17818788,1328812,1943770584
1424000,2146972845,81357755,1.0983296925000001e-11,17762156,1330564,1945101148
1424500,2089237302,81642616,1.102175316e-11,17296130,1328812,1946429960
1425000,2180309472,81344394,1.098149319e-11,17328328,1328812,1947758772
1425500,2091717108,81357979,1.0983327165e-11,17769824,1329312,1949088084
1426000,2098321641,81345612,1.098165762e-11,17367926,1328812,1950416896
1426500,2108813140,81660003,1.1024100405000001e-11,17861233,1328272,1951745168
1427000,2085001767,81361623,1.0983819105e-11,17888255,1328776,1953073944
1427500,2282173865,81360865,1.0983716775000001e-11,17863641,1328276,1954402220
1428000,6585935147,81360402,1.0983654270000001e-11,17848591,1328776,1955730996
1428500,3379620700,81660496,1.102416696e-11,17877252,1328268,1957059264
1429000,2099391321,81360673,1.0983690855e-11,17857400,1328284,1958387548
1429500,2102237089,81360443,1.0983659805000001e-11,17849926,1328784,1959716332
1430000,2102545815,81659397,1.1024018595000001e-11,17841521,1328780,1961045112
1430500,2097738996,81362601,1.0983951135e-11,17920045,1328776,1962373888
1431000,2094049893,81356157,1.0983081195e-11,17710636,1329296,1963703184
1431500,2089963449,81357071,1.0983204585e-11,17740337,1329284,1965032468
1432000,2086974419,81656891,1.1023680285000002e-11,17760092,1329796,1966362264
1432500,2083322530,81348253,1.0982014155000001e-11,17453729,1329688,1967691952
1433000,2096320411,81343111,1.0981319985000002e-11,17286615,1329688,1969021640
1433500,2106344182,81356284,1.0983098340000001e-11,17714737,1329276,1970350916
1434000,2224089760,81655475,1.1023489125e-11,17714075,1327776,1971678692
1434500,2085859644,81358014,1.098333189e-11,17770976,1329804,1973008496
1435000,2211879301,81358466,1.0983392909999999e-11,17785650,1328296,1974336792
1435500,2119209519,81361794,1.098384219e-11,17893812,1328812,1975665604
1436000,2145373078,81355915,1.0983048525e-11,17702748,1328312,1976993916
1436500,2117432069,81657989,1.1023828515e-11,17795376,1328804,1978322720
1437000,2092931326,81358241,1.0983362535000002e-11,17778363,1329188,1979651908
1437500,2123483740,81358470,1.098339345e-11,17785790,1329812,1980981720
1438000,2146562134,81357271,1.0983231584999999e-11,17746820,1328304,1982310024
1438500,6637735677,81808157,1.1044101195e-11,17814032,1328804,1983638828
1439000,2093863240,81358755,1.0983431925e-11,17795051,1329680,1984968508
1439500,2092719342,81356466,1.098312291e-11,17720656,1331028,1986299536
1440000,2090983639,81353176,1.098267876e-11,17613722,1328804,1987628340
1440500,2087850632,81357888,1.098331488e-11,17766879,1330160,1988958500
1441000,2087083324,81649395,1.1022668325000001e-11,17516454,1328304,1990286804
1441500,2085900499,81339303,1.0980805905e-11,17162874,1328312,1991615116
1442000,2064802541,81352628,1.098260478e-11,17595916,1327304,1992942420
1442500,2087703958,81354356,1.0982838060000002e-11,17652096,1329160,1994271580
1443000,2079634099,81357513,1.0983264255000001e-11,17754702,1328296,1995599876
1443500,2086087195,81656831,1.1023672185e-11,17758142,1328304,1996928180
1444000,2079187590,81357853,1.0983310155000002e-11,17765731,1329188,1998257368
1444500,2099599393,81354737,1.0982889495000001e-11,17664463,1328772,1999586140
1445000,2092253345,81356566,1.0983136410000001e-11,17723926,1328304,2000914444
1445500,2085864760,81658145,1.1023849575000001e-11,17800833,1329688,2002244132
1446000,2095506268,81345334,1.098162009e-11,17358871,1330500,2003574632
1446500,2100825346,81355538,1.0982997630000001e-11,17690493,1328784,2004903416
1447000,2104705057,81341749,1.0981136115e-11,17242370,1329276,2006232692
1447500,2107926412,81336182,1.098038457e-11,17061447,1327780,2007560472
1448000,2129606384,81638356,1.102117806e-11,17157716,1328784,2008889256
1448500,2151894114,81345241,1.0981607535000002e-11,17355854,1329776,2010219032
1449000,4846929740,81357101,1.0983208635e-11,17740888,1328312,2011547344
1449500,3408859565,81715943,1.1031652305e-11,17734419,1328256,2012875600
1450000,2110217547,81355853,1.0983040155e-11,17700757,1328768,2014204368
1450500,2104409983,81361493,1.0983801555000001e-11,17884041,1328780,2015533148
1451000,2074912624,81356336,1.098310536e-11,17716435,1328768,2016861916
1451500,2104690922,81356310,1.0983101850000001e-11,17715580,1327312,2018189228
1452000,2087476602,81656154,1.102358079e-11,17736143,1329660,2019518888
1452500,2085086423,81353235,1.0982686725000001e-11,17615640,1328312,2020847200
1453000,2077625995,81356787,1.0983166245e-11,17731082,1328312,2022175512
1453500,2078071137,81348464,1.098204264e-11,17460589,1329680,2023505192
1454000,2226857282,81643146,1.102182471e-11,17313363,1330180,2024835372
1454500,2119394724,81358803,1.0983438405000001e-11,17796608,1328812,2026164184
1455000,2107985794,81358701,1.0983424635000002e-11,17793288,1329312,2027493496
1455500,2165533264,81356521,1.0983130335e-11,17722442,1328304,2028821800
1456000,2130030455,81355480,1.0982989800000001e-11,17688603,1327780,2030149580
1456500,2148766849,81656552,1.102363452e-11,17749055,1328760,2031478340
1457000,2112451689,81358594,1.0983410190000002e-11,17789823,1329784,2032808124
1457500,2107767360,81355711,1.0983020985e-11,17696133,1328284,2034136408
1458000,4836058492,81357377,1.0983245895e-11,17750282,1328804,2035465212
1458500,11267414253,81983869,1.1067822315000001e-11,17690040,1327812,2036793024
1459000,2088178398,81355403,1.0982979405000001e-11,17686103,1327768,2038120792
1459500,2086146959,81356015,1.0983062025e-11,17705993,1328768,2039449560
1460000,2086558429,81356178,1.0983084030000001e-11,17711304,1328776,2040778336
1460500,2079327301,81660414,1.102415589e-11,17874590,1328812,2042107148
1461000,2087248287,81356575,1.0983137625e-11,17724188,1329804,2043436952
1461500,2078223460,81349158,1.098213633e-11,17482709,1329688,2044766640
1462000,2081943775,81339743,1.0980865305e-11,17177168,1329284,2046095924
1462500,2076610423,81346454,1.098177129e-11,17395270,1328812,2047424736
1463000,2096902209,81641758,1.1021637330000002e-11,17268262,1327304,2048752040
1463500,2067212218,81344535,1.0981512225e-11,17332892,1328804,2050080844
1464000,2076706666,81357617,1.0983278295000001e-11,17758064,1328284,2051409128
1464500,2127393271,81357805,1.0983303675e-11,17764184,1327784,2052736912
1465000,2108463311,81358254,1.098336429e-11,17778762,1328312,2054065224
1465500,2108022600,81657334,1.102374009e-11,17774472,1327784,2055393008
1466000,2107807411,81355025,1.0982928375000002e-11,17673841,1328784,2056721792
1466500,2138188517,81355368,1.0982974680000001e-11,17684968,1328812,2058050604
1467000,6622459677,81356135,1.0983078225000001e-11,17709916,1328644,2059379248
1467500,8825957260,81984378,1.106789103e-11,17706593,1329284,2060708532
1468000,2099719047,81356286,1.0983098610000002e-11,17714812,1328804,2062037336
1468500,2093931282,81357303,1.0983235905e-11,17747849,1329144,2063366480
1469000,2086584119,81356141,1.0983079035000001e-11,17710096,1329152,2064695632
1469500,2089444794,81355985,1.0983057975e-11,17705038,1328812,2066024444
1470000,2089687405,81655333,1.1023469955e-11,17709452,1327812,2067352256
1470500,2084345068,81361433,1.0983793455000001e-11,17882084,1329796,2068682052
1471000,2084184655,81372681,1.0985311935000001e-11,18247650,1329304,2070011356
1471500,2072410386,81369906,1.098493731e-11,18157470,1327304,2071338660
1472000,2234934726,81671096,1.102559796e-11,18221752,1328312,2072666972
1472500,2172558192,81373317,1.0985397795e-11,18268309,1329664,2073996636
1473000,2090955013,81373107,1.0985369445e-11,18261500,1328304,2075324940
1473500,2142195478,81373500,1.09854225e-11,18274266,1328304,2076653244
1474000,2139049346,81370650,1.0985037750000002e-11,18181175,1329180,2077982424
1474500,2187058127,81667621,1.1025128835e-11,18108818,1328812,2079311236
1475000,2203644777,81375308,1.098566658e-11,18333010,1329312,2080640548
1475500,2120604380,81376973,1.0985891355e-11,18387128,1328288,2081968836
1476000,6679445829,81358234,1.0983361590000001e-11,17778131,1329268,2083298104
1476500,8673932974,81988216,1.1068409160000001e-11,17831309,1328784,2084626888
1477000,2096581169,81374386,1.098554211e-11,18303053,1328776,2085955664
1477500,2087430023,81371349,1.0985132115000001e-11,18204366,1328776,2087284440
1478000,2078798394,81373562,1.0985430869999999e-11,18276273,1328764,2088613204
1478500,2081510703,81373469,1.0985418315e-11,18273262,1327776,2089940980
1479000,2077822221,81674306,1.1026031310000001e-11,18326071,1329284,2091270264
1479500,2075623123,81373332,1.098539982e-11,18268815,1328272,2092598536
1480000,2079439227,81377610,1.098597735e-11,18407850,1330284,2093928820
1480500,2079851956,81379132,1.0986182820000002e-11,18457324,1328776,2095257596
1481000,2099233651,81374505,1.0985558175000001e-11,18306934,1329268,2096586864
1481500,2063272757,81375519,1.0985695065000001e-11,18339880,1328312,2097915176
1482000,2072986920,81373883,1.0985474205e-11,18286700,1328804,2099243980
1482500,2105660592,81372581,1.0985298435e-11,18244393,1328280,2100572260
1483000,2087219691,81372518,1.098528993e-11,18242350,1327776,2101900036
1483500,2083320489,81668426,1.102523751e-11,18134963,1329612,2103229648
1484000,2098462318,81356308,1.098310158e-11,17715522,1328776,2104558424
1484500,2175804877,81358858,1.098344583e-11,17798400,1328304,2105886728
1485000,2190003459,81360654,1.098368829e-11,17856764,1328276,2107215004
1485500,2264824199,81675652,1.102621302e-11,18369802,1328784,2108543788
1486000,4869958458,81364945,1.0984267575e-11,17996222,1329784,2109873572
1486500,6604889892,81699499,1.1029432365000001e-11,18171944,1327776,2111201348
1487000,2106899739,81374081,1.0985500935000002e-11,18293152,1328312,2112529660
1487500,2127270659,81374620,1.09855737e-11,18310680,1328804,2113858464
1488000,2096264580,81372709,1.0985315715e-11,18248560,1328252,2115186716
1488500,2093175652,81376933,1.0985885955e-11,18385839,1328784,2116515500
1489000,2089416128,81674055,1.1025997425000002e-11,18317909,1329256,2117844756
1489500,2091985954,81373818,1.0985465430000001e-11,18284605,1328776,2119173532
1490000,2086530208,81373936,1.0985481360000001e-11,18288434,1328812,2120502344
1490500,2077183197,81374841,1.0985603535000001e-11,18317846,1328312,2121830656
1491000,2089189331,81670992,1.102558392e-11,18218380,1328296,2123158952
1491500,2174131432,81372638,1.0985306130000001e-11,18246246,1328804,2124487756
1492000,2160803232,81360371,1.0983650085000001e-11,17847563,1329180,2125816936
1492500,2089900732,81354720,1.09828872e-11,17663913,1330160,2127147096
1493000,2111181869,81356718,1.098315693e-11,17728858,1328312,2128475408
1493500,2155858301,81655156,1.102344606e-11,17703684,1328284,2129803692
1494000,2264184965,81366764,1.0984513140000002e-11,18055360,1327796,2131131488
1494500,2131530125,81375439,1.0985684265e-11,18337297,1330664,2132462152
1495000,3429036193,81371890,1.098520515e-11,18221934,1328796,2133790948
1495500,11435337925,81733566,1.103403141e-11,18307153,1328284,2135119232
1496000,2098758039,81666916,1.102503366e-11,18085900,1328312,2136447544
1496500,2093727464,81369269,1.0984851315e-11,18136776,1329304,2137776848
1497000,2085729225,81366837,1.0984522995e-11,18057725,1329688,2139106536
1497500,2085235461,81369669,1.0984905315000001e-11,18149748,1329312,2140435848
1498000,2085454359,81668830,1.1025292050000001e-11,18148112,1328304,2141764152
1498500,2083341987,81365604,1.0984356540000002e-11,18017628,1330048,2143094200
1499000,2081497639,81355055,1.0982932425000001e-11,17674204,1329312,2144423512
1499500,2081434030,81353940,1.0982781900000002e-11,17638574,1328812,2145752324
1500000,2059077234,81355920,1.09830492e-11,17702927,1330688,2147083012
1500500,2088744823,81670256,1.102548456e-11,18194443,1329160,2148412172
1501000,2075612688,81371726,1.098518301e-11,18216600,1328796,2149740968
1501500,2076954157,81368748,1.098478098e-11,18119812,1328796,2151069764
1502000,2127247987,81373375,1.0985405625e-11,18270204,1328312,2152398076
1502500,2062865928,81671457,1.1025646695e-11,18233497,1329132,2153727208
1503000,2197607769,81369489,1.0984881015000002e-11,18143924,1328268,2155055476
1503500,2114779537,81370298,1.0984990230000001e-11,18170196,1328812,2156384288
1504000,2123050861,81371549,1.0985159115e-11,18210858,1328312,2157712600
1504500,2100098943,81372691,1.0985313285e-11,18247984,1329152,2159041752
1505000,2111239136,81666591,1.1024989785000001e-11,18075336,1328652,2160370404
1505500,2106887054,81364460,1.09842021e-11,17980455,1328780,2161699184
1506000,2116424699,81360195,1.0983626325000001e-11,17841851,1329784,2163028968
1506500,3403151135,81351863,1.0982501505000002e-11,17571069,1329172,2164358140
1507000,6644472096,81714924,1.103151474e-11,17701301,1328776,2165686916
1507500,2106099688,81366405,1.0984464675000002e-11,18043674,1327804,2167014720
1508000,2098911205,81373230,1.0985386050000001e-11,18265491,1329660,2168344380
1508500,2098401186,81665154,1.102479579e-11,18028619,1328284,2169672664
1509000,2095682738,81373630,1.0985440050000002e-11,18278490,1328304,2171000968
1509500,2091293663,81374296,1.0985529960000002e-11,18300145,1329280,2172330248
1510000,2067045619,81374218,1.0985519430000001e-11,18297613,1330164,2173660412
1510500,2109791274,81374578,1.098556803e-11,18309311,1328284,2174988696
1511000,2170388247,81670660,1.1025539100000001e-11,18207590,1328752,2176317448
1511500,2086759024,81367237,1.0984576995000001e-11,18070110,1330564,2177648012
1512000,2080480614,81355304,1.0982966040000002e-11,17682886,1328284,2178976296
1512500,2126442645,81353838,1.098276813e-11,17635266,1328812,2180305108
1513000,2132488957,81656417,1.1023616295e-11,17744687,1329660,2181634768
1513500,2118717832,81369265,1.0984850775e-11,18136638,1328312,2182963080
1514000,2162795066,81374111,1.0985504985000001e-11,18294108,1329312,2184292392
1514500,2101085599,81373581,1.0985433435e-11,18276916,1329804,2185622196
1515000,2177618067,81371773,1.0985189355000002e-11,18218157,1330180,2186952376
1515500,6628039376,81735782,1.1034330570000001e-11,18379165,1328784,2188281160
1516000,8713408426,81732797,1.1033927595e-11,18282166,1328768,2189609928
1516500,2093230918,81372756,1.098532206e-11,18250089,1329680,2190939608
1517000,2091863010,81369143,1.0984834305000001e-11,18132666,1328276,2192267884
1517500,2086224251,81370661,1.0985039235e-11,18181998,1328804,2193596688
1518000,2088636262,81367236,1.098457686e-11,18070690,1327804,2194924492
1518500,2075544628,81661538,1.102430763e-11,17911120,1330556,2196255048
1519000,2084890965,81355393,1.0982978055e-11,17685802,1329812,2197584860
1519500,2086596494,81370174,1.0984973490000001e-11,18166180,1327812,2198912672
1520000,2083689076,81371596,1.0985165460000001e-11,18212394,1328288,2200240960
1520500,2097597498,81674100,1.10260035e-11,18319362,1329156,2201570116
1521000,2162243020,81372915,1.0985343525e-11,18255252,1328776,2202898892
1521500,2162982627,81371248,1.0985118480000001e-11,18201059,1330180,2204229072
1522000,2172565413,81365820,1.0984385699999999e-11,18024686,1328312,2205557384
1522500,2252874222,81669401,1.1025369135e-11,18166672,1328304,2206885688
1523000,2317816241,81371662,1.0985174370000001e-11,18214544,1328776,2208214464
1523500,2200319983,81371520,1.09851552e-11,18209904,1328304,2209542768
1524000,2146111881,81371188,1.098511038e-11,18198505,1329688,2210872456
1524500,4924419085,81370536,1.0985022360000001e-11,18177918,1328784,2212201240
1525000,11327263256,82021261,1.1072870235000002e-11,17932853,1330680,2213531920
1525500,2091981150,81363357,1.0984053195000001e-11,17944622,1329304,2214861224
1526000,2082170439,81366460,1.09844721e-11,18045471,1328276,2216189500
1526500,2088941552,81372210,1.0985248350000001e-11,18232339,1329652,2217519152
1527000,2084388059,81668100,1.10251935e-11,18124372,1327812,2218846964
1527500,2093884192,81373495,1.0985421825e-11,18274092,1329804,2220176768
1528000,2064926138,81374723,1.0985587605e-11,18314014,1328804,2221505572
1528500,2080940531,81375376,1.0985675760000002e-11,18335220,1328296,2222833868
1529000,2148300759,81373610,1.098543735e-11,18277845,1329660,2224163528
1529500,2071965340,81674045,1.1025996075000001e-11,18317594,1328776,2225492304
1530000,2096196549,81375011,1.0985626485e-11,18323365,1328280,2226820584
1530500,2150631749,81376058,1.098576783e-11,18357398,1327312,2228147896
1531000,2108345617,81371936,1.098521136e-11,18223434,1329276,2229477172
1531500,2170201188,81671239,1.1025617265e-11,18226394,1327296,2230804468
1532000,2148925318,81370497,1.0985017095e-11,18176658,1330564,2232135032
1532500,2129981341,81356677,1.0983151394999999e-11,17727520,1328812,2233463844
1533000,2125448729,81355900,1.0983046500000001e-11,17702264,1328304,2234792148
1533500,5023048122,81355529,1.0982996415e-11,17690222,1328652,2236120800
1534000,4853528626,81732605,1.1033901675e-11,18275912,1328812,2237449612
1534500,2106553212,81371582,1.098516357e-11,18211940,1328312,2238777924
1535000,2101381330,81373426,1.098541251e-11,18271860,1328304,2240106228
1535500,2088986206,81673550,1.102592925e-11,18301509,1328688,2241434916
1536000,2093084226,81376888,1.0985879880000001e-11,18384367,1329276,2242764192
1536500,2089355836,81373900,1.09854765e-11,18286635,1330188,2244094380
1537000,2083169931,81373573,1.0985432355e-11,18276642,1328304,2245422684
1537500,2082698495,81669485,1.1025380475e-11,18169382,1327804,2246750488
1538000,2096939147,81369987,1.0984948245e-11,18160086,1327312,2248077800
1538500,2098369486,81370976,1.098508176e-11,18192244,1328812,2249406612
1539000,2266931591,81367123,1.0984561605e-11,18067013,1329160,2250735772
1539500,2235575552,81357743,1.0983295305000001e-11,17762162,1328312,2252064084
1540000,2232805841,81357366,1.098324441e-11,17749905,1329652,2253393736
1540500,2153829215,81362392,1.098392292e-11,17913274,1328304,2254722040
1541000,2132847578,81367234,1.098457659e-11,18070621,1329768,2256051808
1541500,2280862783,81368891,1.0984800285000001e-11,18124483,1329188,2257380996
1542000,2219277893,81669574,1.1025392490000001e-11,18172294,1329312,2258710308
1542500,2231089008,81372956,1.098534906e-11,18256574,1328784,2260039092
1543000,2140613945,81372436,1.0985278860000002e-11,18239676,1329304,2261368396
1543500,4874073544,81370851,1.0985064885e-11,18188176,1329632,2262698028
1544000,11469679660,82030929,1.1074175415000001e-11,18247058,1328804,2264026832
1544500,2104832541,81372382,1.098527157e-11,18237926,1329804,2265356636
1545000,2124752376,81371547,1.0985158845000001e-11,18210799,1328688,2266685324
1545500,2101525583,81385807,1.0987083945000001e-11,18674231,1329144,2268014468
1546000,2098011607,81656671,1.1023650585e-11,17752922,1328784,2269343252
1546500,2099645335,81355852,1.098304002e-11,17700703,1328688,2270671940
1547000,2092283822,81368860,1.0984796100000002e-11,18123450,1328304,2272000244
1547500,2087708828,81374082,1.098550107e-11,18293178,1328804,2273329048
1548000,2085354383,81373873,1.0985472855000001e-11,18286400,1328296,2274657344
1548500,2081210346,81671738,1.102568463e-11,18242608,1328812,2275986156
1549000,2080586699,81373464,1.098541764e-11,18272430,1329652,2277315808
1549500,2134282349,81371641,1.0985171534999999e-11,18213863,1328276,2278644084
1550000,2193988832,81370052,1.0984957020000002e-11,18162188,1327304,2279971388
1550500,2153250152,81675000,1.1026125e-11,18348628,1327812,2281299200
1551000,2208932641,81373569,1.0985431815e-11,18276513,1328784,2282627984
1551500,2111096876,81368219,1.0984709565000001e-11,18102627,1328680,2283956664
1552000,2114032815,81366084,1.098442134e-11,18033254,1329148,2285285812
1552500,2153293940,81356060,1.0983068100000001e-11,17707464,1329288,2286615100
1553000,2165419001,81656196,1.102358646e-11,17737501,1328680,2287943780
1553500,2103425347,81375339,1.0985670765e-11,18334034,1329312,2289273092
1554000,3610696929,81370224,1.0984980240000002e-11,18167804,1327812,2290600904
1554500,6893568766,81669104,1.102532904e-11,18157006,1327812,2291928716
1555000,11457618181,81790568,1.104172668e-11,18214831,1328688,2293257404
1555500,2114740814,81377534,1.0985967090000001e-11,18405369,1329776,2294587180
1556000,2159279275,81376727,1.0985858145000001e-11,18379132,1329776,2295916956
1556500,2150320955,81370489,1.0985016015e-11,18176415,1330188,2297247144
1557000,2108384419,81670608,1.102553208e-11,18205894,1328312,2298575456
1557500,2106549897,81372184,1.0985244840000001e-11,18231482,1327812,2299903268
1558000,2100445140,81370039,1.0984955265000001e-11,18161793,1328680,2301231948
1558500,2104008151,81374441,1.0985549534999999e-11,18304842,1329660,2302561608
1559000,2091338417,81670018,1.102545243e-11,18186706,1327812,2303889420
1559500,2108913831,81373144,1.098537444e-11,18262683,1330188,2305219608
1560000,2178544506,81383981,1.0986837435000001e-11,18614892,1327312,2306546920
1560500,2236780398,81381260,1.0986470100000002e-11,18526457,1328280,2307875200
1561000,2087029035,81388011,1.0987381485e-11,18745883,1327776,2309202976
1561500,2114019624,81685886,1.102759461e-11,18701770,1327296,2310530272
1562000,2114597365,81388274,1.0987416990000001e-11,18754420,1329660,2311859932
1562500,2112234944,81388376,1.0987430760000002e-11,18757724,1328312,2313188244
1563000,2113263406,81387116,1.098726066e-11,18716768,1328812,2314517056
1563500,6693603011,81686428,1.1027667780000001e-11,18720029,1329680,2315846736
1564000,14274882240,81864847,1.1051754345e-11,18684030,1327804,2317174540
1564500,2094909853,81390729,1.0987748415e-11,18834198,1328804,2318503344
1565000,2086997858,81387943,1.0987372305e-11,18743656,1327804,2319831148
1565500,2085742034,81363524,1.0984075740000001e-11,17950032,1330056,2321161204
1566000,2082653877,81658140,1.10238489e-11,17800675,1328784,2322489988
1566500,2083618578,81356775,1.0983164625000001e-11,17730705,1329156,2323819144
1567000,2075031869,81357725,1.0983292875000002e-11,17761594,1328804,2325147948
1567500,2085783029,81371678,1.098517653e-11,18215054,1327804,2326475752
1568000,2091912245,81672487,1.1025785745e-11,18266966,1328804,2327804556
1568500,2123934461,81371745,1.0985185575e-11,18217220,1330152,2329134708
1569000,2079326461,81371895,1.0985205825e-11,18222108,1328312,2330463020
1569500,2226187154,81373352,1.0985402519999999e-11,18269446,1327804,2331790824
1570000,2119918638,81372496,1.098528696e-11,18241650,1327804,2333118628
1570500,2112273296,81378434,1.098608859e-11,18434629,1330688,2334449316
1571000,2094210587,81376418,1.098581643e-11,18369115,1328784,2335778100
1571500,2140599895,81374550,1.098556425e-11,18308397,1329688,2337107788
1572000,2251983636,81366371,1.0984460085e-11,18042587,1329180,2338436968
1572500,4868345912,81653483,1.1023220205e-11,17649316,1328812,2339765780
1573000,14493638922,81909048,1.1057721479999999e-11,18175662,1328312,2341094092
1573500,2092405282,81375740,1.09857249e-11,18347071,1330164,2342424256
1574000,2163192109,81372225,1.0985250375000001e-11,18232162,1328312,2343752568
1574500,2155031115,81373606,1.098543681e-11,18277700,1328780,2345081348
1575000,2115611283,81372935,1.0985346225e-11,18255911,1328660,2346410008
1575500,2115063370,81674516,1.1026059660000001e-11,18332906,1327812,2347737820
1576000,2112416698,81377969,1.0986025815000002e-11,18419523,1328784,2349066604
1576500,2100247157,81371980,1.09852173e-11,18224849,1328680,2350395284
1577000,2100868398,81369017,1.0984817295e-11,18128580,1327804,2351723088
1577500,2130535384,81670880,1.1025568799999999e-11,18214734,1329296,2353052384
1578000,2233828025,81372753,1.0985321655000001e-11,18249980,1328312,2354380696
1578500,2123755459,81373287,1.0985393745e-11,18267338,1331564,2355712260
1579000,2128947103,81362509,1.0983938715e-11,17917052,1327804,2357040064
1579500,2120631042,81672728,1.1025818280000002e-11,18274784,1327312,2358367376
1580000,2119985649,81374649,1.0985577615e-11,18311626,1328288,2359695664
1580500,2246938385,81366990,1.098454365e-11,18062694,1328304,2361023968
1581000,2109510845,81359428,1.098352278e-11,17816944,1329276,2362353244
1581500,2230182417,81374260,1.09855251e-11,18298987,1329688,2363682932
1582000,2583192516,81670980,1.1025582299999999e-11,18217990,1327304,2365010236
1582500,2192976535,81372583,1.0985298704999999e-11,18244448,1328296,2366338532
1583000,2129915059,81372836,1.098533286e-11,18252702,1328296,2367666828
1583500,5272025519,81372609,1.0985302215000001e-11,18245315,1329664,2368996492
1584000,6676527858,81703221,1.1029934835e-11,18293394,1328312,2370324804
1584500,2112804492,81379754,1.0986266790000001e-11,18477535,1331188,2371655992
1585000,2109778822,81669379,1.1025366165e-11,18165934,1327776,2372983768
1585500,2109395078,81371658,1.098517383e-11,18214415,1329172,2374312940
1586000,2104835113,81365694,1.098436869e-11,18020563,1328776,2375641716
1586500,2107597329,81357078,1.098320553e-11,17739852,1327812,2376969528
1587000,2098732332,81652207,1.1023047945e-11,17607859,1328664,2378298192
1587500,2097029774,81352740,1.09826199e-11,17599574,1329796,2379627988
1588000,2087445880,81366444,1.0984469940000001e-11,18044940,1327812,2380955800
1588500,2088907895,81374550,1.098556425e-11,18308397,1330180,2382285980
1589000,2130493014,81371555,1.0985159925e-11,18211038,1326804,2383612784
1589500,2086303607,81671425,1.1025642375e-11,18232432,1328812,2384941596
1590000,2088351820,81373511,1.0985423985000001e-11,18274630,1330652,2386272248
1590500,2083116294,81374512,1.098555912e-11,18307150,1327784,2387600032
1591000,2081717156,81374718,1.098558693e-11,18313849,1328284,2388928316
1591500,2098333481,81671750,1.1025686250000002e-11,18243014,1327796,2390256112
1592000,2104222908,81369109,1.0984829715000001e-11,18131558,1330564,2391586676
1592500,2280735185,81355731,1.0983023685e-11,17696779,1329280,2392915956
1593000,2275454196,81355336,1.098297036e-11,17683930,1328304,2394244260
1593500,2114367861,81657080,1.10237058e-11,17766215,1329180,2395573440
1594000,2276110293,81369231,1.0984846185e-11,18135536,1326804,2396900244
1594500,2237680310,81373081,1.0985365935e-11,18260666,1329312,2398229556
1595000,2270761733,81372463,1.0985282505000001e-11,18240566,1328796,2399558352
1595500,2187654767,81671590,1.102566465e-11,18237796,1327804,2400886156
1596000,3375505352,81372833,1.0985332455e-11,18252582,1329284,2402215440
1596500,8795874104,81368774,1.098478449e-11,18120662,1329152,2403544592
1597000,17984501224,82237796,1.110210246e-11,18163162,1327804,2404872396
1597500,2113636208,81370493,1.0985016555000001e-11,18176556,1328312,2406200708
1598000,2110680076,81367917,1.0984668795000001e-11,18092826,1328304,2407529012
1598500,2129479754,81369424,1.098487224e-11,18141813,1328188,2408857200
1599000,2114725626,81667596,1.102512546e-11,18107299,1329180,2410186380
1599500,2101411778,81353671,1.0982745585e-11,17629830,1327812,2411514192
1600000,2096953296,81366096,1.098442296e-11,18033656,1328312,2412842504
1600500,2094609657,81376712,1.0985856120000002e-11,18378657,1329652,2414172156
1601000,2100149292,81372558,1.098529533e-11,18243638,1328284,2415500440
1601500,2208590556,81372432,1.0985278320000001e-11,18239571,1327784,2416828224
1602000,2113392851,81369636,1.0984900860000002e-11,18148706,1328284,2418156508
1602500,2112840719,81372204,1.098524754e-11,18232147,1329280,2419485788
1603000,2326182699,81371151,1.0985105385e-11,18197936,1327804,2420813592
1603500,2237129128,81672479,1.1025784665e-11,18266702,1328812,2422142404
1604000,2248671041,81374130,1.098550755e-11,18294746,1329284,2423471688
1604500,2141427803,81371068,1.0985094180000001e-11,18195224,1328268,2424799956
1605000,2118049526,81375239,1.0985657265e-11,18330785,1329784,2426129740
1605500,3541564196,81674175,1.1026013625e-11,18321805,1328284,2427458024
1606000,7017140104,81373713,1.0985451255e-11,18281202,1329284,2428787308
1606500,8844503723,81792893,1.1042040555000001e-11,18290383,1329772,2430117080
1607000,2137358997,81367894,1.098466569e-11,18092068,1329652,2431446732
1607500,2081885782,81357046,1.0983201210000001e-11,17739523,1328276,2432775008
1608000,2104315399,81654968,1.1023420680000002e-11,17697584,1328784,2434103792
1608500,2103320019,81354748,1.098289098e-11,17664808,1327784,2435431576
1609000,2098851977,81359776,1.0983569760000001e-11,17828244,1328284,2436759860
1609500,2096114207,81374276,1.098552726e-11,18299495,1328280,2438088140
1610000,2093856014,81675193,1.1026151055e-11,18354910,1329768,2439417908
1610500,2109003494,81375993,1.0985759055e-11,18355302,1327784,2440745692
1611000,2093691173,81372852,1.0985335020000002e-11,18253201,1327776,2442073468
1611500,2089472664,81371879,1.0985203665000002e-11,18220851,1329688,2443403156
1612000,2090159937,81368123,1.0984696605e-11,18099510,1328312,2444731468
1612500,2094182185,81670377,1.1025500895e-11,18198384,1328296,2446059764
1613000,2125633989,81368883,1.0984799205e-11,18124226,1328312,2447388076
1613500,2094424045,81371308,1.098512658e-11,18203013,1329688,2448717764
1614000,2093842737,81372433,1.0985278455e-11,18239606,1329304,2450047068
1614500,2123316457,81656392,1.102361292e-11,17743876,1330564,2451377632
1615000,2078186871,81351760,1.09824876e-11,17567714,1327812,2452705444
1615500,2113729783,81377399,1.0985948865000001e-11,18400984,1328784,2454034228
1616000,2167411724,81369039,1.0984820265000002e-11,18129280,1328284,2455362512
1616500,2202735634,81370924,1.0985074740000001e-11,18190555,1329688,2456692200
1617000,2117941459,81670000,1.102545e-11,18186118,1329312,2458021512
1617500,2621886853,81373070,1.0985364450000002e-11,18260306,1329312,2459350824
1618000,2289521434,81371334,1.0985130090000001e-11,18203863,1329188,2460680012
1618500,2325686309,81371918,1.098520893e-11,18222842,1329304,2462009316
1619000,2891895621,81669672,1.1025405720000001e-11,18175456,1327812,2463337128
1619500,6803016328,81373489,1.0985421015000002e-11,18273927,1329188,2464666316
1620000,8761196556,81787969,1.1041375815e-11,18130356,1328312,2465994628
1620500,2246011512,81371686,1.098517761e-11,18215307,1329772,2467324400
1621000,2142376835,81344766,1.098154341e-11,17340416,1328276,2468652676
1621500,2114443072,81643841,1.1021918535e-11,17335973,1329688,2469982364
1622000,2117938932,81357732,1.098329382e-11,17761804,1328312,2471310676
1622500,2111407262,81359876,1.098358326e-11,17831506,1328312,2472638988
1623000,2114496178,81359836,1.098357786e-11,17830173,1329680,2473968668
1623500,2104583000,81360738,1.0983699630000001e-11,17859491,1328780,2475297448
1624000,2104558734,81359409,1.0983520215e-11,17815560,1328812,2476626260
1624500,2120353760,81360312,1.098364212e-11,17845643,1330672,2477956932
1625000,2147702255,81357329,1.0983239415e-11,17748712,1327312,2479284244
1625500,2168980381,81362483,1.0983935205e-11,17916223,1328420,2480612664
1626000,2288109012,81661603,1.1024316405e-11,17913214,1327784,2481940448
1626500,2170342275,81360934,1.0983726090000001e-11,17865866,1329284,2483269732
1627000,2116334701,81359510,1.0983533850000002e-11,17819586,1328268,2484598000
1627500,2512497677,81358538,1.0983402629999999e-11,17787997,1329128,2485927128
1628000,2180225301,81642613,1.1021752755e-11,17296052,1328776,2487255904
1628500,2238685684,81340870,1.0981017450000001e-11,17213793,1327784,2488583688
1629000,4898879261,81347580,1.0981923300000001e-11,17431866,1329268,2489912956
1629500,8813286850,81662094,1.102438269e-11,17929174,1329260,2491242216
1630000,11310307045,81959551,1.1064539385e-11,17872136,1328284,2492570500
1630500,2109671005,81362353,1.0983917655e-11,17911989,1328768,2493899268
1631000,2131385740,81359411,1.0983520484999999e-11,17816358,1328284,2495227552
1631500,2100349749,81361686,1.098382761e-11,17890321,1330188,2496557740
1632000,2106830259,81357659,1.0983283964999999e-11,17759442,1327812,2497885552
1632500,2107892970,81657548,1.1023768980000001e-11,17781446,1328780,2499214332
1633000,2111928243,81358032,1.098333432e-11,17771538,1329652,2500543984
1633500,2088965856,81358020,1.09833327e-11,17771177,1328780,2501872764
1634000,2141806836,81358320,1.0983373200000001e-11,17780904,1328304,2503201068
1634500,2107302218,81656057,1.1023567695e-11,17732988,1326812,2504527880
1635000,2131106028,81344950,1.0981568250000001e-11,17346380,1330000,2505857880
1635500,2099536899,81343400,1.0981359e-11,17296033,1326936,2507184816
1636000,2107285399,81342421,1.0981226835e-11,17264202,1327776,2508512592
1636500,2115672551,81346595,1.0981790325e-11,17399085,1327784,2509840376
1637000,2117751081,81344837,1.0981552995e-11,17342731,1330272,2511170648
1637500,2134354956,81348305,1.0982021175e-11,17455432,1328284,2512498932
1638000,2120578113,81361340,1.09837809e-11,17879077,1328784,2513827716
1638500,2107129279,81358039,1.0983335265000001e-11,17771791,1327768,2515155484
1639000,3509999354,81360756,1.098370206e-11,17860070,1327784,2516483268
1639500,6776896399,81720402,1.1032254270000001e-11,17879336,1329268,2517812536
1640000,14392978004,82015012,1.107202662e-11,17729777,1327776,2519140312
1640500,2107699102,81365650,1.098436275e-11,18019132,1330312,2520470624
1641000,2100448879,81358329,1.0983374415e-11,17781224,1327784,2521798408
1641500,2096050413,81354826,1.098290151e-11,17667371,1329172,2523127580
1642000,2092711998,81356120,1.0983076199999999e-11,17709414,1328812,2524456392
1642500,2088146377,81653207,1.1023182945000002e-11,17640348,1328312,2525784704
1643000,2083971083,81345830,1.098168705e-11,17375004,1330564,2527115268
1643500,2134040301,81340887,1.0981019745e-11,17214328,1329312,2528444580
1644000,2077877935,81339078,1.0980775530000001e-11,17155538,1328804,2529773384
1644500,2123186439,81644068,1.1021949180000001e-11,17343355,1329680,2531103064
1645000,2158952685,81358994,1.098346419e-11,17802818,1328812,2532431876
1645500,2102430633,81365653,1.0984363155e-11,18019256,1328812,2533760688
1646000,2098191577,81361195,1.0983761325e-11,17874353,1328284,2535088972
1646500,2117275404,81360457,1.0983661695000001e-11,17850359,1329180,2536418152
1647000,2092521998,81655945,1.1023552575000001e-11,17729340,1328296,2537746448
1647500,2117072037,81355661,1.0983014235e-11,17694512,1327812,2539074260
1648000,2121141506,81357098,1.098320823e-11,17741195,1329688,2540403948
1648500,3470914113,81357117,1.0983210795000001e-11,17741836,1328812,2541732760
1649000,6714757761,81715020,1.10315277e-11,17703474,1329304,2543062064
1649500,8900782176,81674623,1.1026074105000001e-11,17363942,1330528,2544392592
1650000,2075287398,81342565,1.0981246275e-11,17268896,1329796,2545722388
1650500,2112323854,81357807,1.0983303945e-11,17764257,1328276,2547050664
1651000,2089654757,81357612,1.0983277620000002e-11,17757896,1330160,2548380824
1651500,2086551641,81658501,1.1023897635000001e-11,17812402,1329312,2549710136
1652000,2085649650,81358598,1.098341073e-11,17789962,1329312,2551039448
1652500,2093868384,81355820,1.0983035700000002e-11,17699661,1328688,2552368136
1653000,2085386890,81358485,1.0983395475000002e-11,17786286,1329312,2553697448
1653500,2088344958,81358905,1.0983452175e-11,17799918,1327304,2555024752
1654000,2101782878,81656136,1.102357836e-11,17735529,1330172,2556354924
1654500,2085008980,81357490,1.0983261150000001e-11,17753952,1328804,2557683728
1655000,2087678397,81357438,1.098325413e-11,17752240,1329304,2559013032
1655500,2080082875,81356624,1.098314424e-11,17725798,1327304,2560340336
1656000,2154613147,81649478,1.1022679530000001e-11,17519163,1329152,2561669488
1656500,2222357966,81355218,1.098295443e-11,17680113,1329688,2562999176
1657000,2206849930,81357692,1.098328842e-11,17760514,1327796,2564326972
1657500,2192864316,81347901,1.0981966635e-11,17442296,1327788,2565654760
1658000,2227625696,81340099,1.0980913365000002e-11,17188740,1328312,2566983072
1658500,2109677653,81656232,1.1023591319999999e-11,17738657,1328688,2568311760
1659000,2194233584,81359141,1.0983484035e-11,17807598,1328296,2569640056
1659500,2304318263,81358461,1.0983392235000001e-11,17785492,1327812,2570967868
1660000,2186701299,81359267,1.0983501044999999e-11,17811690,1328304,2572296172
1660500,6654678947,81689691,1.1028108285e-11,17853656,1327812,2573623984
1661000,8739227393,81358583,1.0983408705e-11,17789457,1328768,2574952752
1661500,11437324190,82043794,1.1075912190000001e-11,17691797,1330152,2576282904
1662000,2112021718,81354657,1.0982878695e-11,17661858,1329296,2577612200
1662500,2084341986,81353733,1.0982753955e-11,17631840,1328304,2578940504
1663000,2129075399,81343051,1.0981311885e-11,17284670,1329564,2580270068
1663500,2110809491,81649381,1.1022666435000001e-11,17516024,1327804,2581597872
1664000,2105874876,81340014,1.0980901890000001e-11,17185968,1327812,2582925684
1664500,2101802827,81340317,1.0980942795e-11,17195819,1330156,2584255840
1665000,2098178257,81342672,1.098126072e-11,17272354,1329796,2585585636
1665500,2098202185,81366035,1.0984414725e-11,18031638,1328776,2586914412
1666000,2118637870,81360270,1.0983636450000001e-11,17844304,1328276,2588242688
1666500,2106017947,81359504,1.0983533040000001e-11,17819391,1330180,2589572868
1667000,2125295113,81356112,1.0983075120000001e-11,17709176,1328296,2590901164
1667500,2248411845,81359560,1.09835406e-11,17821218,1328288,2592229452
1668000,2125194708,81660196,1.102412646e-11,17867495,1330180,2593559632
1668500,2120929413,81359955,1.0983593925000002e-11,17834058,1329296,2594888928
1669000,2153685447,81360405,1.0983654675000001e-11,17848670,1329812,2596218740
1669500,2293111920,81343203,1.0981332405e-11,17289621,1330028,2597548768
1670000,2297648837,81341081,1.0981045935000002e-11,17220644,1328304,2598877072
1670500,5024420309,81654191,1.1023315785000001e-11,17672343,1328784,2600205856
1671000,8994222243,81358765,1.0983433275000001e-11,17795391,1328276,2601534132
1671500,14489700788,82225184,1.110039984e-11,17753265,1329660,2602863792
1672000,2119370418,81358123,1.0983346605e-11,17774522,1329276,2604193068
1672500,2132556956,81356130,1.098307755e-11,17709752,1328796,2605521864
1673000,2132818845,81358934,1.098345609e-11,17800879,1330160,2606852024
1673500,2110576182,81360081,1.0983610935e-11,17838144,1328812,2608180836
1674000,2103677251,81655157,1.1023446195e-11,17702770,1327304,2609508140
1674500,2099494567,81358560,1.0983405600000002e-11,17788709,1330680,2610838820
1675000,2093569689,81356246,1.098309321e-11,17713526,1328796,2612167616
1675500,2098972639,81361888,1.0983854880000002e-11,17896871,1327936,2613495552
1676000,2207082536,81656970,1.1023690949999999e-11,17762662,1328284,2614823836
1676500,2269799415,81344325,1.0981483875e-11,17326075,1330036,2616153872
1677000,2135414268,81342965,1.0981300275e-11,17281888,1328312,2617482184
1677500,2099618661,81355255,1.0982959425e-11,17681310,1328312,2618810496
1678000,2335800985,81656004,1.102356054e-11,17731272,1328812,2620139308
1678500,2240615032,81357818,1.0983305430000001e-11,17764599,1329688,2621468996
1679000,2177508081,81356400,1.0983114e-11,17718536,1328804,2622797800
1679500,2142937561,81358192,1.098335592e-11,17776763,1330188,2624127988
1680000,3018022520,81655997,1.1023559595e-11,17731032,1328304,2625456292
1680500,2226374121,81362829,1.0983981915000001e-11,17927465,1328276,2626784568
1681000,2801776766,81359508,1.0983533580000002e-11,17819527,1328784,2628113352
1681500,4101898229,81357989,1.0983328515e-11,17770167,1329688,2629443040
1682000,6830671698,81686579,1.1027688165e-11,17752524,1328304,2630771344
1682500,11293345854,81720314,1.103224239e-11,17876468,1332020,2632103364
1683000,8781093096,81804668,1.104363018e-11,17700646,1329304,2633432668
1683500,2114053996,81367921,1.0984669335e-11,18092966,1328796,2634761464
1684000,2113653894,81375021,1.0985627835e-11,18323706,1327812,2636089276
1684500,2110665744,81375373,1.0985675355000002e-11,18335147,1329680,2637418956
1685000,2097277577,81673976,1.1025986760000001e-11,18315350,1328796,2638747752
1685500,2099353138,81377684,1.0985987340000001e-11,18410236,1328796,2640076548
1686000,2096755958,81376829,1.0985871915e-11,18382465,1328276,2641404824
1686500,2095101687,81374360,1.09855386e-11,18301226,1329660,2642734484
1687000,2093355039,81373870,1.0985472450000001e-11,18286304,1328312,2644062796
1687500,2304230386,81671529,1.1025656415e-11,18235820,1328804,2645391600
1688000,2203802901,81374409,1.0985545215e-11,18303804,1328312,2646719912
1688500,2087381355,81373346,1.0985401710000002e-11,18269263,1329180,2648049092
1689000,2525188321,81372961,1.0985349735000002e-11,18256742,1327812,2649376904
1689500,2243021435,81658922,1.1023954470000002e-11,17826086,1330556,2650707460
1690000,2110886622,81345000,1.0981575000000002e-11,17348011,1330180,2652037640
1690500,2265234930,81341864,1.098115164e-11,17246095,1326936,2653364576
1691000,2119315340,81350633,1.0982335455000001e-11,17531101,1328284,2654692860
1691500,2261254463,81355896,1.098304596e-11,17702136,1329156,2656022016
1692000,4927799583,81656067,1.1023569045e-11,17733314,1328304,2657350320
1692500,11327200083,81357755,1.0983296925000001e-11,17762544,1327312,2658677632
1693000,2145898221,81777013,1.1039896755e-11,17774300,1328812,2660006444
1693500,2111246456,81356857,1.0983175695e-11,17733358,1327312,2661333756
1694000,2106519808,81358149,1.0983350115e-11,17775365,1329664,2662663420
1694500,2110272879,81656729,1.1023658415e-11,17754836,1328312,2663991732
1695000,2110349130,81358822,1.098344097e-11,17797226,1328312,2665320044
1695500,2105439842,81364419,1.0984196564999999e-11,17979129,1329160,2666649204
1696000,2101692569,81363061,1.0984013235000001e-11,17935001,1329264,2667978468
1696500,2110461255,81660811,1.1024209485000002e-11,17887474,1329660,2669308128
1697000,2105319340,81349288,1.098215388e-11,17487387,1328784,2670636912
1697500,2099909723,81349942,1.0982242170000002e-11,17508638,1328776,2671965688
1698000,2090964877,81349622,1.0982198970000001e-11,17498222,1328284,2673293972
1698500,2107417750,81348888,1.0982099880000002e-11,17474370,1327784,2674621756
1699000,2068115294,81647719,1.1022442065e-11,17460990,1328784,2675950540
1699500,2087983605,81347911,1.0981967985000001e-11,17442613,1328268,2677278808
1700000,2088261344,81350587,1.0982329245e-11,17529607,1328268,2678607076
1700500,2089744525,81354089,1.0982802015e-11,17643399,1331284,2679938360
1701000,2098880547,81656306,1.102360131e-11,17741060,1328304,2681266664
1701500,2188765609,81355798,1.0983032730000002e-11,17698955,1327776,2682594440
1702000,2177857110,81356801,1.0983168135000001e-11,17731544,1327776,2683922216
1702500,2190253523,81360436,1.098365886e-11,17849680,1329312,2685251528
1703000,2161465499,81357860,1.09833111e-11,17765971,1328784,2686580312
1703500,2193387874,81658412,1.102388562e-11,17809520,1328768,2687909080
1704000,2176030728,81357993,1.0983329055000001e-11,17770294,1328804,2689237884
1704500,2177237716,81357019,1.0983197565000001e-11,17738647,1328284,2690566168
1705000,2126172754,81353495,1.0982721825e-11,17624108,1328116,2691894284
1705500,4981831421,81676110,1.102627485e-11,17412286,1328776,2693223060
1706000,9066212828,81359054,1.0983472290000002e-11,17804770,1328812,2694551872
1706500,8725906630,81715473,1.1031588855e-11,17719145,1329280,2695881152
1707000,2108596412,81656183,1.1023584705e-11,17737085,1327776,2697208928
1707500,2132580370,81358160,1.09833516e-11,17775723,1327784,2698536712
1708000,2101712927,81359072,1.098347472e-11,17805360,1328784,2699865496
1708500,2093028355,81359308,1.098350658e-11,17813025,1328284,2701193780
1709000,2092997205,81657084,1.102370634e-11,17766347,1327776,2702521556
1709500,2088322089,81360724,1.0983697740000001e-11,17859038,1329284,2703850840
1710000,2102964717,81359737,1.0983564495e-11,17826973,1328784,2705179624
1710500,2106486723,81364019,1.0984142565e-11,17966129,1329276,2706508900
1711000,2119726848,81361593,1.0983815055e-11,17887288,1327776,2707836676
1711500,2116882501,81361137,1.0983753495000001e-11,17871463,1328688,2709165364
1712000,2125185778,81357624,1.098327924e-11,17758286,1327312,2710492676
1712500,2091229021,81350572,1.098232722e-11,17529089,1328680,2711821356
1713000,2297500623,81343872,1.098142272e-11,17311373,1330172,2713151528
1713500,2090754826,81654075,1.1023300125e-11,17668552,1327312,2714478840
1714000,2320489328,81360237,1.0983631995e-11,17843216,1328804,2715807644
1714500,3370061963,81361012,1.0983736620000002e-11,17868422,1328296,2717135940
1715000,6644691398,81659804,1.1024073539999999e-11,17854766,1328660,2718464600
1715500,14396921550,81868292,1.1052219420000001e-11,17823521,1327936,2719792536
1716000,2166897866,81363424,1.0984062240000002e-11,17946788,1329132,2721121668
1716500,2108171078,81359232,1.098349632e-11,17810546,1328784,2722450452
1717000,2096378052,81357585,1.0983273975000001e-11,17757028,1327812,2723778264
1717500,2100224540,81659396,1.102401846e-11,17841500,1328812,2725107076
1718000,2089721022,81360856,1.098371556e-11,17863333,1328688,2726435764
1718500,2089031889,81357113,1.0983210255e-11,17741700,1328312,2727764076
1719000,2082345301,81358345,1.0983376575e-11,17781740,1328296,2729092372
1719500,2123575616,81361312,1.098377712e-11,17878165,1329172,2730421544
1720000,2111155223,81659691,1.1024058285000002e-11,17851088,1328312,2731749856
1720500,2240222460,81378164,1.098605214e-11,18425867,1329680,2733079536
1721000,2140107882,81371196,1.098511146e-11,18199384,1328776,2734408312
1721500,2118891798,81373936,1.0985481360000001e-11,18288423,1329688,2735738000
1722000,2196598539,81673660,1.1025944100000001e-11,18305083,1328784,2737066784
1722500,2234278961,81375793,1.0985732055e-11,18348786,1328796,2738395580
1723000,2144152491,81378592,1.098610992e-11,18439756,1331152,2739726732
1723500,2213074259,81376719,1.0985857065e-11,18378868,1328812,2741055544
1724000,6613701870,81706625,1.1030394375e-11,18403004,1327804,2742383348
1724500,8784889037,81376158,1.0985781329999999e-11,18360645,1329660,2743713008
1725000,8727117427,82034540,1.10746629e-11,18364434,1328312,2745041320
1725500,2109048069,81380500,1.0986367499999999e-11,18501782,1328804,2746370124
1726000,2104824769,81383600,1.0986786e-11,18602532,1329644,2747699768
1726500,2100615331,81354025,1.0982793375e-11,17641347,1329688,2749029456
1727000,2113104251,81356340,1.09831059e-11,17716564,1328312,2750357768
1727500,2095374683,81662281,1.1024407935000002e-11,17935250,1327812,2751685580
1728000,2094565272,81373968,1.0985485680000001e-11,18289466,1328312,2753013892
1728500,2090568611,81374062,1.0985498370000001e-11,18292541,1329688,2754343580
1729000,2089792908,81372579,1.0985298165000002e-11,18244338,1327812,2755671392
1729500,2092596485,81372919,1.0985344065e-11,18255392,1328796,2757000188
1730000,2086460732,81672844,1.102583394e-11,18278575,1329688,2758329876
1730500,2085489251,81381371,1.0986485085000001e-11,18530083,1329784,2759659660
1731000,2077313915,81368548,1.0984753980000002e-11,18113339,1327276,2760986936
1731500,2081650381,81372096,1.098523296e-11,18228638,1329304,2762316240
1732000,2081841172,81675387,1.1026177245000002e-11,18361207,1329680,2763645920
1732500,2081974984,81379246,1.098619821e-11,18461025,1329180,2764975100
1733000,2121296633,81375382,1.0985676570000002e-11,18335442,1328804,2766303904
1733500,2319658156,81375056,1.0985632560000001e-11,18324827,1329180,2767633084
1734000,2235778642,81373338,1.098540063e-11,18269016,1329312,2768962396
1734500,2238019697,81373358,1.098540333e-11,18269652,1328788,2770291184
1735000,2223767809,81374667,1.0985580045e-11,18312206,1329160,2771620344
1735500,2113947170,81368664,1.098476964e-11,18117086,1328776,2772949120
1736000,2147087872,81360075,1.0983610125e-11,17837962,1327284,2774276404
1736500,2248533873,81660560,1.1024175600000001e-11,17878275,1328268,2775604672
1737000,2130160174,81366660,1.09844991e-11,18051948,1329276,2776933948
1737500,4849818932,81372612,1.0985302620000001e-11,18245424,1327284,2778261232
1738000,8748060863,81766115,1.1038425525e-11,18392547,1328772,2779590004
1738500,11256231863,81822581,1.1046048434999999e-11,18282820,1327268,2780917272
1739000,2107737981,81379389,1.0986217515000001e-11,18465675,1329268,2782246540
1739500,2106943602,81378449,1.0986090615e-11,18435098,1329784,2783576324
1740000,2096582365,81376727,1.0985858145000001e-11,18379135,1328284,2784904608
1740500,2096457195,81677072,1.1026404720000001e-11,18415967,1329276,2786233884
1741000,2093746680,81376071,1.0985769585e-11,18357823,1328276,2787562160
1741500,2091921126,81370859,1.0985065965000002e-11,18188422,1327812,2788889972
1742000,2098637737,81374135,1.0985508225e-11,18294889,1329688,2790219660
1742500,2245413261,81370817,1.0985060295e-11,18187064,1327804,2791547464
1743000,2324378475,81371352,1.0985132520000001e-11,18204448,1328812,2792876276
1743500,2105008948,81360784,1.098370584e-11,17861013,1330532,2794206808
1744000,2170508820,81354468,1.098285318e-11,17655712,1328312,2795535120
1744500,2147646928,81664228,1.102467078e-11,17998526,1328812,2796863932
1745000,2137797485,81373648,1.098544248e-11,18279093,1329180,2798193112
1745500,2589415528,81378534,1.0986102090000001e-11,18437871,1328776,2799521888
1746000,2180356640,81375934,1.098575109e-11,18353383,1329276,2800851164
1746500,2231149699,81374242,1.098552267e-11,18298389,1330188,2802181352
1747000,4848041037,81669366,1.1025364410000002e-11,18165530,1327788,2803509140
1747500,11398835935,81371813,1.0985194754999999e-11,18219444,1328812,2804837952
1748000,8736516016,82123076,1.1086615260000001e-11,18324503,1330172,2806168124
1748500,2117591177,81372296,1.0985259960000001e-11,18235120,1328804,2807496928
1749000,2110290090,81369376,1.0984865760000001e-11,18139200,1328304,2808825232
1749500,2106873542,81371232,1.098511632e-11,18200566,1330564,2810155796
1750000,2103173205,81352708,1.098261558e-11,17598530,1327812,2811483608
1750500,2097709345,81659172,1.1023988220000002e-11,17834204,1327776,2812811384
1751000,2095322712,81369939,1.0984941765000001e-11,18158522,1328812,2814140196
1751500,2093799811,81370945,1.0985077575e-11,18191244,1328312,2815468508
1752000,2113754891,81372652,1.0985308019999999e-11,18246700,1328804,2816797312
1752500,2125261394,81670266,1.1025485910000001e-11,18194779,1329172,2818126484
1753000,2133199900,81370328,1.098499428e-11,18171174,1328284,2819454768
1753500,2151304434,81371873,1.0985202855000002e-11,18221383,1328764,2820783532
1754000,2113272557,81371445,1.0985145075e-11,18207488,1328812,2822112344
1754500,2175519183,81374066,1.098549891e-11,18292668,1330152,2823442496
1755000,2112200276,81671158,1.102560633e-11,18223776,1328768,2824771264
1755500,2122486713,81377792,1.098600192e-11,18413744,1329804,2826101068
1756000,2247960413,81372842,1.0985333670000001e-11,18252878,1329312,2827430380
1756500,2128545814,81373233,1.0985386455000001e-11,18265591,1328772,2828759152
1757000,3386181114,81362815,1.0983980025e-11,17926994,1331536,2830090688
1757500,6674298378,81730102,1.1033563770000001e-11,18194584,1328812,2831419500
1758000,14361841599,81942764,1.106227314e-11,18298990,1328312,2832747812
1758500,2107625675,81370949,1.0985078115e-11,18191374,1328284,2834076096
1759000,2183635428,81371570,1.098516195e-11,18211546,1328312,2835404408
1759500,2096452531,81372858,1.0985335830000002e-11,18253409,1329264,2836733672
1760000,2093341043,81674816,1.102610016e-11,18342633,1330160,2838063832
1760500,2092026111,81373364,1.098540414e-11,18269854,1328284,2839392116
1761000,2088862046,81374464,1.0985552640000001e-11,18305614,1329804,2840721920
1761500,2083551396,81374613,1.0985572754999999e-11,18309373,1328280,2842050200
1762000,2112536745,81375571,1.0985702085e-11,18341563,1328660,2843378860
1762500,2113797564,81374659,1.0985578965e-11,18311920,1328304,2844707164
1763000,2115220170,81377082,1.098590607e-11,18390682,1329276,2846036440
1763500,2236738080,81376117,1.0985775795000002e-11,18359337,1327768,2847364208
1764000,2131999708,81367942,1.098467217e-11,18093619,1330188,2848694396
1764500,2322524534,81664928,1.102476528e-11,18021286,1328760,2850023156
1765000,2140257882,81375718,1.098572193e-11,18346351,1328252,2851351408
1765500,2124405683,81374532,1.098556182e-11,18307810,1329304,2852680712
1766000,2313283272,81354800,1.0982898000000001e-11,17666534,1328804,2854009516
1766500,4857066681,81655523,1.1023495605000001e-11,17715616,1328312,2855337828
1767000,18303675848,81937883,1.1061614205e-11,18140380,1328812,2856666640
1767500,2112144727,81375395,1.0985678325e-11,18335865,1330180,2857996820
1768000,2106615811,81371645,1.0985172075e-11,18213976,1329768,2859326588
1768500,2112092439,81372340,1.09852659e-11,18236554,1327812,2860654400
1769000,2105174066,81673432,1.1025913320000002e-11,18297668,1329304,2861983704
1769500,2102254174,81371663,1.0985174505000002e-11,18214570,1327812,2863311516
1770000,2146878311,81373853,1.0985470155e-11,18285740,1328304,2864639820
1770500,2100207375,81376504,1.0985828040000001e-11,18371895,1329160,2865968980
1771000,2097973531,81373231,1.0985386185e-11,18265536,1328796,2867297776
1771500,2091790245,81664998,1.102477473e-11,18023567,1328188,2868625964
1772000,2089718738,81356306,1.098310131e-11,17715468,1328772,2869954736
1772500,2088308579,81357921,1.0983319335000001e-11,17767963,1329660,2871284396
1773000,2087450846,81361894,1.0983855690000002e-11,17897060,1329284,2872613680
1773500,2253116881,81671037,1.1025589995e-11,18219842,1328804,2873942484
1774000,2341924928,81375334,1.098567009e-11,18332784,1328656,2875271140
1774500,2552679859,81369628,1.098489978e-11,18148446,1328284,2876599424
1775000,2270820742,81371292,1.098512442e-11,18202489,1327784,2877927208
1775500,2704266059,81674748,1.102609098e-11,18340428,1329804,2879257012
1776000,2378605715,81372379,1.0985271165e-11,18237820,1327804,2880584816
1776500,2249766681,81376259,1.0985794965000001e-11,18363946,1328312,2881913128
1777000,2297184984,81672728,1.1025818280000002e-11,18274768,1327804,2883240932
1777500,2249130920,81370879,1.0985068665e-11,18189071,1328688,2884569620
1778000,4942550529,81373949,1.0985483115e-11,18288877,1328760,2885898380
1778500,11419526184,81727221,1.1033174835e-11,18100939,1328172,2887226552
1779000,14857708918,81927866,1.1060261909999999e-11,17814812,1328804,2888555356
1779500,2123063812,81370975,1.0985081625e-11,18192191,1329172,2889884528
1780000,2120126517,81376808,1.0985869080000001e-11,18381771,1329780,2891214308
1780500,2134586488,81379130,1.0986182550000002e-11,18457254,1329312,2892543620
1781000,2116017783,81674816,1.102610016e-11,18342662,1328784,2893872404
1781500,2142495287,81374593,1.0985570055e-11,18309784,1328296,2895200700
1782000,2112132721,81374613,1.0985572754999999e-11,18310449,1329180,2896529880
1782500,2135522089,81374955,1.0985618925e-11,18321552,1329304,2897859184
1783000,2288590358,81673163,1.1025877005e-11,18288932,1328304,2899187488
1783500,2281242134,81373913,1.0985478255e-11,18287686,1329660,2900517148
1784000,2461689355,81374698,1.098558423e-11,18313204,1328804,2901845952
1784500,2688890615,81374605,1.0985571675000001e-11,18310178,1327804,2903173756
1785000,2227695095,81670593,1.1025530055000001e-11,18205390,1330064,2904503820
1785500,2135304032,81360124,1.098361674e-11,17839544,1328812,2905832632
1786000,2117439614,81362606,1.098395181e-11,17920203,1327776,2907160408
1786500,2234138432,81361244,1.098376794e-11,17874845,1328276,2908488684
1787000,2202791074,81663547,1.1024578845000001e-11,17976396,1328284,2909816968
1787500,2250485397,81375238,1.0985657130000002e-11,18330761,1327784,2911144752
1788000,3466544251,81375665,1.0985714775e-11,18344620,1327784,2912472536
1788500,8855102335,81704082,1.1030051070000001e-11,18321360,1328304,2913800840
1789000,8922833852,81374682,1.0985582070000002e-11,18312685,1327284,2915128124
1789500,11444792647,82122189,1.1086495515e-11,18295691,1328276,2916456400
1790000,2123123737,81376256,1.0985794560000001e-11,18363834,1327812,2917784212
1790500,2117036310,81378411,1.0986085485e-11,18433859,1328784,2919112996
1791000,2122587455,81376588,1.098583938e-11,18374610,1330124,2920443120
1791500,2110505416,81667942,1.102517217e-11,18119238,1327304,2921770424
1792000,2109420067,81370503,1.0985017905e-11,18176856,1328804,2923099228
1792500,2078631007,81369569,1.0984891815e-11,18146508,1328812,2924428040
1793000,2081688526,81354584,1.0982868840000001e-11,17659486,1331064,2925759104
1793500,2105031941,81352783,1.0982625705000002e-11,17600966,1328312,2927087416
1794000,2170890782,81650320,1.10227932e-11,17546544,1328812,2928416228
1794500,2226078109,81369917,1.0984938795000002e-11,18157835,1329672,2929745900
1795000,2120548097,81368292,1.098471942e-11,18105022,1328804,2931074704
1795500,2230328551,81381061,1.0986443235e-11,18520002,1329296,2932404000
1796000,2119970770,81669907,1.1025437445000001e-11,18183097,1328784,2933732784
1796500,2178663421,81373459,1.0985416965e-11,18272938,1328276,2935061060
1797000,2254158458,81373623,1.0985439105000001e-11,18278254,1329284,2936390344
1797500,2217250318,81372096,1.098523296e-11,18228657,1329284,2937719628
1798000,2229873328,81669031,1.1025319185000001e-11,18154634,1327268,2939046896
1798500,3406058490,81372729,1.0985318415e-11,18249205,1328784,2940375680
1799000,6688914943,81370858,1.0985065830000001e-11,18187281,1327776,2941703456
1799500,18074715755,82239300,1.11023055e-11,18212026,1327776,2943031232
1800000,2085753390,81372325,1.0985263875000001e-11,18236087,1328784,2944360016
1800500,2136865181,81387404,1.098729954e-11,18726138,1329160,2945689176
1801000,2107032451,81357436,1.0983253860000001e-11,17752176,1328812,2947017988
1801500,2107191460,81365598,1.0984355730000002e-11,18017466,1328312,2948346300
1802000,2102186416,81674855,1.1026105425000001e-11,18343918,1329804,2949676104
1802500,2101230108,81375092,1.098563742e-11,18326022,1327804,2951003908
1803000,2097590799,81377980,1.09860273e-11,18419876,1329660,2952333568
1803500,2099233018,81375701,1.0985719635e-11,18345796,1329312,2953662880
1804000,2388145940,81675218,1.1026154430000002e-11,18355700,1328784,2954991664
1804500,2138321170,81372186,1.098524511e-11,18231568,1328284,2956319948
1805000,2124412449,81373471,1.0985418585000001e-11,18273330,1327776,2957647724
1805500,2239535020,81375781,1.0985730435e-11,18348398,1327812,2958975536
1806000,2277781319,81669759,1.1025417465e-11,18178302,1327284,2960302820
1806500,2128248527,81371398,1.098513873e-11,18205945,1327260,2961630080
1807000,2243508201,81371811,1.0985194485e-11,18219360,1327284,2962957364
1807500,2153196994,81374112,1.0985505120000001e-11,18294160,1328776,2964286140
1808000,2237665567,81361731,1.0983833685e-11,17891785,1328624,2965614764
1808500,5451423530,81659910,1.1024087849999999e-11,17858189,1329660,2966944424
1809000,8888829711,81364781,1.0984245435000001e-11,17990896,1328812,2968273236
1809500,6752358498,81791724,1.104188274e-11,18252393,1328268,2969601504
1810000,2115297231,81373935,1.0985481225e-11,18288407,1328752,2970930256
1810500,2115560541,81677708,1.102649058e-11,18436620,1328804,2972259060
1811000,2109639142,81374608,1.0985572080000001e-11,18310290,1329312,2973588372
1811500,2171546968,81375075,1.0985635125e-11,18324328,1328804,2974917176
1812000,2123078519,81373687,1.0985447745000001e-11,18280352,1329660,2976246836
1812500,2110675661,81670566,1.102552641e-11,18204515,1328768,2977575604
1813000,2114471640,81374528,1.0985561280000001e-11,18307681,1329780,2978905384
1813500,2105029261,81375285,1.0985663475e-11,18332283,1330644,2980236028
1814000,2100386320,81371459,1.0985146965000002e-11,18207946,1328312,2981564340
1814500,2103451799,81372974,1.098535149e-11,18257185,1329276,2982893616
1815000,2091525328,81658688,1.102392288e-11,17818481,1329996,2984223612
1815500,2095932178,81347077,1.0981855394999999e-11,17415510,1329296,2985552908
1816000,2088314993,81341443,1.0981094805e-11,17232406,1327812,2986880720
1816500,2091028303,81340691,1.0980993285000001e-11,17207964,1328812,2988209532
1817000,2136248288,81642587,1.1021749245000001e-11,17295209,1330160,2989539692
1817500,2119599967,81355176,1.098294876e-11,17678725,1328764,2990868456
1818000,2166035700,81357215,1.0983224025e-11,17745010,1328304,2992196760
1818500,2167273084,81357142,1.098321417e-11,17742634,1328296,2993525056
1819000,2508413400,81658764,1.102393314e-11,17820966,1328304,2994853360
1819500,2250582649,81359236,1.098349686e-11,17810677,1330180,2996183540
1820000,2293081692,81356897,1.0983181095e-11,17734668,1328312,2997511852
1820500,2207426569,81364374,1.0984190490000001e-11,17977682,1328276,2998840128
1821000,2252055870,81355718,1.098302193e-11,17696354,1328804,3000168932
1821500,5009758483,81656575,1.1023637625000002e-11,17749814,1329796,3001498728
1822000,8923479523,81354289,1.0982829015000001e-11,17649902,1331040,3002829768
1822500,8846801085,81759951,1.1037593385e-11,17219768,1328304,3004158072
1823000,2110272354,81640563,1.1021476005000002e-11,17229418,1328304,3005486376
1823500,2112524276,81345370,1.098162495e-11,17360035,1329188,3006815564
1824000,2099867144,81358434,1.098338859e-11,17783494,1328304,3008143868
1824500,2102449447,81360986,1.098373311e-11,17867570,1329304,3009473172
1825000,2176949700,81655031,1.1023429185e-11,17699627,1328180,3010801352
1825500,2098220576,81364922,1.0984264470000001e-11,17995483,1328436,3012129788
1826000,2103363880,81360910,1.0983722850000001e-11,17865101,1328276,3013458064
1826500,2091039199,81359056,1.0983472560000001e-11,17804821,1328776,3014786840
1827000,2224530644,81356629,1.0983144915000001e-11,17725952,1327284,3016114124
1827500,2156432950,81659705,1.1024060175e-11,17851534,1329284,3017443408
1828000,2405002124,81359426,1.0983522510000001e-11,17816862,1328276,3018771684
1828500,2210979480,81360958,1.098372933e-11,17866650,1327768,3020099452
1829000,2314895609,81359548,1.098353898e-11,17820821,1329276,3021428728
1829500,2121779001,81661048,1.1024241480000001e-11,17895178,1329276,3022758004
1830000,2227172271,81355819,1.0983035565000001e-11,17699634,1329152,3024087156
1830500,2303961252,81345648,1.098166248e-11,17369060,1328304,3025415460
1831000,3386222900,81357404,1.0983249540000001e-11,17751147,1329276,3026744736
1831500,8852634947,81658779,1.1023935165e-11,17821430,1328284,3028073020
1832000,6740192088,81718297,1.1031970095000001e-11,17810911,1329284,3029402304
1832500,2115237742,81347704,1.0981940040000001e-11,17435885,1329284,3030731588
1833000,2115636490,81345236,1.098160686e-11,17355674,1328284,3032059872
1833500,2119170516,81655622,1.102350897e-11,17718836,1327784,3033387656
1834000,2107254055,81360539,1.0983672765e-11,17853043,1329284,3034716940
1834500,2170340082,81359773,1.0983569355000001e-11,17828144,1329784,3036046724
1835000,2122799144,81358262,1.098336537e-11,17779021,1328776,3037375500
1835500,2104630945,81360476,1.098366426e-11,17851007,1328284,3038703784
1836000,2095249652,81657299,1.1023735365e-11,17773342,1327768,3040031552
1836500,2100622668,81357555,1.0983269925e-11,17754887,1328776,3041360328
1837000,2135116492,81356943,1.0983187305000002e-11,17736156,1328268,3042688596
1837500,2120459315,81357722,1.0983292470000002e-11,17761476,1328284,3044016880
1838000,2173090045,81656881,1.1023678935000001e-11,17759749,1328776,3045345656
1838500,2237885244,81358232,1.098336132e-11,17778068,1329160,3046674816
1839000,2468304649,81362326,1.098391401e-11,17911124,1328776,3048003592
1839500,2273484067,81376028,1.098576378e-11,18356414,1327276,3049330868
1840000,2294209390,81660971,1.1024231085e-11,17892668,1327776,3050658644
1840500,2249609760,81359316,1.098350766e-11,17813272,1328796,3051987440
1841000,2238217372,81365459,1.0984336965000001e-11,18012926,1328284,3053315724
1841500,4889290110,81375321,1.0985668335e-11,18333452,1328276,3054644000
1842000,11544513824,81734731,1.1034188685000001e-11,18345017,1327768,3055971768
1842500,4882609101,81852502,1.105008777e-11,18282813,1327784,3057299552
1843000,2087777792,81374462,1.0985552370000001e-11,18305539,1328276,3058627828
1843500,2088075620,81375452,1.0985686020000001e-11,18337719,1328784,3059956612
1844000,2114625457,81374982,1.098562257e-11,18322428,1328784,3061285396
1844500,2115872122,81373426,1.098541251e-11,18271851,1329276,3062614672
1845000,2110718387,81675230,1.102615605e-11,18356115,1327768,3063942440
1845500,2111689776,81375387,1.0985677245e-11,18335586,1328276,3065270716
1846000,2108007377,81372130,1.098523755e-11,18229744,1329296,3066600012
1846500,2107287607,81369171,1.0984838085e-11,18133584,1327276,3067927288
1847000,2100213089,81666699,1.1025004365e-11,18078847,1329680,3069256968
1847500,2097276452,81354436,1.098284886e-11,17654695,1328780,3070585748
1848000,2092828572,81355612,1.0983007620000001e-11,17692920,1328784,3071914532
1848500,2088280233,81365444,1.098433494e-11,18012428,1327784,3073242316
1849000,2133273381,81372470,1.0985283450000002e-11,18239615,1328784,3074571100
1849500,2088909123,81670066,1.1025458910000002e-11,18188270,1328276,3075899376
1850000,2083299809,81372201,1.0985247134999999e-11,18232056,1327812,3077227188
1850500,2107917052,81377605,1.0985976675e-11,18407691,1329768,3078556956
1851000,2116340100,81370750,1.0985051250000002e-11,18184880,1329276,3079886232
1851500,2269601936,81670308,1.102549158e-11,18196132,1328788,3081215020
1852000,2351075474,81372083,1.0985231205e-11,18228199,1327780,3082542800
1852500,2147337253,81371420,1.09851417e-11,18206676,1329268,3083872068
1853000,2234037170,81370759,1.0985052464999999e-11,18185185,1327784,3085199852
1853500,2177122086,81670661,1.1025539235000002e-11,18207620,1328284,3086528136
1854000,2137317970,81371577,1.0985162895e-11,18211772,1328784,3087856920
1854500,2240647200,81371068,1.0985094180000001e-11,18195220,1328804,3089185724
1855000,2257373500,81371215,1.0985114025e-11,18200004,1328312,3090514036
1855500,4907593254,81370133,1.0984967955e-11,18164844,1328152,3091842188
1856000,9202442978,81714207,1.1031417945000001e-11,17678001,1327772,3093169960
1856500,11280973426,81989655,1.1068603425000001e-11,17878067,1327280,3094497240
1857000,2123724191,81364060,1.09841481e-11,17967472,1329312,3095826552
1857500,2125682787,81363686,1.098409761e-11,17955313,1328284,3097154836
1858000,2114605510,81376055,1.0985767425e-11,18357306,1328804,3098483640
1858500,2116235661,81375073,1.0985634855e-11,18325381,1328276,3099811916
1859000,2115566280,81675238,1.102615713e-11,18356357,1328764,3101140680
1859500,2121711422,81375368,1.098567468e-11,18334984,1328296,3102468976
1860000,2108726194,81376186,1.0985785110000002e-11,18361575,1329284,3103798260
1860500,2103275884,81376370,1.098580995e-11,18367554,1327784,3105126044
1861000,2208949221,81672950,1.102584825e-11,18282013,1328784,3106454828
1861500,2331263886,81375339,1.0985670765e-11,18332846,1327812,3107782640
1862000,2100205612,81376194,1.098578619e-11,18361822,1329812,3109112452
1862500,2184780856,81375223,1.0985655105e-11,18330253,1328768,3110441220
1863000,2238102522,81673673,1.1025945855000002e-11,18305514,1327784,3111769004
1863500,2249193811,81373018,1.098535743e-11,18258605,1328284,3113097288
1864000,2131289346,81371843,1.0985198805000001e-11,18220399,1329652,3114426940
1864500,2306258755,81356280,1.09830978e-11,17714610,1328276,3115755216
1865000,2306256947,81358065,1.0983338775000001e-11,17772631,1328276,3117083492
1865500,2335458543,81657325,1.1023738875e-11,17774180,1328284,3118411776
1866000,5158896315,81374716,1.0985586660000002e-11,18313792,1328284,3119740060
1866500,8895606452,81703765,1.1030008275e-11,18311077,1329268,3121069328
1867000,14331823291,81943665,1.1062394775e-11,18328280,1329268,3122398596
1867500,2109256638,81375711,1.0985720985e-11,18346120,1328784,3123727380
1868000,2116306645,81374068,1.0985499180000001e-11,18292721,1328784,3125056164
1868500,2103323305,81375935,1.0985751225000001e-11,18353397,1327776,3126383940
1869000,2145731893,81375864,1.0985741640000002e-11,18351103,1328776,3127712716
1869500,2121687930,81674676,1.102608126e-11,18338079,1329276,3129041992
1870000,2125436849,81373800,1.0985463e-11,18284002,1327776,3130369768
1870500,2134481110,81376724,1.0985857740000001e-11,18379033,1329276,3131699044
1871000,2103776561,81363801,1.0984113135e-11,17959067,1328264,3133027308
1871500,2146285021,81660724,1.102419774e-11,17884663,1328784,3134356092
1872000,2133904552,81370438,1.0985009130000001e-11,18174750,1328760,3135684852
1872500,2109480066,81373447,1.0985415345e-11,18272549,1329652,3137014504
1873000,2169382721,81364629,1.0984224915e-11,17985972,1328312,3138342816
1873500,2259154972,81661893,1.1024355555000001e-11,17922640,1327796,3139670612
1874000,2120298426,81363586,1.098408411e-11,17950854,1328768,3140999380
1874500,2130715081,81362533,1.0983941955e-11,17917832,1328296,3142327676
1875000,2090948571,81362644,1.098395694e-11,17921458,1327284,3143654960
1875500,2120780039,81668630,1.1025265050000002e-11,18141611,1330776,3144985736
1876000,3383674025,81359772,1.098356922e-11,17828101,1329284,3146315020
1876500,6843524390,81361825,1.0983846375e-11,17894820,1328284,3147643304
1877000,22468321617,82215862,1.109914137e-11,18422730,1328304,3148971608
1877500,2086268391,81376834,1.098587259e-11,18382619,1328272,3150299880
1878000,2111816172,81376268,1.098579618e-11,18364208,1328276,3151628156
1878500,2105215666,81675449,1.1026185615000001e-11,18363222,1328276,3152956432
1879000,2094087070,81377658,1.0985983830000001e-11,18409392,1328768,3154285200
1879500,2101181278,81373754,1.098545679e-11,18282518,1327784,3155612984
1880000,2090577271,81378184,1.0986054840000002e-11,18426493,1329284,3156942268
1880500,2093850040,81378754,1.098613179e-11,18445030,1328776,3158271044
1881000,2135812056,81377845,1.0986009075e-11,18415491,1329268,3159600312
1881500,2160712091,81377388,1.098594738e-11,18400634,1329284,3160929596
1882000,2135003842,81377259,1.0985929965000001e-11,18396426,1329268,3162258864
1882500,2226332933,81374161,1.0985511735e-11,18295761,1327272,3163586136
1883000,2157770745,81675872,1.1026242720000001e-11,18376965,1328784,3164914920
1883500,2125709589,81371852,1.098520002e-11,18220695,1328628,3166243548
1884000,2319990515,81358599,1.0983410865000001e-11,17789974,1329268,3167572816
1884500,2196771210,81356812,1.098316962e-11,17731913,1327768,3168900584
1885000,2182157001,81662407,1.1024424945e-11,17939353,1328284,3170228868
1885500,2281378403,81376388,1.0985812380000001e-11,18368117,1328284,3171557152
1886000,5018998733,81371875,1.0985203125000001e-11,18221450,1330644,3172887796
1886500,9087043436,81729681,1.1033506935e-11,18179659,1328280,3174216076
1887000,14307694018,81969614,1.1065897890000001e-11,18199178,1328796,3175544872
1887500,2151124863,81370693,1.0985043555e-11,18183034,1328304,3176873176
1888000,2115694829,81374653,1.0985578155e-11,18311733,1329680,3178202856
1888500,2112547316,81373274,1.0985391990000002e-11,18266918,1328312,3179531168
1889000,2102188556,81369158,1.098483633e-11,18133164,1328312,3180859480
1889500,2110759730,81671714,1.1025681390000001e-11,18241833,1329180,3182188660
1890000,2106845892,81371370,1.098513495e-11,18205028,1328812,3183517472
1890500,2103774193,81375944,1.098575244e-11,18353690,1330148,3184847620
1891000,2095227460,81358769,1.0983433815000001e-11,17795512,1328784,3186176404
1891500,2101562553,81658039,1.1023835265000001e-11,17797398,1328776,3187505180
1892000,2138589139,81364067,1.0984149045e-11,17967683,1328780,3188833960
1892500,2106661717,81356915,1.0983183525000002e-11,17735264,1328784,3190162744
1893000,2095399965,81363867,1.0984122045e-11,17961189,1329284,3191492028
1893500,2090491137,81375311,1.0985666985e-11,18333116,1328260,3192820288
1894000,2091031820,81672414,1.1025775890000001e-11,18264568,1328276,3194148564
1894500,2081356925,81376530,1.0985831550000002e-11,18372750,1327784,3195476348
1895000,2067435750,81377216,1.098592416e-11,18395056,1329276,3196805624
1895500,2155107763,81376903,1.0985881905e-11,18384860,1329276,3198134900
1896000,2159262095,81673987,1.1025988245e-11,18315697,1328772,3199463672
1896500,2211883098,81370768,1.098505368e-11,18185491,1327776,3200791448
1897000,2230128787,81374216,1.098551916e-11,18297549,1328784,3202120232
1897500,2119947326,81373051,1.0985361885e-11,18259678,1328284,3203448516
1898000,2249419019,81672623,1.1025804105e-11,18271379,1328252,3204776768
1898500,2267779085,81374387,1.0985542245000001e-11,18303086,1328276,3206105044
1899000,2370694604,81370059,1.0984957965e-11,18161193,1328688,3207433732
1899500,2317994346,81356287,1.0983098745000001e-11,17714840,1328284,3208762016
1900000,4841188404,81354515,1.0982859525000001e-11,17657259,1327784,3210089800
1900500,11358490704,81716919,1.1031784065e-11,17766122,1327784,3211417584
1901000,8720331425,81909115,1.1057730525000001e-11,18177845,1328276,3212745860
1901500,2118520334,81372080,1.09852308e-11,18228130,1328312,3214074172
1902000,2138928354,81371741,1.0985185034999999e-11,18217098,1327796,3215401968
1902500,2118809911,81369653,1.0984903155e-11,18149245,1329672,3216731640
1903000,2100728458,81671618,1.1025668429999999e-11,18238718,1329276,3218060916
1903500,2092982507,81373633,1.0985440455e-11,18278604,1328312,3219389228
1904000,2091684147,81371487,1.0985150745000001e-11,18208842,1329660,3220718888
1904500,2087137540,81368079,1.0984690665e-11,18098072,1327796,3222046684
1905000,2190874535,81370500,1.09850175e-11,18176778,1328312,3223374996
1905500,2136102606,81678462,1.1026592370000001e-11,18461148,1327812,3224702808
1906000,2255133713,81374225,1.0985520375000002e-11,18297845,1329784,3226032592
1906500,2129849203,81359611,1.0983547485000002e-11,17822885,1329680,3227362272
1907000,2345309273,81373986,1.098548811e-11,18290075,1329680,3228691952
1907500,2242434527,81670432,1.102550832e-11,18200174,1327812,3230019764
1908000,2177202409,81362862,1.098398637e-11,17928540,1328304,3231348068
1908500,2048276009,81355753,1.0983026655000001e-11,17697499,1328188,3232676256
1909000,2479650737,81373020,1.0985357700000001e-11,18258660,1329284,3234005540
1909500,2586007910,81674636,1.102607586e-11,18336790,1329312,3235334852
1910000,8845521862,81373579,1.0985433165e-11,18276837,1328688,3236663540
1910500,14397329045,82120887,1.1086319745e-11,18253379,1326436,3237989976
1911000,2120371878,81371889,1.0985205015e-11,18221906,1328784,3239318760
1911500,2115431646,81370544,1.098502344e-11,18176939,1327768,3240646528
1912000,2107832450,81372373,1.0985270354999999e-11,18237640,1328768,3241975296
1912500,2112536243,81371516,1.0985154660000001e-11,18209802,1328276,3243303572
1913000,2105561483,81672555,1.1025794925000001e-11,18269172,1328276,3244631848
1913500,2100495227,81372564,1.0985296140000001e-11,18243843,1329260,3245961108
1914000,2102508246,81367928,1.098467028e-11,18093185,1329660,3247290768
1914500,2096120008,81361331,1.0983779685000002e-11,17878780,1328276,3248619044
1915000,2113583150,81657655,1.1023783425000002e-11,17784925,1328768,3249947812
1915500,2151820635,81362700,1.0983964500000001e-11,17923277,1328784,3251276596
1916000,2102135919,81373116,1.098537066e-11,18261779,1329276,3252605872
1916500,2243790611,81373474,1.0985418990000001e-11,18273414,1327812,3253933684
1917000,2220848353,81674730,1.102608855e-11,18339842,1329312,3255262996
1917500,2116840018,81376146,1.098577971e-11,18360265,1329776,3256592772
1918000,2124512684,81372701,1.0985314635000001e-11,18248314,1328284,3257921056
1918500,2145083018,81373351,1.0985402385000001e-11,18269428,1327784,3259248840
1919000,2243183952,81372445,1.0985280074999999e-11,18239981,1329276,3260578116
1919500,2441664112,81672985,1.1025852975e-11,18283152,1327768,3261905884
1920000,8750040016,81374712,1.0985586120000001e-11,18313677,1328276,3263234160
1920500,14445381818,82095381,1.1082876435e-11,18396853,1329284,3264563444
1921000,2175915318,81373908,1.0985477580000001e-11,18287525,1328280,3265891724
1921500,2123190111,81372305,1.0985261175e-11,18235436,1327812,3267219536
1922000,2101362367,81371835,1.0985197725000002e-11,18220152,1327804,3268547340
1922500,2102447649,81366566,1.098448641e-11,18048913,1330188,3269877528
1923000,2099168264,81657106,1.102370931e-11,17767070,1327760,3271205288
1923500,2093731409,81368406,1.0984734810000001e-11,18108713,1327780,3272533068
1924000,2090799440,81376563,1.0985836005e-11,18372191,1329688,3273862756
1924500,2088403574,81371487,1.0985150745000001e-11,18208851,1327768,3275190524
1925000,2122776766,81675771,1.1026229085000001e-11,18274469,1328264,3276518788
1925500,2116428749,81374857,1.0985605695000002e-11,18318384,1328268,3277847056
1926000,2234121863,81374621,1.0985573835e-11,18310692,1327804,3279174860
1926500,2178614725,81372963,1.0985350005000001e-11,18256816,1328804,3280503664
1927000,2393082709,81677142,1.1026414170000002e-11,18319020,1327812,3281831476
1927500,2336986748,81375038,1.0985630129999999e-11,18324244,1327796,3283159272
1928000,2133399640,81371070,1.0985094450000001e-11,18195306,1328156,3284487428
1928500,2240012240,81373812,1.0985464619999999e-11,18284398,1328796,3285816224
1929000,2122034897,81373803,1.0985463405000002e-11,18284102,1328296,3287144520
1929500,6677887896,81708830,1.103069205e-11,18366518,1328812,3288473332
1930000,8745924854,81360032,1.0983604320000001e-11,17836563,1329532,3289802864
1930500,8760098195,82028151,1.1073800385e-11,17938486,1329312,3291132176
1931000,2139561389,81355373,1.0982975355e-11,17685154,1328312,3292460488
1931500,2109361859,81365394,1.0984328190000002e-11,18010834,1328812,3293789300
1932000,2099403688,81373233,1.0985386455000001e-11,18265601,1329180,3295118480
1932500,2150443359,81368443,1.0984739805000001e-11,18109924,1327804,3296446284
1933000,2109929645,81672135,1.1025738225000001e-11,18156290,1327784,3297774068
1933500,2094832133,81374749,1.0985591115000001e-11,18314864,1328796,3299102864
1934000,2097226258,81372881,1.0985338935e-11,18254153,1329180,3300432044
1934500,2092271852,81374117,1.0985505795000001e-11,18294328,1329804,3301761848
1935000,2090184319,81675396,1.102617846e-11,18262270,1328796,3303090644
1935500,2089329748,81375608,1.098570708e-11,18342777,1330652,3304421296
1936000,2085118143,81374714,1.0985586390000001e-11,18313709,1328276,3305749572
1936500,2088941805,81379018,1.098616743e-11,18451945,1329644,3307079216
1937000,2088987690,81366836,1.098452286e-11,18057673,1327276,3308406492
1937500,2082845031,81673878,1.102597353e-11,18113724,1328784,3309735276
1938000,2244584306,81369858,1.0984930830000001e-11,18155911,1329284,3311064560
1938500,2237359511,81371876,1.0985203260000002e-11,18221471,1328776,3312393336
1939000,2114828850,81373447,1.0985415345e-11,18272546,1327784,3313721120
1939500,2123850003,81674126,1.1026007010000001e-11,18121770,1327784,3315048904
1940000,2112992878,81372262,1.0985255370000001e-11,18234029,1327784,3316376688
1940500,2237048636,81378320,1.09860732e-11,18430909,1329256,3317705944
1941000,2192056194,81363109,1.0984019715e-11,17936551,1328772,3319034716
1941500,2159663894,81667970,1.102517595e-11,17921698,1327776,3320362492
1942000,2492776187,81362916,1.098399366e-11,17930272,1328784,3321691276
1942500,6613584499,81362876,1.098398826e-11,17928994,1328284,3323019560
1943000,9374661433,81760240,1.1037632400000001e-11,17943657,1328760,3324348320
1943500,4971233178,81700425,1.1029557375e-11,17984238,1328304,3325676624
1944000,2095962302,81361367,1.0983784545000001e-11,17879939,1328276,3327004900
1944500,2136098944,81371518,1.0985154930000001e-11,18209864,1329288,3328334188
1945000,2119444833,81374727,1.0985588145e-11,18314132,1328644,3329662832
1945500,2113193292,81670268,1.102548618e-11,17996379,1328776,3330991608
1946000,2114115024,81352498,1.0982587230000002e-11,17591713,1328768,3332320376
1946500,2109304802,81359336,1.0983510360000002e-11,17813934,1329304,3333649680
1947000,2108059475,81370447,1.0985010345e-11,18175040,1329312,3334978992
1947500,2104594333,81371001,1.0985085135000001e-11,18193054,1328304,3336307296
1948000,2102367388,81675910,1.1026247850000002e-11,18179746,1327812,3337635108
1948500,2527282777,81369804,1.0984923540000001e-11,18154159,1328180,3338963288
1949000,2116029817,81369156,1.098483606e-11,18131431,1328284,3340291572
1949500,2162760962,81369998,1.098494973e-11,18160461,1329272,3341620844
1950000,2108765698,81677950,1.1026523250000001e-11,18146837,1328276,3342949120
1950500,2128580736,81374207,1.0985517945e-11,18297237,1328772,3344277892
1951000,2130635861,81370980,1.09850823e-11,18192352,1328776,3345606668
1951500,2259104149,81371904,1.0985207040000002e-11,18222410,1328312,3346934980
1952000,2304306045,81681359,1.1026983465e-11,18257615,1330160,3348265140
1952500,2106526100,81364619,1.0984223565000002e-11,17985634,1330064,3349595204
1953000,2099354325,81340393,1.0980953055e-11,17198282,1329312,3350924516
1953500,5008585958,81340557,1.0980975195000001e-11,17203636,1328636,3352253152
1954000,8939642042,81662804,1.102447854e-11,17654586,1328312,3353581464
1954500,18162500976,82181560,1.10945106e-11,17476676,1328804,3354910268
1955000,2118155369,81359506,1.0983533310000001e-11,17819448,1328804,3356239072
1955500,2124097950,81358068,1.0983339180000001e-11,17772736,1329652,3357568724
1956000,2108051327,81358141,1.0983349035000002e-11,17775117,1329784,3358898508
1956500,2117916709,81357802,1.098330327e-11,17764077,1328284,3360226792
1957000,2133260803,81357396,1.0983248460000001e-11,17750907,1329284,3361556076
1957500,2120422250,81357990,1.0983328650000001e-11,17770193,1327760,3362883836
1958000,2105565997,81358680,1.09834218e-11,17792612,1328284,3364212120
1958500,2099854461,81357790,1.0983301650000002e-11,17763692,1327760,3365539880
1959000,2140988862,81662133,1.1024387955e-11,17632775,1327764,3366867644
1959500,2313858157,81359412,1.098352062e-11,17816404,1328784,3368196428
1960000,2233184018,81355563,1.0983001005e-11,17691312,1329152,3369525580
1960500,2200138834,81343864,1.098142164e-11,17311094,1328784,3370854364
1961000,2108615666,81652806,1.102312881e-11,17329650,1327812,3372182176
1961500,2110177348,81355521,1.0982995335e-11,17688276,1329296,3373511472
1962000,2236467759,81356813,1.0983169755000001e-11,17731950,1328812,3374840284
1962500,2235295444,81358686,1.098342261e-11,17792814,1328812,3376169096
1963000,2183477104,81667769,1.1025148815e-11,17716768,1328260,3377497356
1963500,2315974642,81358814,1.098343989e-11,17796971,1327756,3378825112
1964000,2364305161,81356668,1.098315018e-11,17727246,1327312,3380152424
1964500,5053425237,81359681,1.0983556935000001e-11,17825163,1328784,3381481208
1965000,8856834754,81764771,1.1038244085e-11,17832911,1329276,3382810484
1965500,8838469886,81703166,1.1029927410000001e-11,17855029,1328280,3384138764
1966000,2140144934,81355921,1.0983049335e-11,17702962,1328312,3385467076
1966500,2134583843,81357241,1.0983227535e-11,17745856,1328796,3386795872
1967000,2135130157,81667751,1.1025146385000001e-11,17716160,1328304,3388124176
1967500,2122036597,81360281,1.0983637935e-11,17844638,1328312,3389452488
1968000,2121698446,81355361,1.0982973735e-11,17684759,1330536,3390783024
1968500,2194844199,81342431,1.0981228185e-11,17264525,1329268,3392112292
1969000,2133253151,81666063,1.1024918505000002e-11,17661330,1328312,3393440604
1969500,2116032463,81358196,1.098335646e-11,17776898,1329284,3394769888
1970000,2110641528,81354403,1.0982844405e-11,17653602,1328304,3396098192
1970500,2109405252,81357872,1.098331272e-11,17766356,1327812,3397426004
1971000,2095273557,81344546,1.0981513710000002e-11,17333254,1328804,3398754808
1971500,2102001328,81666705,1.1025005175000001e-11,17682188,1327312,3400082120
1972000,2115463383,81359481,1.0983529935e-11,17818662,1329640,3401411760
1972500,2096594577,81353688,1.0982747880000001e-11,17630372,1328296,3402740056
1973000,2094770900,81356188,1.098308538e-11,17711646,1327804,3404067860
1973500,2090642474,81668056,1.102518756e-11,17726084,1328280,3405396140
1974000,2116230108,81357642,1.098328167e-11,17757178,1329304,3406725444
1974500,2108804111,81356115,1.0983075525e-11,17709254,1329660,3408055104
1975000,2247508301,81358208,1.0983358080000001e-11,17777278,1328812,3409383916
1975500,2243491743,81666084,1.102492134e-11,17562761,1329172,3410713088
1976000,2150497202,81338196,1.0980656460000001e-11,17126900,1327812,3412040900
1976500,2116393645,81343349,1.0981352115e-11,17294368,1327796,3413368696
1977000,2232723437,81334167,1.0980112545000001e-11,16995946,1328304,3414697000
1977500,2144536910,81335659,1.0980313965e-11,17044437,1329188,3416026188
1978000,2132958657,81653169,1.1023177815000001e-11,17143030,1328296,3417354484
1978500,2168087034,81352195,1.0982546325e-11,17581856,1328304,3418682788
1979000,6641060699,81353291,1.0982694285e-11,17617476,1328812,3420011600
1979500,8823132985,81760377,1.1037650895000001e-11,17561159,1329188,3421340788
1980000,3409331194,81666518,1.102497993e-11,17576870,1328288,3422669076
1980500,2116086760,81362086,1.098388161e-11,17903302,1328276,3423997352
1981000,2119464115,81358085,1.0983341475e-11,17773296,1328804,3425326156
1981500,2112978729,81357870,1.098331245e-11,17766301,1329784,3426655940
1982000,2115906725,81355628,1.098300978e-11,17693410,1328284,3427984224
1982500,2109749093,81671862,1.1025701369999999e-11,17750558,1329284,3429313508
1983000,2170495426,81348542,1.0982053170000001e-11,17463123,1329688,3430643196
1983500,2108278343,81341919,1.0981159065000002e-11,17247877,1329280,3431972476
1984000,2101256361,81341960,1.0981164599999999e-11,17249223,1328284,3433300760
1984500,2100725409,81354184,1.0982814840000002e-11,17646487,1328284,3434629044
1985000,2097242799,81673172,1.1025878220000001e-11,17793122,1328312,3435957356
1985500,2094301975,81359716,1.0983561660000001e-11,17826285,1328776,3437286132
1986000,2097019330,81356243,1.0983092805e-11,17713413,1328784,3438614916
1986500,2097924030,81357766,1.098329841e-11,17761218,1328812,3439943728
1987000,2103745777,81677426,1.1026452510000002e-11,17832158,1330144,3441273872
1987500,4849818485,81357053,1.0983202155e-11,17739749,1328284,3442602156
1988000,2210966503,81359726,1.098356301e-11,17826602,1329296,3443931452
1988500,5077907867,81709683,1.1030807205e-11,17848550,1329144,3445260596
1989000,4869108760,81357642,1.098328167e-11,17758891,1328772,3446589368
1989500,2201153633,81675006,1.1026125810000002e-11,17753510,1328296,3447917664
1990000,5209405795,81359353,1.0983512655e-11,17814504,1328768,3449246432
1990500,6753569450,81679142,1.1026684170000001e-11,17887935,1331036,3450577468
1991000,2722980546,81362102,1.0983883770000001e-11,17903844,1328796,3451906264
1991500,9073514120,81690835,1.1028262725000001e-11,18267972,1327804,3453234068
1992000,14447902077,81371972,1.0985216220000001e-11,18224591,1329188,3454563256
1992500,2122008112,81973489,1.1066421015e-11,18166472,1328284,3455891540
1993000,3349890794,81373884,1.098547434e-11,18286740,1329312,3457220852
1993500,2112782730,81375010,1.098562635e-11,18323348,1328304,3458549156
1994000,3331825232,81690743,1.1028250305e-11,18264973,1329180,3459878336
1994500,3335387451,81375548,1.0985698980000002e-11,18340844,1328312,3461206648
1995000,2126277047,81372832,1.098533232e-11,18252544,1328312,3462534960
1995500,2099312090,81692917,1.1028543795e-11,18335647,1330180,3463865140
1996000,2096479671,81373164,1.0985377140000001e-11,18263356,1329616,3465194756
1996500,2095042551,81360601,1.0983681135e-11,17855048,1329160,3466523916
1997000,2089054486,81350825,1.0982361375e-11,17537318,1328312,3467852228
1997500,2090697224,81355213,1.0982953755e-11,17679942,1328812,3469181040
1998000,2089413555,81668339,1.1025225765000001e-11,17536854,1327812,3470508852
1998500,2081754635,81356117,1.0983075794999999e-11,17709331,1328780,3471837632
1999000,2087991056,81367016,1.098454716e-11,18061799,1328276,3473165908
1999500,2089788349,81368152,1.098470052e-11,18100459,1328772,3474494680
2000000,2088010560,81368686,1.098477261e-11,18117816,1328312,3475822992
2000500,2250204148,81374410,1.098554535e-11,18303830,1329304,3477152296
2001000,2162011848,81370932,1.0985075820000001e-11,18190823,1330188,3478482484
2001500,2199617240,81366680,1.0984501800000001e-11,18052622,1327768,3479810252
2002000,2154610075,81361724,1.098383274e-11,17891558,1328776,3481139028
2002500,2597672693,81679120,1.10266812e-11,17787994,1328284,3482467312
2003000,2129100437,81354814,1.0982899890000001e-11,17666986,1327812,3483795124
2003500,2233828378,81354297,1.0982830095e-11,17650160,1328776,3485123900
2004000,2368997829,81362485,1.0983935475000002e-11,17916294,1327784,3486451684
2004500,2216221518,81688063,1.1027888505e-11,18078649,1328680,3487780364
2005000,5106306684,81360353,1.0983647655e-11,17846986,1329296,3489109660
2005500,14458984096,84800131,1.1448017685e-11,17928155,1333724,3490443384
2006000,11251253334,96251172,1.2993908220000002e-11,22234544,1327812,3491771196
2006500,2112800509,95564124,1.2901156740000001e-11,22592026,1327804,3493099000
2007000,2155560677,95566217,1.2901439295000001e-11,22740996,1329180,3494428180
2007500,3353711469,95572097,1.2902233095e-11,22738392,1328296,3495756476
2008000,3350975294,95900887,1.2946619745000002e-11,22797612,1328312,3497084788
2008500,3416449967,95566279,1.2901447665e-11,22779224,1328312,3498413100
2009000,3337994365,95569010,1.290181635e-11,22835746,1328796,3499741896
2009500,2097423733,95895964,1.2945955140000001e-11,22702428,1329160,3501071056
2010000,3327972485,95566590,1.290148965e-11,22740130,1328812,3502399868
2010500,2089492205,95573649,1.2902442615000001e-11,22893333,1329312,3503729180
2011000,2087287986,95561143,1.2900754305000001e-11,22556377,1328272,3505057452
2011500,2104213056,95931495,1.2950751825000001e-11,22773544,1328812,3506386264
2012000,2089148975,95567216,1.2901574159999999e-11,22702262,1330004,3507716268
2012500,2086645639,95552544,1.289959344e-11,22190723,1329804,3509046072
2013000,2084124140,95550593,1.2899330055000001e-11,22226105,1328796,3510374868
2013500,2079256243,95594329,1.2905234415e-11,22653520,2810120,3513184988
2014000,2083557353,87783279,1.1850742665000002e-11,21700834,39647508,3552832496
2014500,2077548607,87770588,1.184902938e-11,21820944,39655520,3592488016
2015000,2084148230,87793815,1.1852165025000002e-11,21767246,39650780,3632138796
2015500,2085075634,87795281,1.1852362935e-11,21766552,39649112,3671787908
2016000,2082324134,88141010,1.189903635e-11,21657905,39655284,3711443192
2016500,4784354092,87794202,1.1852217270000001e-11,21743950,39650200,3751093392
2017000,5041353486,88164571,1.1902217085000001e-11,21758946,39650632,3790744024
2017500,4910086892,89488483,1.2080945205e-11,21602186,28913228,3819657252
2018000,8775662074,93992812,1.268902962e-11,20919604,1328284,3820985536
2018500,8788935162,93609091,1.2637227285000002e-11,20841372,1327776,3822313312
2019000,8891287087,93720212,1.2652228620000001e-11,20979922,1328276,3823641588
2019500,6635946858,93667558,1.2645120330000001e-11,20883381,1327772,3824969360
2020000,8748610208,93880462,1.2673862370000001e-11,20930880,1330160,3826299520
2020500,3354470209,93302655,1.2595858425e-11,20626560,1329812,3827629332
2021000,3345962589,93913914,1.267837839e-11,20326021,1328268,3828957600
2021500,3347984184,93868085,1.2672191474999999e-11,20385163,1328284,3830285884
2022000,3302662490,93484404,1.2620394540000001e-11,20381075,1329280,3831615164
2022500,2087938502,93318749,1.2598031115e-11,20959325,1328784,3832943948
2023000,2087712135,93671287,1.2645623745e-11,20957514,1328784,3834272732
2023500,2083688373,93311719,1.2597082065e-11,20817300,1327784,3835600516
2024000,2080648334,93320405,1.2598254675e-11,20883209,1328768,3836929284
2024500,3316157386,94243030,1.2722809050000002e-11,20793024,1327784,3838257068
2025000,3318315875,93439948,1.2614392979999999e-11,21000101,1329284,3839586352
2025500,3317238834,93450716,1.261584666e-11,21135921,-664113148,3175473204
2026000,2085929569,81372384,1.098527184e-11,18237994,1329312,3176802516
2026500,2088344745,81369937,1.0984941495e-11,18158470,1327784,3178130300
2027000,2103806765,81737931,1.1034620685000002e-11,18211100,1327796,3179458096
2027500,2094646175,81373699,1.0985449365000002e-11,18280730,1329304,3180787400
2028000,2086299161,81371436,1.098514386e-11,18207195,1328760,3182116160
2028500,2188021613,81365865,1.0984391775e-11,18026132,1329160,3183445320
2029000,2087082278,81721867,1.1032452045e-11,17689000,1328812,3184774132
2029500,2237518334,81358838,1.0983443130000002e-11,17797738,1328812,3186102944
2030000,2121040809,81366604,1.098449154e-11,18050144,1328304,3187431248
2030500,2118921264,81378367,1.0986079545e-11,18432454,1328788,3188760036
2031000,2237614476,81369403,1.0984869405e-11,18141104,1327812,3190087848
2031500,2130122673,81738843,1.1034743805000001e-11,18240724,1328804,3191416652
2032000,2188510896,81370978,1.098508203e-11,18192310,1328804,3192745456
2032500,2259191975,81371221,1.0985114835e-11,18200195,1329188,3194074644
2033000,2250661953,81372828,1.098533178e-11,18252434,1329312,3195403956
2033500,4938386201,81738627,1.1034714645e-11,18233690,1328304,3196732260
2034000,8917542132,81370888,1.098506988e-11,18189397,1329180,3198061440
2034500,6796803486,81811577,1.1044562895000002e-11,18223122,1328796,3199390236
2035000,2119423433,81737265,1.1034530775000002e-11,18189452,1327804,3200718040
2035500,2121482094,81378345,1.0986076575e-11,18431730,1328804,3202046844
2036000,2140422631,81365687,1.0984367745e-11,18020333,1330160,3203377004
2036500,2138821673,81364408,1.0984195080000001e-11,17978780,1327312,3204704316
2037000,2123237305,81374864,1.098560664e-11,18318595,1330636,3206034952
2037500,2119483236,81731299,1.1033725365000001e-11,17995546,1328812,3207363764
2038000,2114663638,81354368,1.098283968e-11,17652486,1328812,3208692576
2038500,2119209660,81372910,1.098534285e-11,18254919,1330180,3210022756
2039000,2109734523,81373046,1.098536121e-11,18259524,1328812,3211351568
2039500,2107907910,81737408,1.103455008e-11,18194090,1328304,3212679872
2040000,2178826003,81372258,1.098525483e-11,18233890,1329144,3214009016
2040500,2183773269,81376390,1.098581265e-11,18368180,1329276,3215338292
2041000,2178069031,81373770,1.0985458950000001e-11,18283034,1328284,3216666576
2041500,2211167598,81738970,1.1034760950000001e-11,18244855,1328276,3217994852
2042000,2155703345,81372215,1.0985249025e-11,18232498,1328276,3219323128
2042500,2293448709,81375032,1.0985629320000002e-11,18324044,1329784,3220652912
2043000,2129103235,81368444,1.0984739940000002e-11,18109962,1329152,3221982064
2043500,2194689594,81726539,1.1033082765000002e-11,17840861,1328284,3223310348
2044000,2295593032,81355839,1.0983038265e-11,17700274,1328784,3224639132
2044500,2154883548,81356516,1.098312966e-11,17722270,1328268,3225967400
2045000,5466773864,81357677,1.0983286395000001e-11,17760020,1328776,3227296176
2045500,8744909233,81739619,1.1034848565e-11,18265967,1327276,3228623452
2046000,18077933899,82397596,1.112367546e-11,18217222,1329276,3229952728
2046500,2131287072,81369717,1.0984911795e-11,18151322,1328804,3231281532
2047000,2148319537,81369078,1.098482553e-11,18130552,1327796,3232609328
2047500,2147071043,81370554,1.098502479e-11,18178520,1328312,3233937640
2048000,2112461028,81374863,1.0985606504999999e-11,18318567,1329780,3235267420
2048500,2111681700,81742009,1.1035171215e-11,18343614,1329660,3236597080
2049000,2108779536,81367641,1.0984631534999999e-11,18083854,1328768,3237925848
2049500,2103815669,81369456,1.0984876560000001e-11,18142830,1328304,3239254152
2050000,2097845665,81372064,1.098522864e-11,18227578,1328312,3240582464
2050500,2096428457,81739999,1.1034899865000002e-11,18278296,1328304,3241910768
2051000,2291083751,81363060,1.09840131e-11,17934801,1328688,3243239456
2051500,2284216678,81355463,1.0982987505000001e-11,17688056,1328296,3244567752
2052000,2100253147,81370689,1.0985043015e-11,18182904,1329660,3245897412
2052500,2238147124,81738180,1.10346543e-11,18219174,1327812,3247225224
2053000,2122574795,81372592,1.0985299920000001e-11,18244738,1327812,3248553036
2053500,2130971197,81372003,1.0985220405e-11,18225606,1328312,3249881348
2054000,2247341199,81372408,1.098527508e-11,18238785,1329164,3251210512
2054500,2236783971,81370844,1.098506394e-11,18187930,1327804,3252538316
2055000,2315769783,81740142,1.103491917e-11,18282940,1328796,3253867112
2055500,2179110117,81372640,1.09853064e-11,18246316,1328312,3255195424
2056000,2172387146,81373222,1.098538497e-11,18265235,1328284,3256523708
2056500,2098176935,81369948,1.0984942980000001e-11,18158808,1328276,3257851984
2057000,2240261938,81741296,1.1035074960000001e-11,18320466,1329284,3259181268
2057500,2223877616,81372911,1.0985342985000001e-11,18255120,1329276,3260510544
2058000,2417068814,81373447,1.0985415345e-11,18272533,1328752,3261839296
2058500,2265678594,81370046,1.0984956210000002e-11,18162019,1329652,3263168948
2059000,2222906775,81353800,1.0982763000000001e-11,17634037,1326784,3264495732
2059500,11277202583,81797435,1.1042653725000001e-11,17763509,1328776,3265824508
2060000,2113142799,81357856,1.0983310560000002e-11,17765844,1328784,3267153292
2060500,2120771188,81367345,1.0984591575e-11,18074222,1328304,3268481596
2061000,2112951791,81370434,1.0985008590000002e-11,18174614,1328276,3269809872
2061500,2110932220,81737351,1.1034542385e-11,18192243,1328272,3271138144
2062000,2102532219,81372102,1.098523377e-11,18228838,1328304,3272466448
2062500,2105286991,81370988,1.098508338e-11,18192627,1327776,3273794224
2063000,2154951892,81373429,1.0985412915e-11,18271956,1328812,3275123036
2063500,2116470877,81370756,1.0985052060000002e-11,18184870,1328312,3276451348
2064000,2113646000,81740482,1.103496507e-11,18294003,1328776,3277780124
2064500,2133814977,81371151,1.0985105385e-11,18197910,1328304,3279108428
2065000,2236479313,81373970,1.098548595e-11,18289538,1328312,3280436740
2065500,2165237638,81379422,1.098622197e-11,18466734,1329660,3281766400
2066000,2651720363,81364512,1.0984209120000001e-11,17982161,1327784,3283094184
2066500,2199971285,81369128,1.098483228e-11,18132194,1329152,3284423336
2067000,2215469508,81359919,1.0983589065e-11,17832868,1328312,3285751648
2067500,2164219235,81728033,1.1033284455e-11,17889398,1329304,3287080952
2068000,2315820872,81359792,1.0983571920000002e-11,17828769,1329644,3288410596
2068500,2217012929,81360191,1.0983625785e-11,17841732,1328804,3289739400
2069000,2138822555,81357852,1.0983310020000001e-11,17765692,1327776,3291067176
2069500,4953611373,81725197,1.1032901595000001e-11,17797224,1328268,3292395444
2070000,9184662972,81361834,1.098384759e-11,17895124,1328312,3293723756
2070500,14505814329,82278166,1.110755241e-11,17907882,1327304,3295051060
2071000,2113186201,81356800,1.0983168e-11,17731528,1328312,3296379372
2071500,2121954275,81365466,1.0984337910000002e-11,18013166,1327804,3297707176
2072000,2120758964,81373568,1.0985431679999999e-11,18276458,1328304,3299035480
2072500,2124719921,81741517,1.1035104795e-11,18327638,1328660,3300364140
2073000,2123294469,81375196,1.098565146e-11,18329386,1328304,3301692444
2073500,2123137969,81376163,1.0985782005e-11,18360822,1328304,3303020748
2074000,2127256628,81377908,1.098601758e-11,18417527,1330188,3304350936
2074500,2128805249,81740607,1.1034981945e-11,18298070,1328804,3305679740
2075000,2087516051,81374645,1.0985577075000001e-11,18311478,1328812,3307008552
2075500,2424421575,81372851,1.0985334885000001e-11,18253186,1328804,3308337356
2076000,2145219053,81375966,1.0985755410000001e-11,18354101,1329784,3309667140
2076500,2317419270,81740185,1.1034924975e-11,18284332,1328284,3310995424
2077000,2227241467,81374535,1.0985562225e-11,18307889,1328776,3312324200
2077500,2290325729,81369502,1.098488277e-11,18144321,1329660,3313653860
2078000,2143158807,81357671,1.0983285585000001e-11,17759826,1329276,3314983136
2078500,2315599170,81722699,1.1032564365e-11,17716058,1327784,3316310920
2079000,2487755904,81361413,1.0983790755e-11,17881436,1327784,3317638704
2079500,2240952748,81372782,1.0985325570000001e-11,18250945,1327776,3318966480
2080000,2552528175,81728925,1.1033404875000001e-11,17918395,1328284,3320294764
2080500,2407819117,81375762,1.0985727870000001e-11,18347786,1328268,3321623032
2081000,6714813361,81373665,1.0985444775000002e-11,18279630,1328804,3322951836
2081500,9008380168,81811910,1.104460785e-11,18233932,1327312,3324279148
2082000,18351801238,82252059,1.1104027965e-11,18250160,1328812,3325607960
2082500,2117068392,81372102,1.098523377e-11,18228836,1327784,3326935744
2083000,2117028367,81373405,1.0985409675000001e-11,18271171,1328772,3328264516
2083500,2113589339,81373491,1.0985421285000001e-11,18273967,1328780,3329593296
2084000,2106648911,81371788,1.0985191380000001e-11,18218640,1328812,3330922108
2084500,2109019940,81738839,1.1034743265e-11,18240611,1328284,3332250392
2085000,2100764243,81376520,1.09858302e-11,18372429,1329284,3333579676
2085500,2099353822,81376023,1.0985763105e-11,18356260,1328784,3334908460
2086000,2109279391,81361456,1.0983796560000001e-11,17882834,1331040,3336239500
2086500,2097125631,81709134,1.103073309e-11,17275190,1329312,3337568812
2087000,2154693587,81343517,1.0981374795000001e-11,17299822,1329160,3338897972
2087500,2242292257,81342996,1.098130446e-11,17282870,1328304,3340226276
2088000,2141636495,81356486,1.0983125610000001e-11,17721320,1328304,3341554580
2088500,2284373972,81726985,1.1033142975e-11,17854960,1328312,3342882892
2089000,2306376482,81356878,1.098317853e-11,17734064,1327304,3344210196
2089500,2241132759,81357355,1.0983242925000001e-11,17749543,1329180,3345539376
2090000,2413852315,81356505,1.0983128175e-11,17721945,1328284,3346867660
2090500,2900071499,81727928,1.1033270280000001e-11,17885988,1328784,3348196444
2091000,2530463581,81354014,1.098279189e-11,17640984,1327812,3349524256
2091500,2589401140,81354383,1.0982841705000001e-11,17652954,1328812,3350853068
2092000,4316939727,81356322,1.0983103470000001e-11,17715992,1328296,3352181364
2092500,5278779992,81758388,1.1037382380000002e-11,17685195,1329188,3353510552
2093000,11508693276,81787471,1.1041308585000001e-11,17439667,1329688,3354840240
2093500,22551416053,82327754,1.1114246790000002e-11,17138050,1328812,3356169052
2094000,2128796392,81353142,1.098267417e-11,17612619,1328160,3357497212
2094500,2139813602,81354830,1.098290205e-11,17667480,1328804,3358826016
2095000,2129960599,81356978,1.098319203e-11,17737314,1328804,3360154820
2095500,2122598937,81730827,1.1033661645e-11,17980226,1328284,3361483104
2096000,2125887380,81358404,1.098338454e-11,17783645,1328284,3362811388
2096500,2124693423,81355263,1.0982960505000002e-11,17681572,1327784,3364139172
2097000,2124349312,81357610,1.098327735e-11,17757844,1327784,3365466956
2097500,2090311779,81721692,1.103242842e-11,17683311,1327776,3366794732
2098000,2088739141,81358963,1.0983460005e-11,17801816,1328276,3368123008
2098500,2113956905,81357336,1.0983240360000001e-11,17748947,1327276,3369450284
2099000,2110587890,81357428,1.098325278e-11,17751930,1329268,3370779552
2099500,2110273661,81358201,1.0983357135e-11,17777066,1329312,3372108864
2100000,2109826952,81725662,1.1032964370000001e-11,17812347,1329688,3373438552
2100500,2107425765,81359065,1.0983473775e-11,17805137,1329660,3374768212
2101000,2112045151,81361492,1.098380142e-11,17883612,1328784,3376096996
2101500,2201285854,81357439,1.0983254265000001e-11,17752293,1328688,3377425684
2102000,2268965698,81727145,1.1033164575e-11,17860538,1328304,3378753988
2102500,2134518177,81373801,1.0985463135000001e-11,18284058,1327812,3380081800
2103000,2207820952,81376784,1.0985865840000002e-11,18381010,1328296,3381410096
2103500,2247387731,81375964,1.0985755140000001e-11,18354358,1328312,3382738408
2104000,2153202942,81738798,1.1034737730000002e-11,18239260,1328660,3384067068
2104500,2171668542,81372070,1.098522945e-11,18227784,1327812,3385394880
2105000,2237654566,81373525,1.0985425875000001e-11,18275080,1328804,3386723684
2105500,2197753232,81377521,1.0985965335e-11,18404942,1327812,3388051496
2106000,2164754548,81742824,1.103528124e-11,18370100,1328784,3389380280
2106500,2239514934,81374183,1.0985514705000001e-11,18296459,1330152,3390710432
2107000,2169429182,81373445,1.0985415075000001e-11,18272490,1328312,3392038744
2107500,4988903771,81368868,1.098479718e-11,18123729,1329188,3393367932
2108000,9083163404,81726041,1.1033015535000001e-11,17824650,1328804,3394696736
2108500,27584480078,82545809,1.1143684215000002e-11,18271278,1329652,3396026388
2109000,2159413431,81377873,1.0986012855e-11,18416382,1329296,3397355684
2109500,2119605629,81373384,1.098540684e-11,18270494,1328312,3398683996
2110000,2229656641,81739236,1.103479686e-11,18253493,1329172,3400013168
2110500,2116784515,81377672,1.098598572e-11,18409840,1328304,3401341472
2111000,2115125357,81377378,1.0985946030000002e-11,18400294,1328784,3402670256
2111500,2112376087,81373931,1.0985480685e-11,18288269,1328680,3403998936
2112000,2108263100,81737742,1.103459517e-11,18204948,1328296,3405327232
2112500,2104892194,81372432,1.0985278320000001e-11,18239542,1328304,3406655536
2113000,2103830315,81375907,1.0985747445000002e-11,18352486,1329812,3407985348
2113500,2103839122,81374896,1.098561096e-11,18319159,1329652,3409315000
2114000,2096883349,81368470,1.098474345e-11,18110790,1329660,3410644660
2114500,2095221896,81722439,1.1032529265e-11,17707600,1328312,3411972972
2115000,2114623799,81365657,1.0984363695000001e-11,18019378,1328284,3413301256
2115500,2112058795,81377247,1.0985928345e-11,18396044,1327812,3414629068
2116000,2096418851,81370844,1.098506394e-11,18187942,1329784,3415958852
2116500,2093677373,81738294,1.1034669690000001e-11,18222873,1329688,3417288540
2117000,2095693293,81371472,1.0985148720000001e-11,18208372,1328812,3418617352
2117500,2303686874,81372935,1.0985346225e-11,18255898,1328304,3419945656
2118000,2452820032,81374460,1.09855521e-11,18305480,1328312,3421273968
2118500,2207669254,81738863,1.1034746505000001e-11,18241395,1330188,3422604156
2119000,2376441586,81374730,1.098558855e-11,18314245,1329780,3423933936
2119500,2422849810,81375296,1.098566496e-11,18332651,1329180,3425263116
2120000,2549844065,81371452,1.0985146020000001e-11,18207708,1328296,3426591412
2120500,2235460667,81742238,1.1035202130000002e-11,18351068,1328312,3427919724
2121000,2383088232,81368635,1.0984765725000001e-11,18116146,1328144,3429247868
2121500,2843455455,81359397,1.0983518595000001e-11,17815936,1328804,3430576672
2122000,2274792888,81355121,1.0982941335000001e-11,17676941,1329688,3431906360
2122500,3521300261,81727695,1.1033238825000001e-11,17878430,1328312,3433234672
2123000,7233895571,81373177,1.0985378894999999e-11,18263766,1328312,3434562984
2123500,11517580938,81885527,1.1054546145e-11,18245046,1327804,3435890788
2124000,6639066943,81847680,1.10494368e-11,18205777,1329688,3437220476
2124500,2203646899,81375922,1.098574947e-11,18352992,1329288,3438549764
2125000,2143606900,81376568,1.0985836680000002e-11,18373992,1329812,3439879576
2125500,2163492743,81372309,1.0985261715e-11,18235560,1330156,3441209732
2126000,2160914783,81742051,1.1035176885000001e-11,18344391,1329284,3442539016
2126500,2123275626,81368960,1.0984809600000001e-11,18126723,1329672,3443868688
2127000,2122810632,81370562,1.0985025870000001e-11,18178780,1327804,3445196492
2127500,2127398680,81366484,1.0984475340000001e-11,18046243,1329180,3446525672
2128000,2121408272,81358433,1.0983388455e-11,17784590,1328812,3447854484
2128500,2116785920,81722594,1.103255019e-11,17712619,1329688,3449184172
2129000,2116231054,81360652,1.0983688020000001e-11,17856714,1328312,3450512484
2129500,2372588223,81372467,1.0985283045000002e-11,18240692,1328312,3451840796
2130000,2441500562,81376153,1.0985780655000001e-11,18360492,1328812,3453169608
2130500,2255281791,81745802,1.103568327e-11,18466904,1330648,3454500256
2131000,2225916474,81369882,1.0984934070000001e-11,18156671,1328276,3455828532
2131500,2264264880,81373809,1.0985464214999999e-11,18284313,1329180,3457157712
2132000,2230675303,81372832,1.098533232e-11,18252556,1328288,3458486000
2132500,2375838530,81740159,1.1034921465e-11,18283499,1328768,3459814768
2133000,2641992030,81373752,1.0985456520000001e-11,18282448,1327804,3461142572
2133500,2256381815,81377839,1.0986008265e-11,18415294,1328796,3462471368
2134000,2244325737,81384771,1.0986944085000001e-11,18640584,1329564,3463800932
2134500,6697825836,81735994,1.1034359190000001e-11,18148138,1328312,3465129244
2135000,8934922589,81374035,1.0985494725e-11,18291646,1328312,3466457556
2135500,11791474898,81892501,1.1055487635000002e-11,18471690,1329288,3467786844
2136000,2133972282,81835200,1.1047752e-11,17800164,1327784,3469114628
2136500,2125112502,81356554,1.0983134790000001e-11,17723522,1329652,3470444280
2137000,2143392451,81373428,1.098541278e-11,18271912,1329284,3471773564
2137500,2129999465,81740582,1.103497857e-11,18297228,1329304,3473102868
2138000,2127168226,81373681,1.0985446935e-11,18280159,1328688,3474431556
2138500,2135132339,81371654,1.098517329e-11,18213653,1328768,3475760324
2139000,2214887372,81373153,1.0985375655e-11,18262978,1328812,3477089136
2139500,2141040052,81374946,1.098561771e-11,18321270,1328304,3478417440
2140000,2122763933,81738267,1.1034666045e-11,18221997,1329188,3479746628
2140500,2131713023,81376331,1.0985804685e-11,18366276,1328784,3481075412
2141000,2144380211,81375290,1.098566415e-11,18332447,1328784,3482404196
2141500,2150371167,81367603,1.0984626405000002e-11,18082623,1329500,3483733696
2142000,2323527123,81725468,1.103293818e-11,17806034,1329312,3485063008
2142500,2381700950,81358693,1.0983423555e-11,17793034,1328812,3486391820
2143000,500231410,81361352,1.098378252e-11,17879454,1328812,3487720632
2143500,2233305231,81361204,1.098376254e-11,17874667,1330144,3489050776
2144000,9031099519,84795637,1.1447410995000002e-11,17777260,1331908,3490382684
2144500,8919188563,95963430,1.295506305e-11,22452300,1329312,3491711996
2145000,9056229555,95996883,1.2959579205e-11,22339099,1328312,3493040308
2145500,8996456303,95925447,1.2949935345000001e-11,22558880,1328304,3494368612
2146000,9109615499,95561133,1.2900752955e-11,22465550,1328776,3495697388
2146500,11310241699,96255490,1.299449115e-11,22334132,1329160,3497026548
2147000,3381590441,95563580,1.29010833e-11,22612814,1327812,3498354360
2147500,3359304649,95568488,1.290174588e-11,22852611,1329312,3499683672
2148000,3330073489,95930623,1.2950634105e-11,22663034,1327804,3501011476
2148500,3356680697,95562817,1.2900980295000001e-11,22683379,1329680,3502341156
2149000,3383234722,95937617,1.2951578295e-11,22905444,1328812,3503669968
2149500,2111762635,95570202,1.290197727e-11,22799523,1329312,3504999280
2150000,2128006846,95574263,1.2902525505000001e-11,22951464,1329644,3506328924
2150500,2172720850,95569484,1.2901880340000002e-11,22836307,1328812,3507657736
2151000,2112197604,95603931,1.2906530685e-11,22973269,1328776,3508986512
2151500,3351605360,95939294,1.295180469e-11,22922333,1328776,3510315288
2152000,2107174072,95569051,1.2901821885000001e-11,22825369,1328768,3511644056
2152500,2095116507,95563855,1.2901120425e-11,22588522,1328652,3512972708
2153000,2099987601,88288262,1.191891537e-11,22404143,37227768,3550200476
2153500,2094068648,88141565,1.1899111275e-11,21315507,39653608,3589854084
2154000,2093355376,87740667,1.1844990045000001e-11,21173393,39657504,3629511588
2154500,2088339045,87780504,1.1850368040000001e-11,21395981,39654124,3669165712
2155000,2088768567,87772105,1.1849234175000001e-11,21784642,39653252,3708818964
2155500,2086945826,87828678,1.1856871530000001e-11,21917137,39653708,3748472672
2156000,2083897570,87794412,1.1852245620000001e-11,21761477,39651456,3788124128
2156500,2063304693,89003326,1.2015449010000002e-11,21704918,32224208,3820348336
2157000,3299164992,93612439,1.2637679265e-11,20887244,1328796,3821677132
2157500,3338712585,93922751,1.2679571385e-11,20933933,1329784,3823006916
2158000,2083310993,93359010,1.2603466350000001e-11,20925655,1329280,3824336196
2158500,3305773656,94094283,1.2702728205e-11,20911755,1328768,3825664964
2159000,6707590255,93690344,1.2648196440000001e-11,20952270,1328812,3826993776
2159500,6637996440,93316798,1.259776773e-11,20967124,1329784,3828323560
2160000,8744634712,94011024,1.2691488240000002e-11,20935735,1329284,3829652844
2160500,11350777558,93924410,1.2679795350000002e-11,21001275,1328280,3830981124
2161000,8747520645,94122779,1.2706575165e-11,20688743,1330152,3832311276
2161500,4841941722,93675928,1.264625028e-11,20557438,1327812,3833639088
2162000,3357127193,93311268,1.259702118e-11,20993714,1328780,3834967868
2162500,3366486050,93317430,1.259785305e-11,21070102,1330304,3836298172
2163000,2103340677,93693996,1.264868946e-11,21115200,1328812,3837626984
2163500,3339945750,93411642,1.261057167e-11,20976194,1329156,3838956140
2164000,3328525884,93570887,1.2632069745e-11,21051327,1329312,3840285452
2164500,2091767519,93394941,1.2608317035e-11,20902828,1328284,3841613736
2165000,2087311247,93308258,1.259661483e-11,20835854,1328304,3842942040
2165500,2082480881,83375836,1.125573786e-11,21125559,-663374864,3179567176
2166000,2065622850,81371094,1.098509769e-11,18196060,1328312,3180895488
2166500,2063838114,81371624,1.0985169240000001e-11,18213288,1328312,3182223800
2167000,2083411298,81739628,1.103484978e-11,18266228,1328312,3183552112
2167500,2086335867,81374169,1.0985512815e-11,18296025,1329152,3184881264
2168000,2085621127,81371644,1.098517194e-11,18213967,1328276,3186209540
2168500,2078837817,81363087,1.0984016745e-11,17935857,1328660,3187538200
2169000,2077673966,81364148,1.098415998e-11,17970330,1328812,3188867012
2169500,2072878943,81374361,1.0985538735000001e-11,18302244,1328312,3190195324
2170000,2213100879,81375882,1.098574407e-11,18351672,1327812,3191523136
2170500,2098807529,81362626,1.0983954510000002e-11,17920870,1329660,3192852796
2171000,2115860918,81362934,1.098399609e-11,17930870,1328312,3194181108
2171500,2101724976,81741421,1.1035091835e-11,18324512,1328788,3195509896
2172000,2144401713,81376202,1.098578727e-11,18362081,1329180,3196839076
2172500,2244230453,81372437,1.0985278995000001e-11,18239722,1328812,3198167888
2173000,2166190795,81373850,1.098546975e-11,18285644,1327804,3199495692
2173500,3483848382,81375388,1.098567738e-11,18335638,1328312,3200824004
2174000,6737340089,81776076,1.1039770260000001e-11,18260071,1328688,3202152692
2174500,18137882744,82289690,1.110910815e-11,18282420,1327812,3203480504
2175000,2105986804,81377045,1.0985901075e-11,18389470,1328804,3204809308
2175500,2094734789,81364472,1.098420372e-11,17980839,1330680,3206139988
2176000,2102939572,81359387,1.0983517245e-11,17815597,1327784,3207467772
2176500,2094389691,81354988,1.0982923380000002e-11,17672628,1329296,3208797068
2177000,2088921784,81722023,1.1032473105e-11,17694097,1328180,3210125248
2177500,2086835392,81371044,1.098509094e-11,18194460,1328304,3211453552
2178000,2092079378,81371864,1.098520164e-11,18220864,1328804,3212782356
2178500,2087027951,81371364,1.098513414e-11,18204862,1329152,3214111508
2179000,2200130636,81736763,1.1034463005e-11,18173132,1328304,3215439812
2179500,2202802941,81371468,1.098514818e-11,18208208,1328304,3216768116
2180000,2106995477,81371034,1.0985089590000002e-11,18194120,1328796,3218096912
2180500,2121290362,81375034,1.098562959e-11,18324120,1328312,3219425224
2181000,2161046022,81371396,1.098513846e-11,18205873,1327768,3220752992
2181500,2454332880,81373475,1.0985419125e-11,18273462,1329276,3222082268
2182000,2150596256,81370464,1.0985012640000001e-11,18175592,1327804,3223410072
2182500,2229759602,81373884,1.098547434e-11,18286751,1328784,3224738856
2183000,6743818925,81733649,1.1034042615000002e-11,18071931,1330144,3226069000
2183500,8756291658,81354192,1.098281592e-11,17646754,1328784,3227397784
2184000,11301434520,82241081,1.1102545935e-11,17893346,1328276,3228726060
2184500,2113474490,81370408,1.0985005080000002e-11,18173784,1328776,3230054836
2185000,2100522712,81375109,1.0985639715e-11,18326564,1329784,3231384620
2185500,2104392074,81377769,1.0985998814999999e-11,18413010,1328784,3232713404
2186000,2092334305,81375241,1.0985657535000002e-11,18330864,1327776,3234041180
2186500,2092005332,81738550,1.1034704250000001e-11,18231214,1328276,3235369456
2187000,2091998619,81377062,1.0985903370000002e-11,18390044,1328796,3236698252
2187500,2087941971,81374165,1.0985512275e-11,18295884,1328276,3238026528
2188000,2086910495,81375681,1.0985716935e-11,18345142,1329784,3239356312
2188500,2156212820,81372964,1.0985350140000002e-11,18256864,1328312,3240684624
2189000,2101659925,81739518,1.103483493e-11,18262673,1327784,3242012408
2189500,2118821888,81375956,1.098575406e-11,18354074,1329812,3243342220
2190000,2126058367,81374462,1.0985552370000001e-11,18305528,1328788,3244671008
2190500,2133999336,81379074,1.098617499e-11,18455165,1330284,3246001292
2191000,2158321074,81738732,1.1034728820000002e-11,18237112,1328304,3247329596
2191500,2115039898,81366070,1.098441945e-11,18032788,1328156,3248657752
2192000,2141635029,81356299,1.0983100365e-11,17715240,1327804,3249985556
2192500,4847686155,81360157,1.0983621195e-11,17840608,1328276,3251313832
2193000,6750759662,81799371,1.1042915085000001e-11,17826423,1328784,3252642616
2193500,14301478930,82061795,1.1078342325e-11,18020154,1327804,3253970420
2194000,2165459738,81376151,1.0985780385000002e-11,18360428,1329304,3255299724
2194500,2094900941,81373844,1.098546894e-11,18285444,1328312,3256628036
2195000,2096760885,81375368,1.098567468e-11,18334982,1328812,3257956848
2195500,2085764418,81376198,1.098578673e-11,18361952,1328312,3259285160
2196000,2086011769,81736616,1.103444316e-11,18168340,1328284,3260613444
2196500,2087279253,81369369,1.0984864815e-11,18140007,1328772,3261942216
2197000,2086423138,81370119,1.0984966065e-11,18164390,1327812,3263270028
2197500,2086799995,81371538,1.098515763e-11,18210502,1328660,3264598688
2198000,2087440427,81737710,1.103459085e-11,18203906,1328304,3265926992
2198500,2078342807,81369202,1.098484227e-11,18134588,1327776,3267254768
2199000,2083630474,81369968,1.098494568e-11,18159486,1328312,3268583080
2199500,2081469204,81363538,1.0984077630000001e-11,17950508,1329152,3269912232
2200000,2118122633,81354434,1.0982848589999999e-11,17654610,1328276,3271240508
2200500,2074342848,81722755,1.1032571925e-11,17717856,1327812,3272568320
2201000,2094083342,81360664,1.0983689640000001e-11,17857095,1328780,3273897100
2201500,2101907620,81359815,1.0983575025e-11,17829514,1328804,3275225904
2202000,2191746964,81360083,1.0983611205000001e-11,17838201,1329280,3276555184
2202500,2123138398,81725434,1.103293359e-11,17804918,1328304,3277883488
2203000,2085109701,81361017,1.0983737295000001e-11,17868266,1329660,3279213148
2203500,2116902202,81358858,1.098344583e-11,17798414,1328312,3280541460
2204000,2254390110,81357423,1.0983252105e-11,17751761,1328276,3281869736
2204500,2515061910,81726088,1.1033021880000002e-11,17826197,1329276,3283199012
2205000,3589856799,81358358,1.098337833e-11,17782164,1329312,3284528324
2205500,6657762663,81359620,1.09835487e-11,17823176,1327812,3285856136
2206000,18199628602,82308759,1.1111682465e-11,17711470,1328312,3287184448
2206500,2119863473,81369284,1.0984853340000001e-11,18137266,1328812,3288513260
2207000,2109715443,81376192,1.098578592e-11,18361777,1329672,3289842932
2207500,2089140752,81375418,1.0985681430000001e-11,18336594,1328796,3291171728
2208000,2085853965,81742199,1.1035196865e-11,18349804,1328304,3292500032
2208500,2084754853,81374960,1.0985619600000002e-11,18321730,1328812,3293828844
2209000,2085045506,81374137,1.0985508495000001e-11,18294977,1329680,3295158524
2209500,2082060985,81371940,1.0985211900000001e-11,18223582,1327804,3296486328
2210000,2087687414,81374421,1.0985546835000001e-11,18304196,1328812,3297815140
2210500,2251295213,81377724,1.0985992740000001e-11,18411556,1328796,3299143936
2211000,2122353657,81374512,1.098555912e-11,18307138,1327804,3300471740
2211500,2253561502,81375772,1.098572922e-11,18348125,1329784,3301801524
2212000,2141817885,81373920,1.09854792e-11,18287923,1328784,3303130308
2212500,2152585649,81735632,1.1034310320000001e-11,18136363,1329160,3304459468
2213000,2121714498,81357328,1.098323928e-11,17748679,1328780,3305788248
2213500,2113668520,81354507,1.0982858445e-11,17656996,1327768,3307116016
2214000,2194474140,81363133,1.0984022955000001e-11,17937356,1328776,3308444792
2214500,5021279041,81373793,1.0985462055000001e-11,18283779,1329252,3309774044
2215000,8729010888,81802221,1.1043299835000002e-11,17919030,1328312,3311102356
2215500,3353238439,81817116,1.104531066e-11,18402826,1329284,3312431640
2216000,2111948886,81374329,1.0985534415e-11,18301207,1328776,3313760416
2216500,2111231654,81376096,1.098577296e-11,18358619,1329280,3315089696
2217000,2109518961,81371174,1.0985108490000001e-11,18198659,1327284,3316416980
2217500,2101413952,81372992,1.0985353920000001e-11,18257755,1328784,3317745764
2218000,2096709212,81741476,1.103509926e-11,18326298,1329284,3319075048
2218500,2104753863,81374183,1.0985514705000001e-11,18296457,1328784,3320403832
2219000,2089858697,81374582,1.098556857e-11,18309427,1328284,3321732116
2219500,2091926801,81372459,1.0985281965e-11,18240437,1328784,3323060900
2220000,2203030206,81740452,1.1034961020000002e-11,18293013,1328772,3324389672
2220500,2151138778,81376195,1.0985786325e-11,18361848,1328284,3325717956
2221000,2130212344,81364578,1.0984218030000001e-11,17984288,1330028,3327047984
2221500,2158446559,81355157,1.0982946195e-11,17678136,1328788,3328376772
2222000,2123714167,81724823,1.1032851105e-11,17785072,1328312,3329705084
2222500,2142824304,81357116,1.098321066e-11,17741794,1327804,3331032888
2223000,2270183288,81371260,1.09851201e-11,18201451,1329180,3332362068
2223500,2344646709,81370742,1.098505017e-11,18184626,1328296,3333690364
2224000,3511204395,81370016,1.0984952160000001e-11,18161046,1328796,3335019160
2224500,6655932369,81737621,1.1034578835e-11,18201022,1328804,3336347964
2225000,17962144736,82179215,1.1094194024999999e-11,18264148,1327796,3337675760
2225500,2121770012,81375518,1.0985694930000001e-11,18339848,1328304,3339004064
2226000,2097446894,81372692,1.0985313419999999e-11,18247998,1328304,3340332368
2226500,2096015389,81374996,1.0985624460000001e-11,18322878,1328812,3341661180
2227000,2084278512,81743330,1.103534955e-11,18386545,1329688,3342990868
2227500,2090200183,81372263,1.0985255505000002e-11,18234055,1328756,3344319624
2228000,2086587783,81372770,1.0985323950000001e-11,18250201,1328780,3345648404
2228500,2084069039,81373174,1.0985378490000002e-11,18263663,1328680,3346977084
2229000,2162635314,81741978,1.103516703e-11,18342605,1329180,3348306264
2229500,2144278547,81386845,1.0987224075e-11,18707994,1328784,3349635048
2230000,2126515760,81390739,1.0987749765e-11,18834540,1328304,3350963352
2230500,2114792029,81391477,1.0987849395e-11,18858526,1328304,3352291656
2231000,2229246833,81387384,1.0987296840000001e-11,18725486,1328312,3353619968
2231500,2142777173,81754088,1.103680188e-11,18736192,1328312,3354948280
2232000,2236434767,81388593,1.0987460055e-11,18764806,1329144,3356277424
2232500,2129950057,81387547,1.0987318844999999e-11,18730800,1328776,3357606200
2233000,2223157211,81387396,1.0987298460000001e-11,18725896,1328312,3358934512
2233500,6682204910,81755356,1.103697306e-11,18777398,1329648,3360264160
2234000,8899474220,81387229,1.0987275915e-11,18720455,1328280,3361592440
2234500,2138104777,81826974,1.104664149e-11,18723502,1328804,3362921244
2235000,2130204876,81389894,1.098763569e-11,18807080,1331056,3364252300
2235500,2152902481,81380950,1.0986428250000002e-11,18516388,1328804,3365581104
2236000,2112457186,81756353,1.1037107655e-11,18809804,1328784,3366909888
2236500,2111838403,81388968,1.098751068e-11,18776990,1328312,3368238200
2237000,2114313081,81373885,1.0985474475e-11,18286790,1330140,3369568340
2237500,2100032992,81376709,1.0985855715e-11,18378572,1329796,3370898136
2238000,2097741879,81385129,1.0986992414999999e-11,18652198,1327812,3372225948
2238500,2086196945,81756291,1.1037099285000001e-11,18807789,1329688,3373555636
2239000,2090702347,81388143,1.0987399305e-11,18750148,1328304,3374883940
2239500,2087809896,81386413,1.0987165755000001e-11,18693940,1329312,3376213252
2240000,2083172487,81390503,1.0987717905000001e-11,18826867,1329680,3377542932
2240500,2083982133,81760124,1.1037616740000001e-11,18931944,1329776,3378872708
2241000,2096650903,81389878,1.098763353e-11,18806550,1329276,3380201984
2241500,2080351145,81387870,1.098736245e-11,18741287,1328768,3381530752
2242000,2082241931,81383772,1.098680922e-11,18608106,1329660,3382860412
2242500,2235014429,81376082,1.0985771070000002e-11,18358184,1328276,3384188688
2243000,2169979773,81738008,1.103463108e-11,18213599,1328784,3385517472
2243500,2164356950,81371802,1.098519327e-11,18219096,1328812,3386846284
2244000,2122453219,81371503,1.0985152905e-11,18209370,1328784,3388175068
2244500,2209991361,81384844,1.098695394e-11,18642948,1328784,3389503852
2245000,2138742062,81759394,1.103751819e-11,18908646,1328804,3390832656
2245500,2234006352,81392845,1.0988034075e-11,18902968,1328284,3392160940
2246000,2415327966,81386631,1.0987195185e-11,18701036,1328772,3393489712
2246500,2093393922,81388205,1.0987407675000001e-11,18752176,1328312,3394818024
2247000,3342134616,81386987,1.0987243244999999e-11,18712595,1328784,3396146808
2247500,6725176373,81790285,1.1041688475e-11,18721872,1328788,3397475596
2248000,14308281783,81825535,1.1046447225e-11,18676761,1328284,3398803880
2248500,2104702362,81387496,1.0987311960000001e-11,18729140,1328776,3400132656
2249000,2106927236,81386487,1.0987175745000002e-11,18696340,1328276,3401460932
2249500,2096131866,81389060,1.09875231e-11,18779977,1329660,3402790592
2250000,2133981078,81377956,1.0986024060000001e-11,18419105,1329152,3404119744
2250500,2097845858,81723189,1.1032630515e-11,17731958,1329296,3405449040
2251000,2086323202,81359585,1.0983543975e-11,17822031,1328280,3406777320
2251500,2087944622,81370387,1.0985002245e-11,18173080,1327312,3408104632
2252000,2076121358,81371380,1.0985136300000001e-11,18205378,1327804,3409432436
2252500,2115501087,81367593,1.0984625055000001e-11,18082286,1328660,3410761096
2253000,2101526986,81734213,1.1034118755e-11,18089836,1328796,3412089892
2253500,2157696755,81370620,1.09850337e-11,18180672,1328312,3413418204
2254000,2103703431,81373009,1.0985356215e-11,18258327,1330672,3414748876
2254500,2111713949,81366884,1.098452934e-11,18059250,1327784,3416076660
2255000,2111140566,81737689,1.1034588015e-11,18203234,1328812,3417405472
2255500,2235269833,81371212,1.0985113620000002e-11,18199918,1329312,3418734784
2256000,2114297369,81369997,1.0984949595e-11,18160425,1328272,3420063056
2256500,3347260602,81368938,1.098480663e-11,18125996,1328784,3421391840
2257000,8748413247,81772585,1.1039298975e-11,18146610,1328776,3422720616
2257500,14337468706,81989629,1.1068599915000001e-11,18056208,1329152,3424049768
2258000,2099476479,81355096,1.0982937960000001e-11,17676135,1329284,3425379052
2258500,2069438700,81357571,1.0983272085000001e-11,17756570,1329276,3426708328
2259000,2119149156,81354838,1.098290313e-11,17667743,1328272,3428036600
2259500,2109560325,81724549,1.1032814115000002e-11,17776185,1328768,3429365368
2260000,2087595139,81371144,1.0985104439999999e-11,18197698,1327784,3430693152
2260500,2084677353,81376179,1.0985784165000001e-11,18361330,1328804,3432021956
2261000,2099269919,81364549,1.0984214115000001e-11,17983359,1327780,3433349736
2261500,2092018431,81733675,1.1034046125e-11,18072782,1327796,3434677532
2262000,2082065782,81367149,1.0984565115000002e-11,18067861,1327268,3436004800
2262500,2120759659,81372121,1.0985236335000001e-11,18229450,1328784,3437333584
2263000,2118656305,81373669,1.0985445315e-11,18279760,1328296,3438661880
2263500,2142376024,81371458,1.0985146830000001e-11,18207917,1329652,3439991532
2264000,2118542631,81369437,1.0984873995e-11,18142208,1328304,3441319836
2264500,2224100728,81370222,1.098497997e-11,18167724,1328804,3442648640
2265000,2255241011,81374721,1.0985587335e-11,18313949,1328768,3443977408
2265500,3495345393,81389724,1.098761274e-11,18801103,1330188,3445307596
2266000,6743918085,81739144,1.1034784440000001e-11,18250508,1329296,3446636892
2266500,11576686022,81812866,1.104473691e-11,18264994,1327812,3447964704
2267000,2087153918,81372972,1.098535122e-11,18257118,1327812,3449292516
2267500,2130182029,81738411,1.1034685485e-11,18226691,1328680,3450621196
2268000,2131925611,81372300,1.0985260500000001e-11,18235272,1328296,3451949492
2268500,2100911648,81374161,1.0985511735e-11,18295766,1328804,3453278296
2269000,2096848249,81374860,1.0985606099999999e-11,18318460,1328296,3454606592
2269500,2094058788,81376368,1.098580968e-11,18367487,1329680,3455936272
2270000,2091124921,81739577,1.1034842895000002e-11,18264572,1328304,3457264576
2270500,2089642729,81378923,1.0986154604999999e-11,18450512,1328812,3458593388
2271000,2138673793,81371454,1.098514629e-11,18207771,1328284,3459921672
2271500,2132973424,81380216,1.0986329160000001e-11,18492550,1328312,3461249984
2272000,2118477408,81758208,1.103735808e-11,18870106,1329284,3462579268
2272500,2143076040,81389724,1.098761274e-11,18801557,1328284,3463907552
2273000,2098606129,81391943,1.0987912305e-11,18873676,1328804,3465236356
2273500,2108340170,81392147,1.0987939845e-11,18880302,1328284,3466564640
2274000,2128050367,81756164,1.1037082140000001e-11,18803657,1328776,3467893416
2274500,2122213903,81392234,1.0987951590000001e-11,18883122,1328260,3469221676
2275000,2153346679,81391701,1.0987879635000002e-11,18865802,1327776,3470549452
2275500,3381275072,81393163,1.0988077005e-11,18913310,1328304,3471877756
2276000,6627040768,81750223,1.1036280105000001e-11,18610584,1329312,3473207068
2276500,14355805623,82045441,1.1076134535000002e-11,18679394,1328804,3474535872
2277000,2082823425,81387879,1.0987363665e-11,18741574,1326812,3475862684
2277500,2101989796,81389944,1.098764244e-11,18808682,1329796,3477192480
2278000,2102020382,81387969,1.0987375815e-11,18744059,1330536,3478523016
2278500,2091254045,81370283,1.0984988205000001e-11,18169718,1328784,3479851800
2279000,2094195420,81736157,1.1034381195e-11,18153428,1328312,3481180112
2279500,2090684319,81382308,1.098661158e-11,18560528,1328304,3482508416
2280000,2088860061,81376520,1.09858302e-11,18372402,1327812,3483836228
2280500,2089658389,81387862,1.098736137e-11,18741029,1328180,3485164408
2281000,2089168673,81756488,1.103712588e-11,18814200,1328796,3486493204
2281500,2086913772,81387981,1.0987377435000001e-11,18744898,1327812,3487821016
2282000,2083929377,81388414,1.098743589e-11,18758979,1329680,3489150696
2282500,2144717714,84460041,1.1402105535e-11,18778348,1332908,3490483604
2283000,2086464815,95581963,1.2903565005e-11,23193321,1327812,3491811416
2283500,2084785218,95580466,1.2903362910000001e-11,23124740,1327812,3493139228
2284000,6557344125,95585630,1.2904060050000001e-11,23357310,1328188,3494467416
2284500,4926921357,95983753,1.2957806655e-11,23225304,1328304,3495795720
2285000,4935921197,95577076,1.290290526e-11,22954848,1329188,3497124908
2285500,6605647290,95939641,1.2951851535e-11,22838695,1328804,3498453712
2286000,6853071347,95937338,1.2951540630000001e-11,22782742,1327784,3499781496
2286500,6737493425,95573213,1.2902383755e-11,23090041,1327276,3501108772
2287000,3354086558,95586913,1.2904233255000001e-11,23395876,1328268,3502437040
2287500,11255784214,96244865,1.2993056775000001e-11,23437359,1329284,3503766324
2288000,2098817878,95583858,1.290382083e-11,23305118,1328776,3505095100
2288500,2110565903,95587293,1.2904284555e-11,23400179,1328776,3506423876
2289000,2109565022,95950156,1.295327106e-11,23258740,1327780,3507751656
2289500,2104839866,95580648,1.290338748e-11,23286428,1327804,3509079460
2290000,2089769869,95585741,1.2904075035000001e-11,23308477,1328784,3510408244
2290500,2086541295,95613492,1.2907821419999999e-11,23287633,1327776,3511736020
2291000,2084807649,95585281,1.2904012935e-11,23364430,1329296,3513065316
2291500,2087314658,95953301,1.2953695635000001e-11,23338978,1328304,3514393620
2292000,2088407473,89108050,1.2029586750000002e-11,23463456,33298696,3547692316
2292500,2081765461,87802232,1.1853301320000002e-11,22186556,39649552,3587341868
2293000,2086913612,87801089,1.1853147015e-11,22099397,39658808,3627000676
2293500,2088197244,87768420,1.18487367e-11,22032144,39655564,3666656240
2294000,2089268958,88174281,1.1903527934999999e-11,22390739,39655544,3706311784
2294500,2086282776,87810664,1.185443964e-11,22230112,39656252,3745968036
2295000,2080551753,87808025,1.1854083375e-11,22310433,39652680,3785620716
2295500,2135091564,88422707,1.1937065445e-11,22481316,36006380,3821627096
2296000,2087994705,93615662,1.2638114370000001e-11,21571005,1328284,3822955380
2296500,4771857465,94422624,1.2747054240000002e-11,21572071,1328652,3824284032
2297000,4892479958,93416071,1.2611169585000001e-11,21504104,1327796,3825611828
2297500,6613839556,94038104,1.269514404e-11,21338757,1328276,3826940104
2298000,6722301671,93736366,1.265440941e-11,21372298,1328284,3828268388
2298500,7056800444,93330217,1.2599579295e-11,21462739,1328784,3829597172
2299000,8793023472,93787580,1.26613233e-11,21384681,1328312,3830925484
2299500,11256667962,93911777,1.2678089895e-11,21505584,1327812,3832253296
2300000,3340734057,93518021,1.2624932835e-11,21441208,1328304,3833581600
2300500,3328589696,93958287,1.2684368745e-11,21318626,1330156,3834911756
2301000,2095004427,93324618,1.259882343e-11,21032266,1328776,3836240532
2301500,2112963285,93317012,1.259779662e-11,20952342,1329152,3837569684
2302000,2082677312,93305431,1.2596233185000001e-11,20943972,1328304,3838897988
2302500,2085261432,93336770,1.260046395e-11,21491254,1328288,3840226276
2303000,2087881994,93755733,1.2657023955e-11,21542060,1328796,3841555072
2303500,2084723899,93533710,1.262705085e-11,21529290,1330156,3842885228
2304000,2082564096,93359562,1.2603540870000002e-11,21402248,1327812,3844213040
2304500,2085930772,93332683,1.2599912205000001e-11,21498771,1329312,3845542352
2305000,2062288671,85989636,1.160860086e-11,21490136,-663027688,3182514664
2305500,2065990233,81753507,1.1036723445e-11,18717296,1328304,3183842968
2306000,2086930987,81390415,1.0987706025e-11,18823990,1327784,3185170752
2306500,2081499348,81389172,1.098753822e-11,18783613,1329660,3186500412
2307000,2077266097,81381911,1.0986557985e-11,18547609,1330180,3187830592
2307500,2061379475,81737850,1.1034609750000001e-11,18208441,1328272,3189158864
2308000,2067233643,81383792,1.098681192e-11,18608742,1328812,3190487676
2308500,2069192867,81388847,1.0987494345e-11,18773032,1329144,3191816820
2309000,2105820945,81383379,1.0986756165e-11,18595320,1328804,3193145624
2309500,2084213005,81386791,1.0987216785e-11,18706219,1328284,3194473908
2310000,2102994675,81757227,1.1037225645000001e-11,18838206,1328268,3195802176
2310500,2086830262,81393388,1.0988107380000001e-11,18920624,1329304,3197131480
2311000,2106557288,81389744,1.0987615440000001e-11,18802183,1328276,3198459756
2311500,2144503120,81387947,1.0987372845000001e-11,18743802,1327804,3199787560
2312000,2147204418,81753963,1.1036785005e-11,18732117,1329188,3201116748
2312500,2167316554,81386661,1.0987199235000002e-11,18701990,1328312,3202445060
2313000,2241243600,81391235,1.0987816725e-11,18850640,1329296,3203774356
2313500,3465193100,81391485,1.0987850475000001e-11,18858769,1330160,3205104516
2314000,6932880062,81749505,1.1036183175e-11,18587245,1330144,3206434660
2314500,6830789464,81773966,1.103948541e-11,18191506,1328304,3207762964
2315000,2084467593,81383717,1.0986801795000001e-11,18606330,1327796,3209090760
2315500,2084993970,81388903,1.0987501905000001e-11,18774863,1329188,3210419948
2316000,2109451207,81391080,1.09877958e-11,18845632,1328768,3211748716
2316500,2104700126,81386896,1.0987230960000001e-11,18709627,1329688,3213078404
2317000,2103917812,81753363,1.1036704005e-11,18712626,1328312,3214406716
2317500,2095477015,81387455,1.0987306425e-11,18727632,1328304,3215735020
2318000,2095073192,81386903,1.0987231905e-11,18709854,1327812,3217062832
2318500,2091669535,81390417,1.0987706295e-11,18824060,1330148,3218392980
2319000,2149211320,81752983,1.1036652705000001e-11,18700288,1327304,3219720284
2319500,2107771204,81387359,1.0987293465000002e-11,18724693,1328272,3221048556
2320000,2217974944,81391656,1.098787356e-11,18864350,1329804,3222378360
2320500,2158679062,81388636,1.098746586e-11,18766200,1332036,3223710396
2321000,2228077258,81371336,1.098513036e-11,18203951,1328284,3225038680
2321500,2096154810,81374631,1.0985575185000001e-11,18311035,1330172,3226368852
2322000,2121087294,81373301,1.0985395635000001e-11,18267801,1327784,3227696636
2322500,2194757074,81389144,1.0987534440000001e-11,18782688,1329304,3229025940
2323000,2160660511,81390579,1.0987728165e-11,18829336,1328804,3230354744
2323500,2220351463,81755264,1.103696064e-11,18774418,1330152,3231684896
2324000,2135456436,81389023,1.0987518105e-11,18778758,1328812,3233013708
2324500,2194712850,81391075,1.0987795125000002e-11,18845460,1328804,3234342512
2325000,2110714256,81388977,1.0987511895e-11,18777273,1330172,3235672684
2325500,2302655669,81757846,1.103730921e-11,18858316,1329804,3237002488
2326000,2164486345,81390537,1.0987722495000001e-11,18827962,1328276,3238330764
2326500,2231058032,81388616,1.0987463160000001e-11,18765541,1329188,3239659952
2327000,14305813430,82044161,1.1075961735000001e-11,18637785,1330152,3240990104
2327500,2101091502,81371587,1.0985164245000001e-11,18212096,1327796,3242317900
2328000,2092468434,81373025,1.0985358375e-11,18258826,1328804,3243646704
2328500,2092926295,81374439,1.0985549265e-11,18304777,1329160,3244975864
2329000,2090248605,81754869,1.1036907315000001e-11,18761567,1327780,3246303644
2329500,2108656586,81388698,1.0987474229999999e-11,18768190,1328788,3247632432
2330000,2063972972,81389085,1.0987526475e-11,18780584,1326812,3248959244
2330500,2085964513,81391885,1.0987904475000002e-11,18871769,1329652,3250288896
2331000,2085170544,81386394,1.098716319e-11,18693318,1329784,3251618680
2331500,2080593563,81751887,1.1036504745e-11,18664649,1329672,3252948352
2332000,2114164388,81385530,1.098704655e-11,18665255,1327768,3254276120
2332500,2099521323,81387746,1.0987345710000001e-11,18737248,1328772,3255604892
2333000,2102547597,81391135,1.0987803225e-11,18847390,1328312,3256933204
2333500,2111177244,81767838,1.1038658130000001e-11,19183060,1327804,3258261008
2334000,2166761732,81388419,1.0987436565e-11,18759118,1329564,3259590572
2334500,2223270711,81386564,1.098718614e-11,18698832,1328312,3260918884
2335000,2125815016,81388259,1.0987414965e-11,18753936,1328812,3262247696
2335500,2132446328,81762410,1.1037925350000001e-11,19006664,1328296,3263575992
2336000,3521481580,81373871,1.0985472585000002e-11,18286337,1327784,3264903776
2336500,6683219419,81375145,1.0985644575e-11,18327743,1329152,3266232928
2337000,17951980320,82306956,1.111143906e-11,18843591,1328772,3267561700
2337500,2108923283,81391694,1.0987878690000001e-11,18865578,1327776,3268889476
2338000,2103394986,81391952,1.098791352e-11,18873960,1328304,3270217780
2338500,2073772968,81390167,1.0987672545000001e-11,18815929,1328680,3271546460
2339000,2074883945,81754876,1.103690826e-11,18761790,1328804,3272875264
2339500,2114160973,81391980,1.09879173e-11,18874851,1328780,3274204044
2340000,2091856330,81391492,1.098785142e-11,18859026,1328304,3275532348
2340500,2097809635,81393809,1.0988164215000002e-11,18934327,1329144,3276861492
2341000,2234779805,81760461,1.1037662235000001e-11,18943327,1329776,3278191268
2341500,2113962892,81388082,1.098739107e-11,18748197,1330500,3279521768
2342000,2219388004,81375957,1.0985754195e-11,18354110,1328796,3280850564
2342500,2219551100,81375948,1.098575298e-11,18353574,1328812,3282179376
2343000,2109894908,81741905,1.1035157175e-11,18340245,1330180,3283509556
2343500,2129231369,81374464,1.0985552640000001e-11,18305602,1328312,3284837868
2344000,2145881660,81376295,1.0985799825e-11,18365090,1329304,3286167172
2344500,2227797231,81377912,1.098601812e-11,18417669,1330680,3287497852
2345000,2217252193,81373518,1.0985424930000002e-11,18274862,1327812,3288825664
2345500,4852077162,81780154,1.104032079e-11,18392606,1330312,3290155976
2346000,8785577189,81372908,1.098534258e-11,18255047,1329268,3291485244
2346500,11232849698,82212692,1.109871342e-11,18161417,1329688,3292814932
2347000,2074907378,81384079,1.0986850665e-11,18618096,1327284,3294142216
2347500,2091881595,81387422,1.0987301970000002e-11,18726728,1328812,3295471028
2348000,2100224897,81385868,1.098709218e-11,18676210,1328312,3296799340
2348500,2067029857,81382926,1.098669501e-11,18580614,1329152,3298128492
2349000,2081764049,81752229,1.1036550915e-11,18675778,1328804,3299457296
2349500,2082916356,81387787,1.0987351245e-11,18738600,1328796,3300786092
2350000,2079222844,81390499,1.0987717365e-11,18826746,1330660,3302116752
2350500,2078941803,81389544,1.098758844e-11,18795703,1329276,3303446028
2351000,2104239651,81388515,1.0987449525000001e-11,18762243,1327784,3304773812
2351500,2097139850,81385972,1.098710622e-11,18679603,1329644,3306103456
2352000,2077539340,81378848,1.0986144480000002e-11,18448084,1331056,3307434512
2352500,2114654012,81355100,1.09829385e-11,17676284,1328804,3308763316
2353000,2199463627,81354003,1.0982790405e-11,17640607,1328680,3310091996
2353500,2188557868,81721137,1.1032353495000001e-11,17665294,1328312,3311420308
2354000,2197938823,81365998,1.098440973e-11,18030444,1328812,3312749120
2354500,2155654901,81370970,1.098508095e-11,18192041,1330144,3314079264
2355000,2115686784,81369971,1.0984946085e-11,18159273,1327764,3315407028
2355500,6632093175,81736808,1.1034469080000002e-11,18174590,1327812,3316734840
2356000,8733183014,81372356,1.098526806e-11,18237102,1328776,3318063616
2356500,8716450478,82174975,1.1093621625e-11,18126357,1328672,3319392288
2357000,2129214592,81369103,1.0984828905000001e-11,18131366,1328812,3320721100
2357500,2097717469,81370002,1.0984950270000001e-11,18160570,1328312,3322049412
2358000,2091834000,81370276,1.098498726e-11,18169495,1329688,3323379100
2358500,2086524071,81368190,1.0984705650000001e-11,18101685,1330188,3324709288
2359000,2088854558,81719823,1.1032176105e-11,17622576,1328812,3326038100
2359500,2083011789,81354212,1.0982818620000002e-11,17647420,1327804,3327365904
2360000,2085570330,81356328,1.098310428e-11,17716185,1330672,3328696576
2360500,2081791525,81377348,1.098594198e-11,18399318,1328804,3330025380
2361000,2082686787,81371490,1.0985151150000001e-11,18208945,1327784,3331353164
2361500,2090410026,81736663,1.1034449505000001e-11,18169874,1329160,3332682324
2362000,2092702976,81369124,1.098483174e-11,18132036,1328804,3334011128
2362500,2073041471,81372053,1.0985227155000001e-11,18227246,1327796,3335338924
2363000,2076150194,81371377,1.0985135895e-11,18205280,1328312,3336667236
2363500,2078877832,81738886,1.103474961e-11,18242108,1329660,3337996896
2364000,2083117863,81371895,1.0985205825e-11,18222109,1328268,3339325164
2364500,2081249865,81373668,1.0985445179999999e-11,18279714,1329312,3340654476
2365000,2073941248,81370360,1.09849986e-11,18172220,1329556,3341984032
2365500,2166747665,81359459,1.0983526965e-11,17817918,1328284,3343312316
2366000,2083386676,81743395,1.1035358325000001e-11,18388654,1328260,3344640576
2366500,2118484140,81375366,1.0985674410000001e-11,18334905,1330160,3345970736
2367000,2101947619,81369747,1.0984915845e-11,18152292,1327296,3347298032
2367500,2109188575,81375147,1.0985644845e-11,18327488,1329796,3348627828
2368000,2111330537,81741577,1.1035112895e-11,18329596,1328804,3349956632
2368500,2196555943,81374676,1.098558126e-11,18312479,1330188,3351286820
2369000,2238881819,81373638,1.098544113e-11,18278760,1328304,3352615124
2369500,4889314700,81373645,1.0985442075e-11,18278976,1327804,3353942928
2370000,17980048420,82326346,1.1114056710000001e-11,18283039,1329688,3355272616
2370500,2094642402,81372738,1.098531963e-11,18249500,1327804,3356600420
2371000,2088396767,81378138,1.0986048630000001e-11,18425000,1328776,3357929196
2371500,2090557904,81368152,1.098470052e-11,18100438,1330048,3359259244
2372000,2086798097,81727971,1.1033276085000001e-11,17887396,1327804,3360587048
2372500,2090343433,81374144,1.098550944e-11,18295194,1329312,3361916360
2373000,2156456239,81373743,1.0985455304999999e-11,18282155,1330144,3363246504
2373500,2073762321,81356252,1.098309402e-11,17713722,1327812,3364574316
2374000,2093651744,81364257,1.0984174695e-11,17973878,1329312,3365903628
2374500,2071511973,81740476,1.103496426e-11,18293794,1327804,3367231432
2375000,2108619759,81375964,1.0985755140000001e-11,18354329,1330644,3368562076
2375500,2120533973,81377176,1.098591876e-11,18393752,1327304,3369889380
2376000,2112101265,81375661,1.0985714235000002e-11,18344492,1328276,3371217656
2376500,2250498967,81738271,1.1034666585000001e-11,18222129,1329688,3372547344
2377000,2383949877,81373251,1.0985388885e-11,18266170,1328312,3373875656
2377500,2114786254,81372355,1.0985267925e-11,18237042,1329804,3375205460
2378000,2184403109,81375344,1.0985671440000002e-11,18334215,1331024,3376536484
2378500,2227019248,81747514,1.103591439e-11,18522520,1328804,3377865288
2379000,5026887737,81376693,1.0985853555e-11,18378032,1327812,3379193100
2379500,8968262393,81775556,1.1039700060000001e-11,18243177,1329680,3380522780
2380000,22651703728,82326077,1.1114020395000002e-11,18273982,1327288,3381850068
2380500,2162196197,81388791,1.0987486785000001e-11,18771235,1327920,3383177988
2381000,2160236575,81391414,1.098784089e-11,18856486,1328284,3384506272
2381500,2160402066,81384253,1.0986874155e-11,18623752,1328304,3385834576
2382000,2161115606,81750841,1.1036363535e-11,18630677,1329180,3387163756
2382500,2169192510,81385340,1.09870209e-11,18659050,1327796,3388491552
2383000,2133016754,81386680,1.0987201800000001e-11,18702628,1327804,3389819356
2383500,2133661570,81387596,1.0987325460000001e-11,18732393,1329660,3391149016
2384000,2217446454,81753986,1.103678811e-11,18732862,1328304,3392477320
2384500,2711123644,81387941,1.0987372035000001e-11,18743608,1328312,3393805632
2385000,2728374295,81384913,1.0986963255000002e-11,18645186,1328296,3395133928
2385500,3191073017,81756637,1.1037145995000002e-11,18819032,1329160,3396463088
2386000,2505661089,81374798,1.098559773e-11,18316467,1327776,3397790864
2386500,2791613765,81383419,1.0986761565e-11,18596636,1328304,3399119168
2387000,3002220519,81388497,1.0987447095e-11,18761685,1328688,3400447856
2387500,2377143521,81389588,1.098759438e-11,18797132,1328804,3401776660
2388000,3329628092,81754241,1.1036822535e-11,18741150,1328804,3403105464
2388500,2590379746,81390669,1.0987740315e-11,18832251,1330188,3404435652
2389000,2530566104,81388243,1.0987412805e-11,18753414,1327804,3405763456
2389500,2636599221,81753471,1.1036718585000001e-11,18716144,1328296,3407091752
2390000,3432715467,81388656,1.0987468560000001e-11,18766843,1329172,3408420924
2390500,3776655538,81759836,1.103757786e-11,18923000,1329284,3409750208
2391000,2452049751,81390920,1.09877742e-11,18840406,1328768,3411078976
2391500,7032891926,81386556,1.098718506e-11,18698568,1329652,3412408628
2392000,7716576872,81785714,1.1041071390000001e-11,18573299,1328688,3413737316
2392500,10416833813,81919843,1.1059178805e-11,18169216,1327796,3415065112
2393000,15661416402,81934352,1.106113752e-11,18641171,1329188,3416394300
2393500,19056047640,82339459,1.1115826965000002e-11,18709190,1328812,3417723112
2394000,2141937423,81389270,1.098755145e-11,18786784,1328804,3419051916
2394500,2131911960,81391553,1.0987859655000001e-11,18860990,1328288,3420380204
2395000,2126084886,81389714,1.098761139e-11,18801217,1330152,3421710356
2395500,2128093195,81759893,1.1037585555000002e-11,18924838,1328796,3423039152
2396000,2130518648,81390503,1.0987717905000001e-11,18826857,1329276,3424368428
2396500,2120789757,81383947,1.0986832845e-11,18613791,1329160,3425697588
2397000,2131465603,81383672,1.098679572e-11,18604861,1328780,3427026368
2397500,2084771917,81750627,1.1036334645e-11,18623706,1328312,3428354680
2398000,2138066068,81384440,1.0986899400000001e-11,18629821,1329672,3429684352
2398500,2316639614,81383376,1.098675576e-11,18595237,1329188,3431013540
2399000,2170768944,81369238,1.0984847130000001e-11,18135746,1328812,3432342352
2399500,2185969208,81747012,1.1035846619999999e-11,18506232,1328804,3433671156
2400000,2486180150,81387767,1.0987348545e-11,18737947,1330180,3435001336
2400500,2244752300,81395456,1.0988386560000001e-11,18987838,1328796,3436330132
2401000,2282521362,81387507,1.0987313445e-11,18729482,1328812,3437658944
2401500,2317728827,81752941,1.1036647035e-11,18698920,1328312,3438987256
2402000,2330546530,81387456,1.0987306560000001e-11,18727828,1328804,3440316060
2402500,2212928554,81388302,1.098742077e-11,18755333,1329276,3441645336
2403000,2729231320,81387737,1.0987344495000001e-11,18736986,1328796,3442974132
2403500,2352896524,81752046,1.103652621e-11,18669826,1327796,3444301928
2404000,2528048470,81387999,1.0987379865e-11,18745480,1328768,3445630696
2404500,2280628652,81388360,1.0987428600000001e-11,18757218,1329284,3446959980
2405000,2236760212,81389216,1.0987544160000001e-11,18784604,1328312,3448288292
2405500,3546197587,81755341,1.1036971035000001e-11,18776910,1328776,3449617068
2406000,6796770291,81380533,1.0986371955000002e-11,18502834,1327284,3450944352
2406500,6864884379,81971041,1.1066090535000001e-11,18642803,1329688,3452274040
2407000,2124251645,81373706,1.098545031e-11,18280974,1328312,3453602352
2407500,2141095369,81373875,1.0985473125000002e-11,18286464,1328812,3454931164
2408000,2151858323,81374050,1.0985496750000002e-11,18292135,1330160,3456261324
2408500,2163315511,81372080,1.09852308e-11,18228108,1328804,3457590128
2409000,2124332885,81739329,1.1034809415000002e-11,18256534,1328812,3458918940
2409500,2122448505,81372731,1.0985318685e-11,18249272,1327812,3460246752
2410000,2123813837,81373116,1.098537066e-11,18261777,1329672,3461576424
2410500,2114357733,81376603,1.0985841405e-11,18375126,1328812,3462905236
2411000,2130136890,81755548,1.1036998980000002e-11,18783646,1329812,3464235048
2411500,2453955739,81388609,1.0987462215e-11,18765310,1327812,3465562860
2412000,2503214948,81387027,1.0987248645e-11,18713882,1329656,3466892516
2412500,554573717,81387379,1.0987296165e-11,18725336,1328784,3468221300
2413000,2402514228,81753443,1.1036714805000002e-11,18715232,1328804,3469550104
2413500,2154122442,81389546,1.098758871e-11,18795750,1329312,3470879416
2414000,2337149077,81383440,1.0986764400000002e-11,18597317,1330036,3472209452
2414500,2418425196,81371834,1.0985197590000001e-11,18220120,1328312,3473537764
2415000,2245357270,81738534,1.103470209e-11,18230674,1328312,3474866076
2415500,2208373674,81392355,1.0987967925e-11,18887046,1330160,3476196236
2416000,2239207723,81388986,1.098751311e-11,18777568,1329276,3477525512
2416500,3383053369,81387135,1.0987263225e-11,18717404,1328812,3478854324
2417000,6763524768,81827559,1.1046720465e-11,18742515,1329688,3480184012
2417500,11357572804,81388955,1.0987508925e-11,18776112,1329296,3481513308
2418000,17976199768,82524028,1.1140743780000002e-11,18754112,1328312,3482841620
2418500,2133602476,81388056,1.0987387560000001e-11,18747335,1330180,3484171800
2419000,2145219802,81387610,1.0987327350000002e-11,18732829,1328772,3485500572
2419500,2122330966,81388762,1.0987482870000001e-11,18770278,1328804,3486829376
2420000,2123533815,81757100,1.1037208499999999e-11,18834093,1330528,3488159904
2420500,2123765764,81373506,1.098542331e-11,18274448,1328296,3489488200
2421000,2123975328,84450207,1.1400777945000001e-11,18458797,1332888,3490821088
2421500,2119968655,95589138,1.2904533630000001e-11,23406154,1328776,3492149864
2422000,2126418033,95587429,1.2904302914999999e-11,23304965,1329276,3493479140
2422500,3361439714,95580099,1.2903313365000001e-11,23324936,1328284,3494807424
2423000,3371379318,95584029,1.2903843914999999e-11,23318303,1327812,3496135236
2423500,2118942136,95583515,1.2903774525e-11,23302707,1328776,3497464012
2424000,8841986617,95949930,1.2953240550000001e-11,23200215,1327280,3498791292
2424500,6643864733,95955468,1.2953988180000002e-11,23385571,1328284,3500119576
2425000,8826656978,96029978,1.296404703e-11,23379449,1328284,3501447860
2425500,8854964945,95955206,1.295395281e-11,23532468,1329268,3502777128
2426000,9317968111,95948958,1.2953109330000002e-11,23249440,1328280,3504105408
2426500,8946090325,95582931,1.2903695685000002e-11,23348124,1329284,3505434692
2427000,3542983113,95950420,1.29533067e-11,23346167,1328764,3506763456
2427500,11319126408,95987998,1.295837973e-11,23299778,1329296,3508092752
2428000,2128282486,95589850,1.290462975e-11,23410474,1329276,3509422028
2428500,2095589887,95574193,1.2902516055e-11,23006910,1329644,3510751672
2429000,2094659596,95565401,1.2901329135e-11,22662734,1328288,3512079960
2429500,2121220430,95934066,1.2951098910000002e-11,22794110,1327788,3513407748
2430000,2119386528,95601760,1.29062376e-11,22906587,1329284,3514737032
2430500,2120385980,95575454,1.290268629e-11,23035550,1327788,3516064820
2431000,2124307150,89887932,1.2134870820000001e-11,23259933,29354128,3545418948
2431500,2141391253,87804331,1.1853584685000002e-11,22335814,39658976,3585077924
2432000,2115479607,87810699,1.1854444365000001e-11,22418085,39650252,3624728176
2432500,2119535501,87808491,1.1854146285000001e-11,22368792,39655964,3664384140
2433000,2177780176,87773352,1.184940252e-11,22201926,39657696,3704041836
2433500,2117587906,87804639,1.1853626265e-11,22254840,39649280,3743691116
2434000,2116773259,88171723,1.1903182605000002e-11,22133901,39657008,3783348124
2434500,2117341773,87803066,1.185341391e-11,22185854,39651444,3822999568
2435000,3353258857,93589527,1.2634586145e-11,22321916,1623616,3824623184
2435500,3354302358,94471536,1.2753657360000002e-11,21543574,1328780,3825951964
2436000,3395403126,93398099,1.2608743365000002e-11,21568498,1327812,3827279776
2436500,3375717760,93526492,1.262607642e-11,21677017,1329688,3828609464
2437000,3342027386,93760970,1.2657730950000002e-11,21484040,1329660,3829939124
2437500,3342119030,93332796,1.2599927460000002e-11,21376991,1328776,3831267900
2438000,2100232184,93331217,1.2599714295e-11,21506284,1328812,3832596712
2438500,3393083034,93361769,1.2603838815000001e-11,21388392,1327812,3833924524
2439000,2088895142,93703393,1.2649958055000001e-11,21529263,1328312,3835252836
2439500,3333417969,93550946,1.262937771e-11,21427464,1330188,3836583024
2440000,3360143714,93473621,1.2618938835e-11,21502535,1329312,3837912336
2440500,8811306417,93696914,1.264908339e-11,21600065,1327804,3839240140
2441000,8877670383,93720022,1.265220297e-11,20814569,1327776,3840567916
2441500,8842282404,93751619,1.2656468565000001e-11,20872424,1329304,3841897220
2442000,11363279781,93697106,1.2649109310000002e-11,21318411,1328672,3843225892
2442500,11457793715,93781589,1.2660514515e-11,21382670,1328812,3844554704
2443000,4984068234,93506782,1.262341557e-11,21367613,1327312,3845882016
2443500,8779192705,93920222,1.2679229970000001e-11,21474126,1328304,3847210320
2444000,3385385226,93334923,1.2600214605e-11,21417003,1329180,3848539500
2444500,2258788607,88603535,1.1961477225000002e-11,21296750,-663031456,3185508044
2445000,2131380801,81753161,1.1036676735000001e-11,18706050,1329804,3186837848
2445500,2124414144,81389648,1.098760248e-11,18799073,1329660,3188167508
2446000,2129700221,81384967,1.0986970545e-11,18646935,1328784,3189496292
2446500,2123404953,81385042,1.098698067e-11,18649388,1327804,3190824096
2447000,2122076090,81750033,1.1036254455e-11,18604403,1328284,3192152380
2447500,2114136153,81381448,1.098649548e-11,18532575,1329688,3193482068
2448000,2117113642,81370613,1.0985032755e-11,18180429,1328784,3194810852
2448500,2120615416,81367698,1.098463923e-11,18085716,1328812,3196139664
2449000,2141274202,81376791,1.0985866785e-11,18381234,1328776,3197468440
2449500,2130056841,81746028,1.103571378e-11,18474229,1327772,3198796212
2450000,2113430025,81377193,1.0985921055000001e-11,18394298,1328784,3200124996
2450500,2111680708,81386459,1.0987171965e-11,18695428,1328812,3201453808
2451000,2112592240,81385373,1.0987025354999999e-11,18660150,1329304,3202783112
2451500,2137905125,81753300,1.10366955e-11,18710572,1328312,3204111424
2452000,2117044033,81385884,1.098709434e-11,18676765,1329680,3205441104
2452500,2117318541,81383100,1.09867185e-11,18586270,1327812,3206768916
2453000,2378806318,81389064,1.0987523640000001e-11,18780096,1328812,3208097728
2453500,2197735809,81753319,1.1036698065e-11,18711210,1327312,3209425040
2454000,2249271156,81385347,1.0987021845e-11,18659303,1329688,3210754728
2454500,2353016640,81385695,1.0987068825000001e-11,18670598,1329312,3212084040
2455000,2737782838,81377063,1.0985903505000001e-11,18390055,1329188,3213413228
2455500,2186865010,81741589,1.1035114515e-11,18329973,1330188,3214743416
2456000,2210094220,81390246,1.098768321e-11,18818508,1328276,3216071692
2456500,2156147869,81389381,1.0987566435e-11,18790403,1328272,3217399964
2457000,5094512893,81386547,1.0987183845e-11,18698111,1327284,3218727248
2457500,8838402610,81754671,1.1036880585000001e-11,18755125,1328276,3220055524
2458000,14400446703,81940491,1.1061966285e-11,18840672,1328784,3221384308
2458500,3361906308,81829687,1.1047007745000001e-11,18811702,1327784,3222712092
2459000,2129220558,81388362,1.098742887e-11,18757296,1328784,3224040876
2459500,2121057197,81387599,1.0987325865000001e-11,18732491,1327784,3225368660
2460000,2094817797,81391084,1.098779634e-11,18845745,1329272,3226697932
2460500,2139654373,81388805,1.0987488675e-11,18771679,1327776,3228025708
2461000,2127592361,81756450,1.103712075e-11,18812965,1328276,3229353984
2461500,2121466033,81385351,1.0987022385000001e-11,18659432,1328304,3230682288
2462000,2144322448,81384069,1.0986849315000002e-11,18617775,1327276,3232009564
2462500,2103009642,81387190,1.0987270650000002e-11,18719186,1327812,3233337376
2463000,2114468270,81745353,1.1035622655000001e-11,18452292,1330160,3234667536
2463500,2114066074,81379899,1.0986286365000002e-11,18482244,1328812,3235996348
2464000,2268398594,81388090,1.0987392150000001e-11,18748457,1328284,3237324632
2464500,2160575466,81390017,1.0987652295000001e-11,18811086,1328304,3238652936
2465000,2323108301,81747705,1.1035940175000001e-11,18528736,1328312,3239981248
2465500,2415279887,81377526,1.098596601e-11,18405098,1329296,3241310544
2466000,2683547358,81379273,1.0986201855e-11,18461880,1329312,3242639856
2466500,2198305827,81389173,1.0987538355000001e-11,18783642,1328296,3243968152
2467000,2097299200,81754279,1.1036827665e-11,18742396,1327804,3245295956
2467500,2467998770,81389180,1.0987539300000002e-11,18783879,1329672,3246625628
2468000,2351464506,81390900,1.0987771500000002e-11,18839760,1329312,3247954940
2468500,5045990399,81385412,1.098703062e-11,18661396,1328304,3249283244
2469000,8832907864,81825446,1.1046435210000002e-11,18673860,1327812,3250611056
2469500,18008044537,82337060,1.11155031e-11,18631064,1328284,3251939340
2470000,2135163178,81385717,1.0987071795000002e-11,18671326,1328812,3253268152
2470500,2114476876,81389644,1.098760194e-11,18798964,1327296,3254595448
2471000,2114769964,81382032,1.0986574320000002e-11,18551569,1329688,3255925136
2471500,2109532519,81735628,1.103430978e-11,18136238,1327796,3257252932
2472000,2126976984,81372045,1.0985226075e-11,18226970,1327812,3258580744
2472500,2079542878,81372667,1.0985310045000001e-11,18247182,1329644,3259910388
2473000,2136065159,81388960,1.0987509600000001e-11,18776704,1327784,3261238172
2473500,2104050164,81387708,1.0987340580000001e-11,18736010,1327304,3262565476
2474000,2127310311,81755624,1.103700924e-11,18786102,1328304,3263893780
2474500,2160698743,81389862,1.098763137e-11,18806040,1330156,3265223936
2475000,2121510390,81389384,1.098756684e-11,18790516,1328804,3266552740
2475500,2238288531,81394703,1.0988284905e-11,18963377,1329652,3267882392
2476000,2122818714,81754658,1.103687883e-11,18754704,1327776,3269210168
2476500,2142014141,81390156,1.098767106e-11,18815606,1328284,3270538452
2477000,2137819962,81387724,1.098734274e-11,18736546,1328784,3271867236
2477500,2167501552,81389595,1.0987595325000001e-11,18797342,1327784,3273195020
2478000,2246804051,81753021,1.1036657835000002e-11,18701508,1331520,3274526540
2478500,2308449180,81355145,1.0982944575e-11,17677719,1328260,3275854800
2479000,4924980828,81361653,1.0983823155e-11,17889245,1327784,3277182584
2479500,8819330016,81813379,1.1044806165e-11,18281693,1328768,3278511352
2480000,14511504140,81775299,1.1039665365e-11,18234816,1328284,3279839636
2480500,2221636059,81745522,1.1035645470000001e-11,18457782,1329768,3281169404
2481000,2121922236,81372445,1.0985280074999999e-11,18239992,1328804,3282498208
2481500,2123198331,81371621,1.0985168835e-11,18213191,1328276,3283826484
2482000,2118106726,81375018,1.098562743e-11,18323415,1328780,3285155264
2482500,2116156382,81739535,1.1034837225000001e-11,18263212,1328304,3286483568
2483000,2118598737,81371602,1.098516627e-11,18212574,1328276,3287811844
2483500,2109169038,81372950,1.098534825e-11,18256406,1328760,3289140604
2484000,2111607600,81370323,1.0984993605e-11,18171012,1328276,3290468880
2484500,2398970201,81370961,1.0985079735000001e-11,18191764,1328776,3291797656
2485000,2162258438,81374223,1.0985520105000001e-11,18297770,1329304,3293126960
2485500,2226128824,81373907,1.0985477445000001e-11,18287495,1327784,3294454744
2486000,2244142627,81367641,1.0984631534999999e-11,18083867,1328784,3295783528
2486500,2237549425,81363340,1.09840509e-11,17944077,1330172,3297113700
2487000,2151702993,81721068,1.1032344180000001e-11,17663044,1328312,3298442012
2487500,2166092675,81356391,1.0983112785000001e-11,17718213,1329680,3299771692
2488000,2243201648,81357051,1.0983201885000001e-11,17739686,1328312,3301100004
2488500,2250375585,81369432,1.098487332e-11,18142044,1328312,3302428316
2489000,2400812745,81738058,1.103463783e-11,18215218,1328804,3303757120
2489500,2180186779,81373638,1.098544113e-11,18278743,1329188,3305086308
2490000,2135208419,81369622,1.098489897e-11,18148228,1328784,3306415092
2490500,2161179316,81376602,1.0985841270000002e-11,18375074,1328312,3307743404
2491000,2189547332,81735410,1.1034280350000002e-11,18129152,1327804,3309071208
2491500,2135527095,81372047,1.0985226345000001e-11,18227044,1328812,3310400020
2492000,2125785873,81371403,1.0985139405000001e-11,18206126,1327812,3311727832
2492500,3421501958,81369889,1.0984935015e-11,18156914,1329152,3313056984
2493000,18000170132,82323164,1.1113627140000001e-11,18179596,1328312,3314385296
2493500,2115508825,81372160,1.0985241600000002e-11,18230707,1330180,3315715476
2494000,2116061822,81369883,1.0984934204999999e-11,18156725,1329688,3317045164
2494500,2084729405,81371755,1.0985186925e-11,18217340,1329304,3318374468
2495000,2125655843,81747206,1.1035872810000002e-11,18512532,1329296,3319703764
2495500,2119252201,81387721,1.0987342335e-11,18736465,1328144,3321031908
2496000,2210313912,81384962,1.098696987e-11,18646785,1329624,3322361532
2496500,2110046912,81384379,1.0986891165e-11,18627830,1328776,3323690308
2497000,2110429612,81384672,1.098693072e-11,18637355,1327776,3325018084
2497500,2260941458,81751018,1.103638743e-11,18636412,1328784,3326346868
2498000,2204905076,81388526,1.0987451009999999e-11,18762618,1327804,3327674672
2498500,2278039627,81385175,1.0986998625e-11,18653714,1329148,3329003820
2499000,2491251254,81751857,1.1036500695000001e-11,18663679,1328284,3330332104
2499500,2255005283,81386866,1.098722691e-11,18708668,1328304,3331660408
2500000,2299648317,81387815,1.0987355025000001e-11,18739499,1329188,3332989596
2500500,2268691435,81391762,1.098788787e-11,18867772,1328312,3334317908
2501000,2274337093,81737626,1.103457951e-11,18201164,1328812,3335646720
2501500,2449773534,81378924,1.098615474e-11,18450556,1328784,3336975504
2502000,2235626824,81389811,1.0987624485000001e-11,18804366,1328312,3338303816
2502500,2124942527,81390624,1.098773424e-11,18830785,1329272,3339633088
2503000,5107105549,81752126,1.1036537009999999e-11,18672414,1328312,3340961400
2503500,8756730178,81383456,1.098676656e-11,18597856,1328304,3342289704
2504000,22624663398,82596742,1.115056017e-11,18735823,1330180,3343619884
2504500,2145321279,81386211,1.0987138485e-11,18687366,1329304,3344949188
2505000,2135636336,81386269,1.0987146315e-11,18689252,1327804,3346276992
2505500,2118491711,81394314,1.098823239e-11,18950708,1329660,3347606652
2506000,2113748964,81751557,1.1036460195000002e-11,18653931,1327776,3348934428
2506500,2112042651,81389555,1.0987589925000001e-11,18796064,1329776,3350264204
2507000,2109693562,81389009,1.0987516215000001e-11,18778082,1329284,3351593488
2507500,2112121946,81380017,1.0986302295e-11,18486086,1328644,3352922132
2508000,2105097491,81737370,1.1034544950000001e-11,18192850,1328304,3354250436
2508500,2108878632,81372315,1.0985262525e-11,18235765,1328276,3355578712
2509000,2218139218,81376245,1.0985793075000001e-11,18363496,1329312,3356908024
2509500,2154477425,81373548,1.0985428980000001e-11,18275826,1329296,3358237320
2510000,2271884358,81744949,1.1035568115e-11,18439164,1328804,3359566124
2510500,2132608813,81389998,1.098764973e-11,18810443,1328776,3360894900
2511000,2141982236,81385784,1.0987080840000001e-11,18673512,1327812,3362222712
2511500,2125869904,81384522,1.0986910470000002e-11,18632476,1327312,3363550024
2512000,2338125184,81753609,1.1036737215e-11,18720616,1328812,3364878836
2512500,2128808372,81387961,1.0987374735000001e-11,18744258,1328812,3366207648
2513000,2172831636,81388156,1.0987401060000001e-11,18750603,1329180,3367536828
2513500,3448186149,81388502,1.098744777e-11,18761824,1329312,3368866140
2514000,6680860286,81790255,1.1041684425e-11,18720894,1329312,3370195452
2514500,11646636601,81389682,1.098760707e-11,18800193,1327772,3371523224
2515000,8898048048,82306776,1.111141476e-11,18837739,1330532,3372853756
2515500,2132266779,81373486,1.0985420610000001e-11,18273810,1329312,3374183068
2516000,2124855866,81390602,1.098773127e-11,18830085,1328776,3375511844
2516500,2242092794,81387897,1.0987366095e-11,18742186,1328312,3376840156
2517000,2128556412,81385864,1.0987091639999999e-11,18676079,1328680,3378168836
2517500,2145851407,81754942,1.103691717e-11,18763934,1328304,3379497140
2518000,2119355841,81390621,1.0987733835000002e-11,18830704,1329812,3380826952
2518500,2119424941,81388243,1.0987412805e-11,18753426,1329160,3382156112
2519000,2117865459,81385854,1.0987090290000001e-11,18675758,1327312,3383483424
2519500,2116224112,81754299,1.1036830365e-11,18742746,1328312,3384811736
2520000,2109540556,81389508,1.098758358e-11,18794526,1328304,3386140040
2520500,2291464439,81392613,1.0988002755000001e-11,18895456,1328812,3387468852
2521000,2213518022,81391355,1.0987832925000001e-11,18854544,1328804,3388797656
2521500,2142979508,81753611,1.1036737485e-11,18720706,1327796,3390125452
2522000,2135339456,81389847,1.0987629345e-11,18805556,1329312,3391454764
2522500,2262617049,81383752,1.0986806520000001e-11,18607446,1329644,3392784408
2523000,2264450091,81378078,1.0986040530000002e-11,18423051,1329280,3394113688
2523500,2721477292,81755014,1.103692689e-11,18766295,1329260,3395442948
2524000,2448131753,81386869,1.0987227315e-11,18708755,1328280,3396771228
2524500,2182299612,81385078,1.0986985530000001e-11,18650567,1327784,3398099012
2525000,4947716229,81376698,1.098585423e-11,18378204,1328776,3399427788
2525500,8791109336,81787087,1.1041256745000002e-11,18617932,1328304,3400756092
2526000,22356470434,82449124,1.113063174e-11,18701160,1327796,3402083888
2526500,2116796032,81386317,1.0987152795e-11,18690822,1327812,3403411700
2527000,2128351070,81389812,1.0987624620000002e-11,18804400,1327804,3404739504
2527500,2117309142,81391759,1.0987887465e-11,18867674,1328804,3406068308
2528000,2149405565,81388957,1.0987509195000001e-11,18776637,1328688,3407396996
2528500,2110150111,81392159,1.0987941465000001e-11,18880696,1329796,3408726792
2529000,2096083345,81391011,1.0987786485e-11,18843376,1328796,3410055588
2529500,2099945349,81387032,1.098724932e-11,18714041,1329160,3411384748
2530000,2097962048,81752283,1.1036558205e-11,18677523,1329688,3412714436
2530500,2096769115,81383540,1.0986777900000002e-11,18600554,1328804,3414043240
2531000,2089623215,81372683,1.0985312205000002e-11,18247716,1328776,3415372016
2531500,2090121374,81368745,1.0984780575e-11,18119730,1328312,3416700328
2532000,2171168292,81749075,1.1036125125e-11,18572949,1329188,3418029516
2532500,2252280719,81385553,1.0987049655e-11,18665994,1327804,3419357320
2533000,2091303486,81385394,1.0987028190000001e-11,18660830,1328804,3420686124
2533500,2147469572,81384046,1.098684621e-11,18617026,1327812,3422013936
2534000,2105601606,81384045,1.0986846075e-11,18616981,1329180,3423343116
2534500,2209560658,81383599,1.0986785865000001e-11,18602484,1328812,3424671928
2535000,2223186584,81386312,1.098715212e-11,18690672,1327812,3425999740
2535500,2120791088,81394574,1.0988267490000001e-11,18959172,1328784,3427328524
2536000,2229417610,81387964,1.098737514e-11,18744330,1327776,3428656300
2536500,2196601781,81755546,1.103699871e-11,18783568,1329276,3429985576
2537000,4995064518,81388185,1.0987404975000001e-11,18751543,1327780,3431313356
2537500,11436261522,81745034,1.1035579590000001e-11,18441936,1330160,3432643516
2538000,18155804147,82175081,1.1093635935e-11,18129796,1327796,3433971312
2538500,2108298835,81386707,1.0987205445e-11,18703488,1329152,3435300464
2539000,2109469821,81388175,1.0987403625e-11,18751199,1329276,3436629740
2539500,2119998348,81390543,1.0987723305000001e-11,18828174,1329296,3437959036
2540000,2076289943,81754910,1.1036912850000001e-11,18762889,1328284,3439287320
2540500,2098201024,81391145,1.0987804575e-11,18847743,1328784,3440616104
2541000,2095379864,81385240,1.09870074e-11,18655802,1327784,3441943888
2541500,2321693657,81388564,1.098745614e-11,18763836,1328312,3443272200
2542000,2243599376,81757595,1.1037275325e-11,18850176,1329312,3444601512
2542500,2243966535,81390285,1.0987688475e-11,18819790,1329804,3445931316
2543000,2266884131,81387722,1.0987342469999999e-11,18736489,1330180,3447261496
2543500,2285019751,81384240,1.0986872400000001e-11,18623326,1327776,3448589272
2544000,2152447740,81749144,1.1036134440000001e-11,18575498,1327784,3449917056
2544500,2246589710,81386869,1.0987227315e-11,18708431,1328776,3451245832
2545000,2143960663,81381115,1.0986450525000001e-11,18521753,1330172,3452576004
2545500,2120629523,81376081,1.0985770935000001e-11,18358151,1328660,3453904664
2546000,2259977302,81736822,1.103447097e-11,18175034,1327304,3455231968
2546500,3486743383,81384027,1.0986843645000001e-11,18616403,1331180,3456563148
2547000,6978299228,81382378,1.098662103e-11,18562806,1327804,3457890952
2547500,11394508355,81825105,1.1046389174999999e-11,18662784,1328812,3459219764
2548000,4930185708,81792518,1.1041989930000002e-11,18794418,1329804,3460549568
2548500,2185579567,81388243,1.0987412805e-11,18753405,1329672,3461879240
2549000,2114344114,81755867,1.1037042045000002e-11,18794016,1328812,3463208052
2549500,2116118679,81390331,1.0987694685000002e-11,18821260,1328812,3464536864
2550000,2107957119,81389736,1.0987614360000001e-11,18801955,1330164,3465867028
2550500,2131633918,81385092,1.098698742e-11,18650994,1328312,3467195340
2551000,2105668001,81389582,1.098759357e-11,18796920,1328784,3468524124
2551500,2100837206,81389280,1.0987552800000002e-11,18787132,1330528,3469854652
2552000,2096854853,81387813,1.0987354755000002e-11,18739440,1328812,3471183464
2552500,2100658035,81384787,1.0986946245e-11,18641096,1328304,3472511768
2553000,2137432476,81386965,1.0987240275000001e-11,18711897,1330680,3473842448
2553500,2275401212,81755523,1.1036995604999999e-11,18782844,1329812,3475172260
2554000,2117021739,81387395,1.0987298325000001e-11,18725857,1329680,3476501940
2554500,2130641262,81388354,1.098742779e-11,18757022,1329284,3477831224
2555000,2129545122,81388004,1.098738054e-11,18745664,1327812,3479159036
2555500,2218563411,81751028,1.1036388780000002e-11,18636754,1328284,3480487320
2556000,2127710339,81375370,1.098567495e-11,18335043,1328776,3481816096
2556500,2421354717,81376465,1.0985822775e-11,18370645,1329660,3483145756
2557000,2423293738,81388727,1.0987478145e-11,18768722,1328812,3484474568
2557500,5193729268,81758462,1.1037392370000001e-11,18878339,1330680,3485805248
2558000,8908718449,81385080,1.09869858e-11,18650612,1327812,3487133060
2558500,11405035201,82267175,1.1106068625e-11,18741384,1327804,3488460864
2559000,3360847024,84461227,1.1402265645000002e-11,18817588,1332408,3489793272
2559500,2172488898,95590123,1.2904666605000001e-11,23404330,1329660,3491122932
2560000,2124433608,95589578,1.2904593030000001e-11,23348886,1329796,3492452728
2560500,3361134425,95949442,1.2953174670000001e-11,23305781,1328296,3493781024
2561000,2113325216,95585750,1.290407625e-11,23416018,1328284,3495109308
2561500,2112553720,95577182,1.2902919570000002e-11,23134313,1327804,3496437112
2562000,2107797625,95570837,1.2902062995e-11,22873307,1329536,3497766648
2562500,2107903821,95568863,1.2901796505e-11,22698060,1328804,3499095452
2563000,2105470946,95570708,1.2902045580000001e-11,22768538,1328804,3500424256
2563500,2100134332,95577223,1.2902925105e-11,22925268,1329160,3501753416
2564000,2091215532,95568470,1.2901743450000002e-11,22860231,1328812,3503082228
2564500,2107765164,95574059,1.2902497965e-11,22984938,1328804,3504411032
2565000,2092872652,95936085,1.2951371475e-11,22895294,1329640,3505740672
2565500,2081668138,95571434,1.290214359e-11,22961284,1328284,3507068956
2566000,2087120893,95566417,1.2901466295e-11,22700362,1328784,3508397740
2566500,2085890869,95579787,1.2903271245000002e-11,23116527,1328784,3509726524
2567000,2085870319,95584634,1.290392559e-11,23380646,1327284,3511053808
2567500,4790694366,95948298,1.295302023e-11,23204396,1329284,3512383092
2568000,3349346901,95593517,1.2905124795e-11,23561007,1329744,3513712836
2568500,4852720036,95953462,1.2953717370000001e-11,23415833,1327776,3515040612
2569000,4850737389,95591611,1.2904867485000001e-11,23545088,1328776,3516369388
2569500,5163374589,91048013,1.2291481755000001e-11,23420727,25597856,3541967244
2570000,6723922091,88174940,1.1903616900000001e-11,22416816,39650604,3581617848
2570500,6655951239,87803078,1.185341553e-11,22313599,39657472,3621275320
2571000,8943951041,88210289,1.1908389015000001e-11,22376920,39652920,3660928240
2571500,6658729417,87814740,1.1854989900000001e-11,22368428,39654524,3700582764
2572000,11339835663,88468697,1.1943274095e-11,22327033,39655948,3740238712
2572500,2119509045,87761159,1.1847756465e-11,22217565,39649468,3779888180
2573000,2115888798,88104773,1.1894144355e-11,22312213,37676272,3817564452
2573500,3354004485,93863190,1.267153065e-11,21389118,1329652,3818894104
2574000,3352079823,94122933,1.2706595955e-11,20882440,1328260,3820222364
2574500,3362200265,93380760,1.2606402600000002e-11,20986153,1327784,3821550148
2575000,3338204008,93429369,1.2612964815e-11,21065630,1328284,3822878432
2575500,3337932693,93729175,1.2653438625e-11,21063986,1328796,3824207228
2576000,3332190464,93381782,1.2606540570000001e-11,21554389,1327784,3825535012
2576500,3333890826,93687761,1.2647847735e-11,21426145,1330160,3826865172
2577000,2070263481,93329208,1.2599443080000001e-11,21434194,1328796,3828193968
2577500,3314135324,93375950,1.260575325e-11,21422131,1329312,3829523280
2578000,2088885212,93347317,1.2601887795e-11,21397902,1328172,3830851452
2578500,3323427205,93724632,1.2652825320000001e-11,21495851,1328804,3832180256
2579000,3320000007,93369247,1.2604848345e-11,21405285,1327804,3833508060
2579500,2087382593,93337257,1.2600529695e-11,21454789,1327804,3834835864
2580000,2070583627,93332311,1.2599861985000002e-11,21525360,1330680,3836166544
2580500,2120902879,93327210,1.259917335e-11,21554612,1327928,3837494472
2581000,3322556376,93329828,1.259952678e-11,21178518,1329652,3838824124
2581500,2098922528,93340900,1.26010215e-11,20902456,1329652,3840153776
2582000,3315101954,93802796,1.266337746e-11,20842143,1328804,3841482580
2582500,2086362989,93350037,1.2602254995000002e-11,21184025,1328296,3842810876
2583000,2085651969,93331798,1.259979273e-11,21383019,1328312,3844139188
2583500,2077600845,89040016,1.202040216e-11,21360769,-628194920,3215944268
2584000,2100231221,81390286,1.098768861e-11,18819800,1328312,3217272580
2584500,2089163065,81754972,1.103692122e-11,18764914,1328812,3218601392
2585000,2082708888,81388181,1.0987404435e-11,18751411,1329188,3219930580
2585500,2078521966,81391361,1.0987833735e-11,18854739,1326928,3221257508
2586000,2238313267,81391076,1.098779526e-11,18845507,1328284,3222585792
2586500,2186188175,81756422,1.103711697e-11,18812053,1329688,3223915480
2587000,2410506403,81388212,1.098740862e-11,18752388,1329312,3225244792
2587500,2087452729,81390088,1.098766188e-11,18813368,1328804,3226573596
2588000,2133783245,81376940,1.0985886900000001e-11,18386054,1331036,3227904632
2588500,2153087212,81741584,1.103511384e-11,18329801,1328284,3229232916
2589000,2216557327,81390964,1.098778014e-11,18841850,1328804,3230561720
2589500,2258049788,81388244,1.098741294e-11,18753462,1329144,3231890864
2590000,4864629425,81385916,1.0987098660000001e-11,18677780,1328796,3233219660
2590500,6681809133,81752659,1.1036608965e-11,18689756,1327312,3234546972
2591000,11612779667,81829591,1.1046994784999999e-11,18808581,1328284,3235875256
2591500,11241045261,82048059,1.1076487965e-11,18764466,1330152,3237205408
2592000,2142724989,81389689,1.0987608015e-11,18800406,1328276,3238533684
2592500,2128695393,81389538,1.098758763e-11,18795514,1329312,3239862996
2593000,2101280517,81388920,1.0987504200000001e-11,18775411,1330156,3241193152
2593500,2102651315,81752026,1.1036523509999999e-11,18669160,1327796,3242520948
2594000,2096761753,81388889,1.0987500015e-11,18774398,1327812,3243848760
2594500,2134823429,81380111,1.0986314985000002e-11,18489115,1329172,3245177932
2595000,2091888040,81385813,1.0987084755000001e-11,18674441,1328688,3246506620
2595500,2081905413,81391479,1.0987849665e-11,18858583,1329268,3247835888
2596000,2211038867,81738528,1.1034701280000002e-11,18230480,1328284,3249164172
2596500,2173119399,81370044,1.098495594e-11,18161937,1329652,3250493824
2597000,2257253441,81383532,1.098677682e-11,18600298,1329312,3251823136
2597500,2184948187,81386018,1.098711243e-11,18681088,1328312,3253151448
2598000,2184844409,81755088,1.1036936880000001e-11,18768513,1329680,3254481128
2598500,2170189846,81385652,1.098706302e-11,18669204,1329304,3255810432
2599000,2246522489,81388158,1.098740133e-11,18750650,1328812,3257139244
2599500,2195808632,81386145,1.0987129575e-11,18685231,1329688,3258468932
2600000,2172581320,81753561,1.1036730735e-11,18719072,1328796,3259797728
2600500,3464456810,81390522,1.0987720469999999e-11,18827484,1329312,3261127040
2601000,6675541700,81380071,1.0986309585000002e-11,18487811,1328680,3262455720
2601500,11252105501,81772450,1.103928075e-11,18142220,1329276,3263784996
2602000,14346488682,82292865,1.1109536775e-11,18385620,1327812,3265112808
2602500,2124710146,81383891,1.0986825285e-11,18611974,1329312,3266442120
2603000,2109080470,81389213,1.0987543755000001e-11,18784934,1329660,3267771780
2603500,2107235533,81388162,1.0987401870000001e-11,18750789,1329784,3269101564
2604000,2102096763,81754340,1.10368359e-11,18744370,1329312,3270430876
2604500,2099378481,81387455,1.0987306425e-11,18727797,1327276,3271758152
2605000,2106480527,81387557,1.0987320195e-11,18731125,1328784,3273086936
2605500,2093392957,81392388,1.098797238e-11,18888130,1328312,3274415248
2606000,2083089912,81385765,1.0987078275e-11,18672872,1328312,3275743560
2606500,2107187519,81755466,1.103698791e-11,18780984,1329804,3277073364
2607000,2162582409,81386762,1.0987212870000002e-11,18705284,1328644,3278402008
2607500,2120264032,81385503,1.0987042905000001e-11,18664355,1327784,3279729792
2608000,2254091716,81388503,1.0987447905e-11,18761873,1328784,3281058576
2608500,2237046454,81737302,1.1034535770000002e-11,18190652,1330564,3282389140
2609000,2102610523,81357145,1.0983214575e-11,17742719,1329144,3283718284
2609500,2158314066,81373253,1.0985389155e-11,18266229,1329284,3285047568
2610000,2244786501,81373848,1.098546948e-11,18285580,1327812,3286375380
2610500,2199264462,81375705,1.0985720175e-11,18345760,1327296,3287702676
2611000,2693508846,81739748,1.1034865980000001e-11,18270132,1328784,3289031460
2611500,4833672434,81373158,1.0985376330000001e-11,18263166,1328312,3290359772
2612000,8731689104,81774856,1.1039605560000001e-11,18220403,1329180,3291688952
2612500,11911788952,81775330,1.103966955e-11,18235836,1328804,3293017756
2613000,2138845490,81373201,1.0985382135000001e-11,18264538,1328312,3294346068
2613500,2135159002,81739262,1.1034800370000001e-11,18254344,1328304,3295674372
2614000,2117290014,81371108,1.0985099580000001e-11,18196535,1328672,3297003044
2614500,2116801724,81372987,1.0985353245e-11,18257578,1329312,3298332356
2615000,2108383440,81376081,1.0985770935000001e-11,18358138,1331064,3299663420
2615500,2111506462,81357674,1.0983285990000001e-11,17759937,1327936,3300991356
2616000,2111629815,81723906,1.103272731e-11,17755269,1328784,3302320140
2616500,2114092114,81357330,1.0983239550000001e-11,17748748,1328268,3303648408
2617000,2104922953,81356418,1.098311643e-11,17719094,1327312,3304975720
2617500,2101775385,81360642,1.098368667e-11,17856370,1329268,3306304988
2618000,2095728035,81741216,1.1035064160000002e-11,18317850,1328776,3307633764
2618500,2102490452,81371662,1.0985174370000001e-11,18214521,1327784,3308961548
2619000,2116839734,81374762,1.098559287e-11,18315281,1328276,3310289824
2619500,2093836412,81373345,1.0985401575000001e-11,18269232,1328284,3311618108
2620000,2093170421,81376214,1.0985788890000001e-11,18362458,1328776,3312946884
2620500,2090955426,81744207,1.1035467945e-11,18415064,1330304,3314277188
2621000,2088743546,81371210,1.098511335e-11,18199838,1329276,3315606464
2621500,2321489973,81372860,1.0985336100000002e-11,18253466,1328804,3316935268
2622000,2111555853,81377705,1.0985990175e-11,18410923,1329780,3318265048
2622500,2602574877,81739709,1.1034860715e-11,18268885,1329180,3319594228
2623000,2513888340,81374012,1.0985491620000002e-11,18290904,1327796,3320922024
2623500,2275000757,81384900,1.0986961500000001e-11,18644787,1329188,3322251212
2624000,2409679277,81386796,1.0987217460000002e-11,18706370,1328296,3323579508
2624500,2497774039,81389303,1.0987555905e-11,18787848,1327796,3324907304
2625000,2273832552,81394617,1.0988273295000001e-11,18960577,1330688,3326237992
2625500,2669211016,81393200,1.0988082e-11,18914510,1328804,3327566796
2626000,2256782344,81741215,1.1035064025000001e-11,18317832,1328812,3328895608
2626500,7125917229,81374180,1.0985514300000001e-11,18296354,1327312,3330222920
2627000,6952390391,81780055,1.1040307425e-11,18389374,1328804,3331551724
2627500,22847574637,82401731,1.1124233685e-11,18351615,1329660,3332881384
2628000,2128129302,81375200,1.0985652000000001e-11,18329524,1327812,3334209196
2628500,2124990394,81378793,1.0986137055e-11,18446280,1328288,3335537484
2629000,2115096355,81375320,1.09856682e-11,18333406,1329156,3336866640
2629500,2110869919,81374913,1.0985613255000001e-11,18320180,1328296,3338194936
2630000,2102890297,81749455,1.1036176425000002e-11,18585604,1328812,3339523748
2630500,2110361900,81384080,1.09868508e-11,18618113,1329180,3340852928
2631000,2166527322,81359313,1.0983507255e-11,17813190,1328276,3342181204
2631500,2104181961,81364812,1.098424962e-11,17991918,1329312,3343510516
2632000,2090995886,81739059,1.1034772965e-11,18247753,1329172,3344839688
2632500,2093392197,81371894,1.0985205690000001e-11,18222058,1328304,3346167992
2633000,2084835174,81371087,1.0985096745000001e-11,18195830,1328296,3347496288
2633500,2083758112,81372032,1.0985224320000001e-11,18226564,1327304,3348823592
2634000,2084582055,81371168,1.0985107680000001e-11,18198463,1329688,3350153280
2634500,2084456089,81737402,1.1034549270000001e-11,18193884,1327796,3351481076
2635000,2095221869,81371760,1.0985187600000001e-11,18217736,1327804,3352808880
2635500,2112610682,81376155,1.0985780924999999e-11,18360552,1329284,3354138164
2636000,2099489108,81375722,1.0985722470000001e-11,18346261,1328784,3355466948
2636500,2088245685,81372220,1.0985249700000002e-11,18232686,1329812,3356796760
2637000,2101912777,81737084,1.1034506340000002e-11,18183561,1327272,3358124032
2637500,2396509242,81368827,1.0984791645e-11,18122386,1327644,3359451676
2638000,2182385466,81371525,1.0985155875000002e-11,18210089,1328780,3360780456
2638500,2651877946,81372140,1.09852389e-11,18230050,1328284,3362108740
2639000,2196975198,81381809,1.0986544215e-11,18544307,1329284,3363438024
2639500,4896919712,81384484,1.0986905340000001e-11,18631266,1327812,3364765836
2640000,11303045968,81786680,1.10412018e-11,18604678,1329812,3366095648
2640500,14330603256,82163384,1.1092056840000001e-11,18940402,1328312,3367423960
2641000,2104514879,81387500,1.0987312500000002e-11,18729276,1327804,3368751764
2641500,2104673276,81386064,1.0987118640000002e-11,18682594,1328288,3370080052
2642000,2100479386,81388836,1.0987492860000002e-11,18772685,1330652,3371410704
2642500,2096165062,81385534,1.098704709e-11,18665363,1328776,3372739480
2643000,2095389076,81386288,1.098714888e-11,18689871,1327776,3374067256
2643500,2091207776,81388272,1.0987416720000002e-11,18754340,1328312,3375395568
2644000,2091437251,81389943,1.0987642305000001e-11,18808664,1330148,3376725716
2644500,2346282951,81388368,1.098742968e-11,18757492,1329304,3378055020
2645000,2141126483,81745827,1.1035686645e-11,18467703,1329188,3379384208
2645500,2172357488,81376736,1.0985859360000001e-11,18379432,1328304,3380712512
2646000,2172567340,81373003,1.0985355405e-11,18258098,1329312,3382041824
2646500,2119603503,81374529,1.0985561415e-11,18307718,1327812,3383369636
2647000,2450096634,81752980,1.1036652300000001e-11,18700194,1329652,3384699288
2647500,2180611599,81386354,1.098715779e-11,18692030,1328284,3386027572
2648000,2390041786,81387391,1.0987297785e-11,18725716,1327804,3387355376
2648500,2203689382,81758286,1.103736861e-11,18872382,1328812,3388684188
2649000,2338747058,81387951,1.0987373385e-11,18743912,1328656,3390012844
2649500,2282895875,81388350,1.098742725e-11,18756882,1328812,3391341656
2650000,2299128313,81390647,1.0987737345000002e-11,18831544,1328812,3392670468
2650500,3664230605,81758306,1.103737131e-11,18873265,1329688,3394000156
2651000,6910961438,81383526,1.098677601e-11,18600103,1328780,3395328936
2651500,11569434097,81900495,1.1056566825000001e-11,18731500,1328312,3396657248
2652000,14306831119,82111904,1.1085107040000002e-11,18457996,1331528,3397988776
2652500,2119992841,81385596,1.098705546e-11,18667400,1328304,3399317080
2653000,2116875106,81387812,1.0987354620000001e-11,18739416,1328304,3400645384
2653500,2148055324,81390678,1.0987741530000001e-11,18832538,1328812,3401974196
2654000,2086044833,81754963,1.1036920005e-11,18764645,1329688,3403303884
2654500,2109430814,81388354,1.098742779e-11,18757008,1328796,3404632680
2655000,2108658511,81389902,1.0987636770000001e-11,18807344,1328304,3405960984
2655500,2105297496,81391425,1.0987842375000002e-11,18856827,1329188,3407290172
2656000,2102400960,81390765,1.0987753275e-11,18835395,1328276,3408618448
2656500,2134155596,81755485,1.1036990475000002e-11,18781597,1327784,3409946232
2657000,2181131468,81387300,1.0987285499999999e-11,18722751,1328784,3411275016
2657500,2299069869,81387440,1.09873044e-11,18727322,1327776,3412602792
2658000,2128392014,81388036,1.098738486e-11,18746676,1327784,3413930576
2658500,2176717805,81753708,1.103675058e-11,18723832,1327784,3415258360
2659000,2179857570,81386415,1.0987166025000002e-11,18693988,1329148,3416587508
2659500,2204428029,81377563,1.0985971005e-11,18406321,1328784,3417916292
2660000,2151147404,81391552,1.098785952e-11,18860966,1328312,3419244604
2660500,2167666956,81745082,1.1035586069999999e-11,18443502,1327776,3420572380
2661000,2497090615,81374630,1.098557505e-11,18310737,1328776,3421901156
2661500,2143913534,81384131,1.0986857685000001e-11,18619783,1328280,3423229436
2662000,3454751324,81388964,1.0987510140000002e-11,18776844,1328804,3424558240
2662500,7078262675,81831913,1.1047308255e-11,18884031,1329280,3425887520
2663000,11288441237,81391432,1.0987843319999999e-11,18857069,1329160,3427216680
2663500,9027702446,82303763,1.1111008005e-11,18739833,1328284,3428544964
2664000,2121183558,81386640,1.09871964e-11,18701322,1327812,3429872776
2664500,2120515161,81387597,1.0987325595000001e-11,18732426,1328796,3431201572
2665000,2086247347,81388285,1.0987418475e-11,18754782,1328284,3432529856
2665500,2129844120,81391084,1.098779634e-11,18845754,1328312,3433858168
2666000,2119887243,81755007,1.1036925945000001e-11,18766062,1327784,3435185952
2666500,2102521653,81388889,1.0987500015e-11,18774420,1328804,3436514756
2667000,2103065037,81379537,1.0986237495e-11,18470487,1329172,3437843928
2667500,2097368356,81376569,1.0985836815000001e-11,18374017,1329160,3439173088
2668000,2091842783,81757083,1.1037206205000001e-11,18833528,1328304,3440501392
2668500,2192057237,81390694,1.0987743689999999e-11,18833058,1328804,3441830196
2669000,2116915375,81391073,1.0987794855e-11,18845383,1329652,3443159848
2669500,2336241694,81390092,1.0987662420000001e-11,18813513,1328780,3444488628
2670000,2130530197,81392353,1.0987967655e-11,18886982,1328812,3445817440
2670500,2128255679,81391640,1.09878714e-11,18863831,1329680,3447147120
2671000,2230425039,81390755,1.0987751925000001e-11,18835056,1328268,3448475388
2671500,2219570120,81387810,1.098735435e-11,18739354,1328284,3449803672
2672000,2231046516,81390562,1.098772587e-11,18828790,1328276,3451131948
2672500,2282716135,81758456,1.1037391560000001e-11,18878142,1329284,3452461232
2673000,2131493976,81392036,1.098792486e-11,18876682,1328284,3453789516
2673500,2618995377,81391016,1.098778716e-11,18843242,1328784,3455118300
2674000,2529483756,81387507,1.0987313445e-11,18729486,1328652,3456446952
2674500,2329801677,81742007,1.1035170945000001e-11,18343550,1328784,3457775736
2675000,2553052214,81379523,1.0986235605e-11,18470004,1328768,3459104504
2675500,2483553721,81394050,1.0988196750000002e-11,18942144,1329776,3460434280
2676000,2255163618,81745942,1.1035702170000001e-11,18471440,1328284,3461762564
2676500,2405610587,81392612,1.098800262e-11,18895399,1328284,3463090848
2677000,2591151159,81391720,1.09878822e-11,18866401,1328284,3464419132
2677500,14324912951,82088015,1.1081882025e-11,18872296,1328304,3465747436
2678000,2085965683,81391038,1.0987790130000002e-11,18844247,1328272,3467075708
2678500,2086960491,81390705,1.0987745175e-11,18833430,1328304,3468404012
2679000,2110915438,81388433,1.0987438455e-11,18759582,1327784,3469731796
2679500,2096831339,81756967,1.1037190545e-11,18829777,1328276,3471060072
2680000,2101296433,81391414,1.098784089e-11,18856480,1327784,3472387856
2680500,2096772116,81393222,1.098808497e-11,18915230,1328776,3473716632
2681000,2093651953,81390273,1.0987686855000001e-11,18819382,1329312,3475045944
2681500,2094402462,81385732,1.098707382e-11,18671824,1328312,3476374256
2682000,2091051186,81757123,1.1037211605e-11,18834810,1331036,3477705292
2682500,2088599974,81374311,1.0985531985e-11,18300629,1328756,3479034048
2683000,2091673745,81373348,1.0985401980000001e-11,18269318,1328804,3480362852
2683500,2147614117,81376199,1.0985786865e-11,18361985,1329160,3481692012
2684000,2251814718,81758395,1.1037383324999999e-11,18876176,1329804,3483021816
2684500,2123414023,81391321,1.0987828335000001e-11,18853450,1328812,3484350628
2685000,2103055435,81390567,1.0987726545e-11,18828949,1329672,3485680300
2685500,2260862705,81395588,1.0988404380000001e-11,18992146,1329304,3487009604
2686000,2140334833,81745079,1.1035585665000002e-11,18443076,1326776,3488336380
2686500,6680889581,84462263,1.1402405505000001e-11,18851700,1333416,3489669796
2687000,5372159075,95993638,1.295914113e-11,23427452,1329680,3490999476
2687500,6627186516,95586610,1.290419235e-11,23296770,1328304,3492327780
2688000,8854186233,95949046,1.2953121210000001e-11,23272464,1328312,3493656092
2688500,11490723582,96044216,1.296596916e-11,23909934,1331048,3494987140
2689000,2122705255,95578381,1.2903081435000001e-11,23172875,1328304,3496315444
2689500,2139324529,95583512,1.290377412e-11,23300228,1328812,3497644256
2690000,2091483252,95584125,1.2903856875000001e-11,23324868,1328296,3498972552
2690500,2123296704,95577077,1.2902905395e-11,23045481,1326804,3500299356
2691000,2126410628,95571662,1.290217437e-11,22816420,1328768,3501628124
2691500,2112332889,95577395,1.2902948325e-11,22925875,1328776,3502956900
2692000,2108965013,95948251,1.2953013885000001e-11,23333411,1327284,3504284184
2692500,2115499061,95579352,1.2903212520000001e-11,23217366,1327272,3505611456
2693000,2104900473,95583634,1.2903790590000001e-11,23384595,1328276,3506939732
2693500,2099350492,95583199,1.2903731865e-11,23358053,1328268,3508268000
2694000,2096374112,95958419,1.2954386565e-11,23504724,1329304,3509597304
2694500,2092891674,95589373,1.2904565355e-11,23413462,1329276,3510926580
2695000,2070085263,95588373,1.2904430355e-11,23480041,1328264,3512254844
2695500,2068601621,95589693,1.2904608555000001e-11,23462048,1328784,3513583628
2696000,2092429151,95587342,1.290429117e-11,23401886,1329152,3514912780
2696500,2087079670,95983117,1.2957720795000001e-11,23170744,1328312,3516241092
2697000,2089532319,95579096,1.2903177960000001e-11,23141212,1328296,3517569388
2697500,6710739938,90806633,1.2258895455e-11,23338009,25028368,3542597756
2698000,5195756885,88148216,1.1900009159999999e-11,21637186,39649904,3582247660
2698500,6786697599,88184879,1.1904958665000001e-11,21818972,39653300,3621900960
2699000,6840067023,87742393,1.1845223055000001e-11,21728496,39657820,3661558780
2699500,6661494822,88061141,1.1888254035000001e-11,21921237,39663880,3701222660
2700000,8755470651,88187645,1.1905332075e-11,21846136,39643136,3740865796
2700500,8918043032,90200764,1.217710314e-11,21976111,23281296,3764147092
2701000,11277665554,94882185,1.2809094975e-11,21080848,1328784,3765475876
2701500,3351486122,93479647,1.2619752345e-11,21454158,1329680,3766805556
2702000,3490993386,93392619,1.2608003565e-11,21139512,1329812,3768135368
2702500,3349153919,93342980,1.2601302300000001e-11,21529015,1328312,3769463680
2703000,3461385878,93360149,1.2603620115e-11,21544635,1329688,3770793368
2703500,3343929327,93716716,1.265175666e-11,21466817,1328804,3772122172
2704000,3337702740,93337052,1.260050202e-11,21455867,1327312,3773449484
2704500,2093657013,93330619,1.2599633565e-11,21456213,1329804,3774779288
2705000,2103803727,93343884,1.260142434e-11,21565333,1330144,3776109432
2705500,2090584647,93317455,1.2597856425000001e-11,21471972,1326928,3777436360
2706000,3322381585,93757182,1.2657219570000002e-11,21608491,1328784,3778765144
2706500,3318776784,93382130,1.2606587550000002e-11,21604822,1330680,3780095824
2707000,3318382934,93810392,1.2664402920000001e-11,21360793,1329688,3781425512
2707500,2085783775,93318541,1.2598003035000002e-11,20939344,1327812,3782753324
2708000,2088293356,93306200,1.2596337e-11,20950959,1328312,3784081636
2708500,2104287832,93317354,1.259784279e-11,20942739,1330160,3785411796
2709000,2084167520,93335335,1.2600270225e-11,21356655,1329312,3786741108
2709500,2083114951,93688382,1.2647931570000002e-11,21473588,1329660,3788070768
2710000,2085415341,93446672,1.261530072e-11,21504317,1328312,3789399080
2710500,2081925813,93343900,1.2601426500000002e-11,21487627,1328312,3790727392
2711000,2092567782,93329492,1.2599481420000001e-11,21560512,1327284,3792054676
2711500,2080661540,84734561,1.1439165735e-11,21620952,-463788516,3328266160
2712000,2098105314,81752132,1.103653782e-11,18672632,1328304,3329594464
2712500,2144907151,81389359,1.0987563465e-11,18789690,1329304,3330923768
2713000,2086329312,81388059,1.0987387965000001e-11,18747428,1327812,3332251580
2713500,2124362227,81386548,1.0987183980000001e-11,18698332,1330064,3333581644
2714000,2126870541,81740465,1.1034962775e-11,18293446,1329312,3334910956
2714500,2175211247,81374973,1.0985621355e-11,18322141,1329660,3336240616
2715000,2218270643,81373689,1.0985448015000001e-11,18280402,1328812,3337569428
2715500,2175602481,81393415,1.0988111025000002e-11,18921496,1328804,3338898232
2716000,2156964580,81392040,1.09879254e-11,18876819,1328776,3340227008
2716500,2728760893,81386636,1.098719586e-11,18701185,1328688,3341555696
2717000,2261053314,81387609,1.0987327215000002e-11,18732822,1328788,3342884484
2717500,2281789366,81389302,1.098755577e-11,18787832,1329312,3344213796
2718000,2580965102,81754981,1.1036922435000001e-11,18765199,1329652,3345543448
2718500,2236839041,81387827,1.0987356645e-11,18739880,1328804,3346872252
2719000,2392235620,81387713,1.0987341255000002e-11,18736200,1328304,3348200556
2719500,2376967838,81390331,1.0987694685000002e-11,18821280,1328312,3349528868
2720000,2238634374,81756526,1.1037131010000001e-11,18815426,1330548,3350859416
2720500,2278760110,81373120,1.09853712e-11,18261913,1328280,3352187696
2721000,3586373299,81391433,1.0987843455e-11,18857095,1328284,3353515980
2721500,11293499660,82082010,1.1081071350000002e-11,18677136,1327304,3354843284
2722000,2125200594,81386891,1.0987230285e-11,18709462,1329160,3356172444
2722500,2112068763,81389316,1.0987557660000001e-11,18788299,1328812,3357501256
2723000,2112273636,81390698,1.098774423e-11,18833216,1328812,3358830068
2723500,2139906934,81389817,1.0987625295000002e-11,18804565,1329660,3360159728
2724000,2080971158,81389752,1.0987616519999999e-11,18802448,1328804,3361488532
2724500,2103845011,81391893,1.0987905555e-11,18872036,1328804,3362817336
2725000,2101234382,81388238,1.0987412130000002e-11,18753253,1329688,3364147024
2725500,2096485789,81389996,1.0987649459999999e-11,18810370,1328312,3365475336
2726000,2154897369,81755331,1.1036969685e-11,18776581,1328276,3366803612
2726500,2373484737,81384044,1.098684594e-11,18616962,1327812,3368131424
2727000,2121729189,81374600,1.0985571000000001e-11,18310003,1330532,3369461956
2727500,2202171934,81388221,1.0987409835e-11,18752696,1329288,3370791244
2728000,2388255190,81754016,1.1036792159999999e-11,18733862,1328312,3372119556
2728500,2120624254,81370789,1.0985056515000001e-11,18186153,1329188,3373448744
2729000,2152744854,81374292,1.0985529420000001e-11,18300004,1327812,3374776556
2729500,2150030478,81387217,1.0987274295000001e-11,18720060,1328312,3376104868
2730000,2131916687,81754528,1.1036861280000001e-11,18750497,1329688,3377434556
2730500,2363362491,81394291,1.0988229285000002e-11,18949964,1328768,3378763324
2731000,3374609808,81392402,1.098797427e-11,18888597,1328784,3380092108
2731500,6718292518,81389157,1.0987536195e-11,18783123,1329644,3381421752
2732000,11465265112,81867263,1.1052080505e-11,18842216,1328804,3382750556
2732500,14700772397,82233878,1.110157353e-11,18849965,1330152,3384080708
2733000,2128016507,81382412,1.098662562e-11,18563922,1331056,3385411764
2733500,2124912265,81367209,1.0984573215000002e-11,18069804,1327804,3386739568
2734000,2088437381,81362269,1.0983906315000001e-11,17909251,1330172,3388069740
2734500,2094427947,81723273,1.1032641855000001e-11,17734527,1328784,3389398524
2735000,2092028974,81358102,1.0983343770000001e-11,17773826,1328804,3390727328
2735500,2088798121,81371511,1.0985153985e-11,18209628,1329312,3392056640
2736000,2089269521,81375880,1.09857438e-11,18351601,1328284,3393384924
2736500,2108453528,81737751,1.1034596385e-11,18205234,1326812,3394711736
2737000,2120840097,81373465,1.0985417775e-11,18273127,1330188,3396041924
2737500,2141817634,81372647,1.0985307345000001e-11,18246554,1328804,3397370728
2738000,2113175581,81376304,1.098580104e-11,18365382,1329312,3398700040
2738500,2246295183,81739259,1.1034799965000001e-11,18254237,1329188,3400029228
2739000,2242002720,81369564,1.0984891140000002e-11,18146348,1327772,3401357000
2739500,2207346838,81373504,1.098542304e-11,18274382,1328804,3402685804
2740000,2153466420,81363365,1.0984054275000002e-11,17944887,1329688,3404015492
2740500,3441482478,81358623,1.0983414105e-11,17790749,1328688,3405344180
2741000,6875342736,81742944,1.103529744e-11,18374000,1328284,3406672464
2741500,11406420104,81815955,1.1045153925000002e-11,18365389,1329688,3408002152
2742000,11422163567,81996015,1.1069462025e-11,18263782,1329296,3409331448
2742500,2153384871,81375771,1.0985729085e-11,18348086,1327812,3410659260
2743000,2078000217,81373962,1.0985484870000001e-11,18289282,1329660,3411988920
2743500,2101418735,81373637,1.0985440995e-11,18278726,1329312,3413318232
2744000,2094860854,81740907,1.1035022445e-11,18307796,1328312,3414646544
2744500,2091635318,81372333,1.0985264955e-11,18236338,1326812,3415973356
2745000,2084876295,81375618,1.098570843e-11,18343112,1329660,3417303016
2745500,2144547122,81376473,1.0985823855e-11,18370886,1329260,3418632276
2746000,2166842811,81372996,1.098535446e-11,18257895,1327772,3419960048
2746500,2114104499,81736097,1.1034373095e-11,18151469,1329152,3421289200
2747000,2226604296,81357094,1.0983207690000001e-11,17740887,1328776,3422617976
2747500,2105191342,81359752,1.0983566520000002e-11,17827470,1327812,3423945788
2748000,2125146744,81371992,1.098521892e-11,18225247,1327284,3425273072
2748500,2120439015,81742274,1.103520699e-11,18352247,1329276,3426602348
2749000,2162584236,81369401,1.0984869135e-11,18141052,1327776,3427930124
2749500,2209113158,81373182,1.098537957e-11,18263935,1327784,3429257908
2750000,2238237703,81374508,1.098555858e-11,18307009,1329284,3430587192
2750500,5018264178,81376238,1.098579213e-11,18363247,1328276,3431915468
2751000,8809460938,81809457,1.1044276695e-11,18154225,1328280,3433243748
2751500,14373951429,82141406,1.108908981e-11,18226077,1329272,3434573020
2752000,2110943838,81371180,1.09851093e-11,18198878,1328304,3435901324
2752500,2106569733,81372316,1.098526266e-11,18235785,1328768,3437230092
2753000,2105118569,81371558,1.0985160330000001e-11,18211149,1328268,3438558360
2753500,2111821114,81738220,1.10346597e-11,18220496,1328276,3439886636
2754000,2096328147,81371105,1.0985099175000001e-11,18196427,1327784,3441214420
2754500,2143085503,81369812,1.0984924620000001e-11,18154420,1327304,3442541724
2755000,2101310957,81369221,1.0984844835e-11,18135189,1330180,3443871904
2755500,2095150380,81723472,1.103266872e-11,17741171,1327776,3445199680
2756000,2126948904,81365677,1.0984366395000001e-11,18020010,1328296,3446527976
2756500,2524390068,81365316,1.0984317660000001e-11,18008274,1328784,3447856760
2757000,2244477818,81369103,1.0984828905000001e-11,18131368,1328284,3449185044
2757500,2121886913,81738955,1.1034758925e-11,18244380,1328804,3450513848
2758000,2222438138,81372392,1.0985272920000002e-11,18238260,1327796,3451841644
2758500,2403354237,81372052,1.0985227020000001e-11,18227205,1329160,3453170804
2759000,2251830082,81370451,1.0985010885e-11,18175186,1328796,3454499600
2759500,2244109125,81736210,1.1034388350000001e-11,18155156,1328312,3455827912
2760000,2128953841,81369480,1.09848798e-11,18143428,1328804,3457156716
2760500,2185796879,81373912,1.0985478119999999e-11,18287652,1328312,3458485028
2761000,2152223167,81361085,1.0983746475e-11,17870782,1329304,3459814332
2761500,2434578969,81721475,1.1032399125e-11,17676286,1327804,3461142136
2762000,2372557514,81360338,1.098364563e-11,17846500,1329660,3462471796
2762500,2190203359,81374995,1.0985624325e-11,18322846,1329648,3463801444
2763000,2389303529,81375016,1.0985627160000001e-11,18323524,1328276,3465129720
2763500,2246921847,81742787,1.1035276245e-11,18368904,1328812,3466458532
2764000,11327990012,81818018,1.104543243e-11,18432432,1328812,3467787344
2764500,2115747585,81374306,1.098553131e-11,18300475,1329172,3469116516
2765000,2135398352,81376840,1.0985873400000001e-11,18382800,1329812,3470446328
2765500,2111863777,81375904,1.0985747040000002e-11,18352392,1328804,3471775132
2766000,2111192330,81739007,1.1034765945000001e-11,18246061,1329276,3473104408
2766500,2109826296,81383717,1.0986801795000001e-11,18606326,1327804,3474432212
2767000,2106604793,81387915,1.0987368525000001e-11,18742743,1329680,3475761892
2767500,2103477342,81386934,1.0987236090000002e-11,18710884,1328304,3477090196
2768000,2101822715,81388336,1.098742536e-11,18756426,1327812,3478418008
2768500,2087022895,81755933,1.1037050955000002e-11,18796154,1329304,3479747312
2769000,2094387677,81388843,1.0987493805e-11,18772909,1329188,3481076500
2769500,2133727395,81389395,1.0987568325000002e-11,18790858,1328796,3482405296
2770000,2120377800,81390382,1.098770157e-11,18822942,1329312,3483734608
2770500,2111004912,81757682,1.103728707e-11,18853004,1328304,3485062912
2771000,2174711492,81391660,1.0987874100000001e-11,18864454,1328776,3486391688
2771500,2145390313,81389872,1.098763272e-11,18806366,1328268,3487719956
2772000,2134584942,81392045,1.0987926075000001e-11,18876981,1329284,3489049240
2772500,5022029207,84893806,1.1460663810000002e-11,18588533,1332764,3490382004
2773000,7011915836,95577290,1.2902934150000001e-11,23024505,1329276,3491711280
2773500,6793792514,95937192,1.295152092e-11,22775678,1328276,3493039556
2774000,8816540059,96014890,1.2962010150000002e-11,22990919,1329276,3494368832
2774500,6746510333,95581464,1.2903497640000002e-11,23312778,1328276,3495697108
2775000,4966189690,95577273,1.2902931855e-11,22999665,1328784,3497025892
2775500,2122278114,95951724,1.2953482740000002e-11,23505789,1328268,3498354160
2776000,2127717534,95585505,1.2904043175e-11,23349325,1327812,3499681972
2776500,2117100457,95586674,1.290420099e-11,23394567,1328784,3501010756
2777000,2114368449,95585664,1.2904064640000001e-11,23295366,1327764,3502338520
2777500,2116740003,95591393,1.2904838055e-11,23364464,1329284,3503667804
2778000,2151148742,95586576,1.290418776e-11,23328631,1328784,3504996588
2778500,2080830643,95580265,1.2903335775000001e-11,23268170,1328284,3506324872
2779000,2100338942,95952499,1.2953587365e-11,23341175,1328812,3507653684
2779500,2103374517,95582386,1.290362211e-11,23329484,1329272,3508982956
2780000,2103038929,95577612,1.2902977620000001e-11,23172886,1326780,3510309736
2780500,2103639165,95593880,1.29051738e-11,23571042,1329276,3511639012
2781000,2100761814,95575952,1.2902753520000001e-11,23025672,1329160,3512968172
2781500,2106189430,95941957,1.2952164195e-11,23003216,1329796,3514297968
2782000,2093786397,95564098,1.290115323e-11,22661912,1327812,3515625780
2782500,2096611595,95570522,1.2902020470000001e-11,22844487,1328772,3516954552
2783000,2091801237,95575277,1.2902662395e-11,23048366,1328284,3518282836
2783500,2097101918,95961519,1.2954805065e-11,23548147,1330152,3519612988
2784000,2128892701,88381465,1.1931497775e-11,23466161,37117136,3556730124
2784500,2100840809,87793744,1.185215544e-11,22265298,39652412,3596382536
2785000,4871234898,88406259,1.1934844965e-11,22226562,36654556,3633037092
2785500,6641953706,94392403,1.2742974405e-11,21535807,1328260,3634365352
2786000,11339936643,93784480,1.2660904800000002e-11,21488965,1328804,3635694156
2786500,11379145194,93879654,1.267375329e-11,21470969,1328768,3637022924
2787000,8910495087,93798386,1.2662782110000001e-11,21569509,1328804,3638351728
2787500,8901050741,93710104,1.2650864040000001e-11,21559459,1330160,3639681888
2788000,11292683405,93926801,1.2680118135e-11,21431710,1327784,3641009672
2788500,3357459931,93358969,1.2603460815000001e-11,21264371,1328660,3642338332
2789000,2124396290,93306121,1.2596326335e-11,20889381,1328312,3643666644
2789500,3365853400,93686175,1.2647633625000001e-11,21175949,1327776,3644994420
2790000,3338869058,93339045,1.2600771075e-11,21491620,1327812,3646322232
2790500,2096471484,93338808,1.260073908e-11,21595650,1328304,3647650536
2791000,2092259225,93342839,1.2601283265e-11,21479448,1328812,3648979348
2791500,2092606178,93317891,1.2597915285e-11,21479788,1328812,3650308160
2792000,2088744872,93334976,1.2600221760000002e-11,21590808,1329172,3651637332
2792500,2091746095,93332674,1.259991099e-11,21384877,1328296,3652965628
2793000,2106780956,93321488,1.2598400880000002e-11,21457780,1327812,3654293440
2793500,2089294225,93332481,1.2599884935e-11,21464416,1328796,3655622236
2794000,2103059424,93367150,1.260456525e-11,22379990,1329688,3656951924
2794500,2089546301,93771207,1.2659112945000002e-11,21433873,1328280,3658280204
2795000,2087727647,93333725,1.2600052875e-11,21522134,1329304,3659609508
2795500,2087182154,93341446,1.260109521e-11,21382738,1330520,3660940028
2796000,2079751750,93325302,1.259891577e-11,21112377,1329268,3662269296
2796500,2085762125,85089811,1.1487124485e-11,21626061,-230950508,3431318788
2797000,2084348844,81377216,1.098592416e-11,18395024,1328284,3432647072
2797500,2085752227,81371961,1.0985214735e-11,18224262,1328784,3433975856
2798000,2085454364,81371427,1.0985142645e-11,18206891,1327768,3435303624
2798500,2094594810,81376247,1.0985793345e-11,18363538,1327276,3436630900
2799000,2197150641,81756442,1.103711967e-11,18812684,1327768,3437958668
2799500,2067763116,81388449,1.0987440615000001e-11,18760104,1328768,3439287436
2800000,2177173791,81389390,1.098756765e-11,18790686,1328776,3440616212
2800500,2489358243,81395003,1.0988325405000002e-11,18973112,1328812,3441945024
2801000,2334168265,81751471,1.1036448585e-11,18651149,1328772,3443273796
2801500,2300018742,81389127,1.0987532145e-11,18782130,1328312,3444602108
2802000,2124153301,81386068,1.098711918e-11,18682720,1328312,3445930420
2802500,2224866338,81384959,1.0986969465e-11,18646691,1328680,3447259100
2803000,2382922241,81755337,1.1036970495000001e-11,18776780,1329788,3448588888
2803500,2136045280,81377782,1.098600057e-11,18413441,1329188,3449918076
2804000,2190880220,81375352,1.098567252e-11,18334467,1329180,3451247256
2804500,2096009529,81391374,1.098783549e-11,18855174,1328312,3452575568
2805000,2290929739,81758072,1.1037339720000002e-11,18865660,1328312,3453903880
2805500,2220376431,81390368,1.0987699680000001e-11,18822497,1329180,3455233060
2806000,3483304212,81385341,1.0987021035e-11,18659102,1327276,3456560336
2806500,6630747394,81791975,1.1041916625e-11,18776792,1328304,3457888640
2807000,18081919232,82122007,1.1086470945000001e-11,18786185,1328284,3459216924
2807500,2117368362,81388767,1.0987483544999999e-11,18770437,1328264,3460545188
2808000,2103864518,81387862,1.098736137e-11,18741018,1327804,3461872992
2808500,2091096839,81387863,1.0987361505e-11,18741061,1327784,3463200776
2809000,2094147468,81756888,1.103717988e-11,18827194,1329284,3464530060
2809500,2094063713,81391225,1.0987815375e-11,18850332,1329276,3465859336
2810000,2090830398,81386931,1.0987235685e-11,18710766,1327276,3467186612
2810500,2082236215,81390717,1.0987746795e-11,18833811,1328276,3468514888
2811000,2087356282,81752777,1.1036624895000002e-11,18693595,1330144,3469845032
2811500,2089739015,81375398,1.098567873e-11,18335954,1328312,3471173344
2812000,2083513111,81373543,1.0985428305000001e-11,18275676,1327804,3472501148
2812500,2224136065,81374654,1.098557829e-11,18311777,1329188,3473830336
2813000,2383183916,81392168,1.098794268e-11,18880978,1328804,3475159140
2813500,2162189115,81757351,1.1037242385e-11,18842240,1328304,3476487444
2814000,2712394293,81392067,1.0987929045e-11,18877704,1327812,3477815256
2814500,2151817230,81387030,1.098724905e-11,18714002,1328144,3479143400
2815000,2145038990,81392505,1.0987988175000002e-11,18891934,1328304,3480471704
2815500,2341327900,81392349,1.0987967115e-11,18886870,1328304,3481800008
2816000,2226376475,81390189,1.0987675515000001e-11,18816654,1328284,3483128292
2816500,2121247789,81389012,1.0987516620000001e-11,18778414,1328284,3484456576
2817000,6686019168,81756668,1.1037150180000002e-11,18820047,1328268,3485784844
2817500,9004346444,81389803,1.0987623405e-11,18804100,1328776,3487113620
2818000,18012504296,82526248,1.114104348e-11,18826213,1329268,3488442888
2818500,2110021646,84470101,1.1403463635e-11,19107157,1333756,3489776644
2819000,2114105800,95580939,1.2903426765000002e-11,23155709,1328276,3491104920
2819500,2109891679,95581064,1.290344364e-11,23123744,1327284,3492432204
2820000,2099269778,95579579,1.2903243165e-11,23191081,1328276,3493760480
2820500,2076087114,95994172,1.295921322e-11,23518348,1328784,3495089264
2821000,2106631209,95575093,1.2902637555e-11,23048005,1327812,3496417076
2821500,2097820641,95575151,1.2902645385000001e-11,23036105,1328804,3497745880
2822000,2090209592,95573200,1.2902382000000002e-11,22998130,1327796,3499073676
2822500,2088396815,95578784,1.290313584e-11,23104636,1329784,3500403460
2823000,2086666167,95976389,1.2956812515000001e-11,22923061,1327796,3501731256
2823500,2088724886,95578307,1.2903071445000001e-11,23046687,1327804,3503059060
2824000,2088518410,95573869,1.2902472315e-11,22877596,1327284,3504386344
2824500,2082278567,95573923,1.2902479605e-11,22992229,1328780,3505715124
2825000,2084053926,95577822,1.2903005970000001e-11,23126575,1329284,3507044408
2825500,2086550436,95937433,1.2951553455e-11,22962260,1328312,3508372720
2826000,2087714891,95547706,1.289894031e-11,22205673,1327784,3509700504
2826500,6562921457,95562285,1.2900908475e-11,22546108,1328768,3511029272
2827000,4949073866,95938278,1.295166753e-11,22906825,1328296,3512357568
2827500,6879041548,95935101,1.2951238635000001e-11,22846482,1328188,3513685756
2828000,4996979696,95567992,1.290167892e-11,22761449,1327804,3515013560
2828500,6917723404,95972110,1.295623485e-11,22874302,1327812,3516341372
2829000,7045171435,95943647,1.2952392345000001e-11,23060505,1328780,3517670152
2829500,6879333500,95571876,1.290220326e-11,22927834,1327812,3518997964
2830000,3410313121,91175996,1.2308759460000002e-11,22998537,23075544,3542073508
2830500,11319323080,88419545,1.1936638575e-11,21941826,39660608,3581734116
2831000,3367079733,93512980,1.2624252300000001e-11,21971239,6333476,3588067592
2831500,3328922176,93863860,1.26716211e-11,21094659,1328804,3589396396
2832000,3346510406,93364777,1.2604244895e-11,20954667,1331032,3590727428
2832500,2112551159,93407874,1.261006299e-11,20599067,1328804,3592056232
2833000,3351585901,93361987,1.2603868245000001e-11,20385455,1327804,3593384036
2833500,3326178002,93701283,1.2649673205e-11,21146186,1330152,3594714188
2834000,3327099835,93341893,1.2601155555e-11,21014134,1328304,3596042492
2834500,2090067721,93337492,1.260056142e-11,21193888,1331172,3597373664
2835000,2089718848,93304833,1.2596152455e-11,21039309,1327804,3598701468
2835500,2080662961,93681666,1.2647024910000001e-11,20998946,1327812,3600029280
2836000,2065733498,93332188,1.259984538e-11,20978874,1327812,3601357092
2836500,2087490011,93320639,1.2598286265000001e-11,20937959,1327284,3602684376
2837000,2087693332,93322872,1.259858772e-11,21008599,1328768,3604013144
2837500,2083553011,93305758,1.259627733e-11,21019781,1327276,3605340420
2838000,2088024874,93683488,1.264727088e-11,21038392,1328812,3606669232
2838500,2084594426,93311892,1.259710542e-11,21083678,1329284,3607998516
2839000,2085005820,93324569,1.2598816815000002e-11,21059968,1328780,3609327296
2839500,2084040811,93311984,1.2597117840000001e-11,20793771,1328652,3610655948
2840000,2076179938,93307868,1.259656218e-11,20571251,1328804,3611984752
2840500,6564742188,93664771,1.2644744085e-11,20597937,1328312,3613313064
2841000,6863468180,93708793,1.2650687055e-11,20445514,1329304,3614642368
2841500,8772745656,93680910,1.264692285e-11,20770331,1328804,3615971172
2842000,8743722733,91871237,1.2402616995e-11,21002265,-130486096,3485485076
2842500,2189016437,81371702,1.0985179770000001e-11,18215834,1328284,3486813360
2843000,2313124957,81373372,1.098540522e-11,18270088,1328304,3488141664
2843500,2194614172,81373360,1.09854036e-11,18269706,1328796,3489470460
2844000,4866267909,84818190,1.1450455650000001e-11,18272774,1332408,3490802868
2844500,11264849329,96007110,1.2960959850000001e-11,22883459,1329688,3492132556
2845000,2103168185,95566253,1.2901444155e-11,22650751,1327776,3493460332
2845500,2095356052,95576711,1.2902855985e-11,23016980,1327812,3494788144
2846000,2096665326,95573047,1.2902361345e-11,22953134,1328760,3496116904
2846500,2092085200,95933944,1.2951082440000001e-11,22848931,1328304,3497445208
2847000,2088106858,95558587,1.2900409245000001e-11,22391285,1330564,3498775772
2847500,2064940113,95556895,1.2900180825e-11,22493479,1328804,3500104576
2848000,2102935859,95570528,1.2902021280000001e-11,22824927,1328804,3501433380
2848500,2085246819,95570256,1.2901984560000002e-11,22796934,1329188,3502762568
2849000,2086529795,95941933,1.2952160955000001e-11,22986712,1328788,3504091356
2849500,2084221371,95583705,1.2903800175000001e-11,23064787,1329312,3505420668
2850000,2085135855,95566280,1.2901447800000001e-11,22752663,1328644,3506749312
2850500,2086663628,95579324,1.2903208740000002e-11,23158295,1329812,3508079124
2851000,2083632821,95574402,1.290254427e-11,23091523,1328284,3509407408
2851500,2082992065,95938420,1.29516867e-11,22955901,1329160,3510736568
2852000,2081134900,95574763,1.2902593005000001e-11,22968840,1328276,3512064844
2852500,2083229514,95572718,1.290231693e-11,22946482,1327764,3513392608
2853000,2080337607,95576849,1.2902874615e-11,23062841,1329312,3514721920
2853500,2076672787,95566416,1.290146616e-11,22641539,1330556,3516052476
2854000,2085807988,95937233,1.2951526455e-11,22943875,1328276,3517380752
2854500,2115754518,95582088,1.290358188e-11,23130390,1328796,3518709548
2855000,2081625599,95559178,1.290048903e-11,22536758,1329688,3520039236
2855500,2080177796,92756432,1.252211832e-11,22378917,15328056,3535367292
2856000,4785277443,92062209,1.2428398215e-11,22044629,18600272,3553967564
2856500,8716714852,93418642,1.2611516670000001e-11,21080327,1327312,3555294876
2857000,8791671318,93457180,1.2616719300000002e-11,21112453,1329652,3556624528
2857500,6879672325,93815057,1.2665032695e-11,21072817,1328296,3557952824
2858000,8737520790,93795230,1.2662356050000001e-11,21062284,1328304,3559281128
2858500,8917294914,93333645,1.2600042075000001e-11,21043250,1328304,3560609432
2859000,8738575707,94059527,1.2698036145e-11,20910981,1328652,3561938084
2859500,3352282111,93348418,1.260203643e-11,20979921,1328280,3563266364
2860000,3347783441,93323391,1.2598657785e-11,21081912,1329188,3564595552
2860500,3343508703,93691867,1.2648402045e-11,21293903,1328296,3565923848
2861000,2103251825,93319492,1.259813142e-11,21158506,1328284,3567252132
2861500,2109595178,93318938,1.259805663e-11,21065799,1328804,3568580936
2862000,2094396199,93343853,1.2601420155000001e-11,21519725,1329152,3569910088
2862500,2082662120,93342797,1.2601277595e-11,21535175,1327788,3571237876
2863000,3330642131,93672510,1.2645788850000002e-11,21572202,1328304,3572566180
2863500,2092676176,93347056,1.2601852560000002e-11,21660891,1330180,3573896360
2864000,2090482029,93336461,1.2600422235e-11,21456712,1328304,3575224664
2864500,2094406458,93328607,1.2599361945e-11,21535238,1329304,3576553968
2865000,2085839818,93696322,1.264900347e-11,21584597,1328312,3577882280
2865500,2077995408,93330292,1.259958942e-11,21537381,1328652,3579210932
2866000,2086505780,93348587,1.2602059245e-11,21656788,1328284,3580539216
2866500,2086640941,93328062,1.2599288370000001e-11,21479168,1327812,3581867028
2867000,2109342211,93311670,1.259707545e-11,20639372,1330432,3583197460
2867500,2087931375,86087809,1.1621854215e-11,20603606,-65446428,3517751032
2868000,2087460032,84449512,1.140068412e-11,18438336,1332408,3519083440
2868500,2092807975,95578007,1.2903030945e-11,23023829,1328812,3520412252
2869000,2146894685,95572172,1.290224322e-11,22816776,1328160,3521740412
2869500,2094689520,96005631,1.2960760185000001e-11,22870385,1328304,3523068716
2870000,2089545894,95573477,1.2902419395000001e-11,22960276,1329796,3524398512
2870500,2094272350,95572892,1.290234042e-11,22984711,1329688,3525728200
2871000,2094382705,95576308,1.2902801580000001e-11,23027544,1328284,3527056484
2871500,6884352912,95978449,1.2957090615000002e-11,23096859,1330140,3528386624
2872000,6730393558,95574974,1.290262149e-11,22932906,1328304,3529714928
2872500,6695006176,95572029,1.2902223915000001e-11,22943973,1327784,3531042712
2873000,6681382799,95944839,1.2952553265000001e-11,23043517,1329304,3532372016
2873500,6641556803,95567896,1.290166596e-11,22527014,1330064,3533702080
2874000,6776351512,95563781,1.2901110435e-11,22672669,1328812,3535030892
2874500,6688247964,95941083,1.2952046205e-11,23064833,1328804,3536359696
2875000,6739751399,95569072,1.290182472e-11,22901622,1327288,3537686984
2875500,4858304669,95942342,1.295221617e-11,23080252,1328796,3539015780
2876000,2120511706,95579339,1.2903210765e-11,23135220,1329284,3540345064
2876500,2116344066,95570751,1.2902051385e-11,22811898,1329172,3541674236
2877000,2120950420,95567257,1.2901579695e-11,22768362,1328284,3543002520
2877500,2144626874,95567548,1.290161898e-11,22799105,1328304,3544330824
2878000,2243948019,95567148,1.290156498e-11,22753565,1328280,3545659104
2878500,2149340040,95572260,1.29022551e-11,22844713,1329660,3546988764
2879000,2109632379,95564351,1.2901187385e-11,22685517,1328312,3548317076
2879500,2112485569,94241799,1.2722642865e-11,22775091,8009216,3556326292
2880000,2226301610,90519877,1.2220183395e-11,21858770,25389768,3581716060
2880500,3345004067,93603846,1.263651921e-11,20403333,1326936,3583042996
2881000,3385672821,93884822,1.2674450970000002e-11,20653849,1327784,3584370780
2881500,3358534163,93316250,1.259769375e-11,20539609,1329688,3585700468
2882000,3322139784,93421073,1.2611844855e-11,20773982,1328812,3587029280
2882500,2092335024,93373648,1.260544248e-11,21122050,1329304,3588358584
2883000,2090037662,93737307,1.2654536445e-11,21088186,1328812,3589687396
2883500,2088182938,93329179,1.2599439165000001e-11,21025771,1329160,3591016556
2884000,2088257427,93334109,1.2600104715e-11,20974279,1327312,3592343868
2884500,3318336265,93321093,1.2598347555000001e-11,21178564,1328812,3593672680
2885000,3309241490,93683086,1.2647216610000002e-11,21162905,1328312,3595000992
2885500,3323357559,93326604,1.259909154e-11,21161770,1328304,3596329296
2886000,3321310716,93330808,1.259965908e-11,21253625,1328784,3597658080
2886500,3299964116,93686419,1.2647666565000001e-11,20947937,1329152,3598987232
2887000,3314709783,93313826,1.259736651e-11,20931788,1328284,3600315516
2887500,2085408311,93389201,1.2607542135e-11,20927747,1329672,3601645188
2888000,8648788348,93672894,1.2645840690000001e-11,20527142,1328780,3602973968
2888500,6624831495,93716249,1.2651693615000001e-11,20673414,1328796,3604302764
2889000,6668622406,93300453,1.2595561155e-11,20651253,1329688,3605632452
2889500,8722639390,93684570,1.264741695e-11,21063980,1328784,3606961236
2890000,11401976130,93694817,1.2648800295e-11,21097582,1328812,3608290048
2890500,8840752913,93693002,1.2648555270000002e-11,21193005,1328804,3609618852
2891000,14271540850,93966313,1.2685452255000002e-11,21008101,1328784,3610947636
2891500,2093668183,90119266,1.216610091e-11,21056682,-63249764,3547697872
2892000,2084345394,84476374,1.140431049e-11,18360826,1333264,3549031136
2892500,2088314566,95945575,1.2952652625e-11,23099108,1328280,3550359416
2893000,2084469007,95578466,1.290309291e-11,23023189,1328296,3551687712
2893500,2133981374,95580619,1.2903383565000001e-11,23074732,1330152,3553017864
2894000,2097235721,95575717,1.2902721795000001e-11,23030668,1328804,3554346668
2894500,2086788474,95580248,1.290333348e-11,23230185,1329180,3555675848
2895000,2081157680,95945206,1.2952602810000001e-11,23061869,1328312,3557004160
2895500,2087889747,95605771,1.2906779085000001e-11,23231974,1328304,3558332464
2896000,2086854900,95560000,1.29006e-11,22478242,1328276,3559660740
2896500,2086255043,95551119,1.2899401065000001e-11,22255455,1329188,3560989928
2897000,2083720400,95569842,1.290192867e-11,22749632,1328304,3562318232
2897500,2086160201,95940618,1.2951983430000001e-11,22817310,1328804,3563647036
2898000,2087935165,95571309,1.2902126715e-11,22869516,1328312,3564975348
2898500,2082218531,95573316,1.290239766e-11,22945262,1330664,3566306012
2899000,2085619664,95562793,1.2900977055000002e-11,22636327,1327804,3567633816
2899500,4767047243,95933445,1.2951015075e-11,22835656,1328812,3568962628
2900000,3390238011,95565517,1.2901344795000001e-11,22760290,1327788,3570290416
2900500,4817338729,95941589,1.2952114515000002e-11,22948042,1329652,3571620068
2901000,5342184492,95572735,1.2902319225e-11,22917193,1328784,3572948852
2901500,4838127222,95939366,1.295181441e-11,22991739,1328276,3574277128
2902000,6752963554,95569414,1.2901870890000001e-11,22763174,1329644,3575606772
2902500,4875629134,95923299,1.2949645365000001e-11,22392442,1328784,3576935556
2903000,6676141162,95554941,1.2899917035000001e-11,22377092,1328784,3578264340
2903500,4921455538,95559152,1.2900485519999999e-11,22501993,1326772,3579591112
2904000,11242378941,88311862,1.1922101370000002e-11,22895285,39005672,3618596784
2904500,2108395659,90548736,1.222407936e-11,21535825,28179528,3646776312
2905000,2128679096,93393080,1.26080658e-11,21087556,1328284,3648104596
2905500,3345577486,93800624,1.266308424e-11,21220020,1328784,3649433380
2906000,3325884771,93361460,1.2603797100000002e-11,20996668,1328284,3650761664
2906500,2092587186,93426122,1.2612526470000001e-11,21067661,1329284,3652090948
2907000,2087657267,93370410,1.260500535e-11,20955544,1328284,3653419232
2907500,2086482647,93342274,1.260120699e-11,21079334,1328812,3654748044
2908000,2083662831,93369264,1.2604850640000001e-11,20969060,1328260,3656076304
2908500,2082488132,93323738,1.259870463e-11,21056053,1328280,3657404584
2909000,2086378656,93316457,1.2597721695e-11,21042446,1328812,3658733396
2909500,2080720325,93317720,1.25978922e-11,21126402,1329268,3660062664
2910000,2085868864,93336262,1.260039537e-11,21127363,1328276,3661390940
2910500,2064849340,93316845,1.2597774075e-11,21024739,1328660,3662719600
2911000,2068691379,93306581,1.2596388435e-11,20456205,1328804,3664048404
2911500,2088140972,93291608,1.259436708e-11,20440648,1327284,3665375688
2912000,2082292807,93293082,1.259456607e-11,20528937,1329312,3666705000
2912500,2087326186,93689909,1.2648137715e-11,21059539,1329180,3668034180
2913000,2079548506,93321633,1.2598420455e-11,20940766,1328304,3669362484
2913500,2086907045,93317267,1.2597831045e-11,21010663,1327284,3670689768
2914000,2091063509,93303299,1.2595945365000002e-11,20901111,1327276,3672017044
2914500,3320193711,93907053,1.2677452155000001e-11,21012659,1327776,3673344820
2915000,2084595304,93405256,1.2609709560000002e-11,21017129,1328276,3674673096
2915500,2085391776,93318708,1.259802558e-11,21169170,1328276,3676001372
2916000,2095443491,93314881,1.2597508935e-11,21016253,1327312,3677328684
2916500,2060465063,81952384,1.1063571840000001e-11,21061147,-98512012,3578816672
2917000,3324192479,84507473,1.1408508855000001e-11,18421125,1334276,3580150948
2917500,3306829870,95574196,1.290251646e-11,22910683,1328784,3581479732
2918000,4808056160,95975667,1.2956715045e-11,22759895,1329688,3582809420
2918500,4915010204,95553784,1.2899760840000002e-11,22287561,1327304,3584136724
2919000,5308213972,95937560,1.2951570600000001e-11,22894327,1329160,3585465884
2919500,6880633461,95572962,1.290234987e-11,22948088,1328304,3586794188
2920000,5017995251,95937941,1.2951622035000001e-11,22887115,1328288,3588122476
2920500,4983239834,95602735,1.2906369225000001e-11,23050883,1329312,3589451788
2921000,11253166262,96230201,1.2991077135e-11,22884553,1328312,3590780100
2921500,2116318296,95569852,1.290193002e-11,22889177,1328296,3592108396
2922000,2099660578,95573291,1.2902394285e-11,22858916,1327304,3593435700
2922500,2101893669,95575938,1.290275163e-11,22936328,1329172,3594764872
2923000,2095178607,95938001,1.2951630135e-11,22795957,1327812,3596092684
2923500,2093571535,95570009,1.2901951215000002e-11,22902304,1329296,3597421980
2924000,2094450040,95571710,1.290218085e-11,22883626,1329672,3598751652
2924500,2095195983,95569417,1.2901871295e-11,22947770,1328312,3600079964
2925000,2093102483,95562893,1.2900990555000002e-11,22595596,1330036,3601410000
2925500,2087749676,95930459,1.2950611965000002e-11,22613136,1329812,3602739812
2926000,2082662145,95569040,1.29018204e-11,22762158,1328284,3604068096
2926500,2090158373,95556955,1.2900188925e-11,22475272,1328776,3605396872
2927000,2088280034,95552534,1.289959209e-11,22213215,1329272,3606726144
2927500,2084444461,95544924,1.2898564740000001e-11,22068213,1326768,3608052912
2928000,2081488771,95924400,1.2949794e-11,22447906,1329768,3609382680
2928500,2082383397,95570818,1.2902060430000001e-11,22838481,1328276,3610710956
2929000,2085328944,89407756,1.207004706e-11,22905571,31391372,3642102328
2929500,2084107482,89084330,1.2026384550000001e-11,21756513,33691532,3675793860
2930000,2082952168,93980528,1.268737128e-11,20941529,1328768,3677122628
2930500,2088028118,93412020,1.2610622700000001e-11,21105960,1328284,3678450912
2931000,2077710024,93772327,1.2659264145000002e-11,20862305,1329312,3679780224
2931500,2084313690,93383676,1.2606796260000002e-11,20883845,1328296,3681108520
2932000,2092258243,93413355,1.2610802925e-11,20873859,1329284,3682437804
2932500,2083586600,93321779,1.2598440165000001e-11,20841178,1328812,3683766616
2933000,2105611534,93701469,1.2649698315000001e-11,20832408,1328776,3685095392
2933500,2094771530,93330878,1.259966853e-11,20734108,1329156,3686424548
2934000,2076676568,93306888,1.259642988e-11,20465182,1328784,3687753332
2934500,2077443242,93294997,1.2594824595000002e-11,20316407,1328804,3689082136
2935000,2083109370,93328587,1.2599359245e-11,20356185,1329276,3690411412
2935500,2075247693,93298265,1.2595265775e-11,20588001,1328312,3691739724
2936000,2085399903,93727825,1.2653256375000001e-11,20922260,1328268,3693067992
2936500,2085797821,93302191,1.2595795785e-11,20966287,1328284,3694396276
2937000,2086073122,93562664,1.2630959640000001e-11,20934459,1327784,3695724060
2937500,2083879819,93317555,1.2597869925000001e-11,21003067,1328784,3697052844
2938000,2086655722,93324324,1.2598783740000001e-11,21018085,1329260,3698382104
2938500,2081747197,93687290,1.2647784150000002e-11,20948865,1328312,3699710416
2939000,8877281514,93678338,1.2646575630000001e-11,20926507,1328268,3701038684
2939500,6789352205,93299038,1.259537013e-11,20973403,1328284,3702366968
2940000,8892704719,93781767,1.2660538545e-11,21030273,1329776,3703696744
2940500,8833734629,93732290,1.265385915e-11,21039296,1328304,3705025048
2941000,6694214773,93706045,1.2650316075e-11,20867155,1328276,3706353324
2941500,5002306679,85624895,1.1559360825000002e-11,20881308,-97137676,3609215648
2942000,9028779750,84527293,1.1411184555000001e-11,18114748,1333264,3610548912
2942500,3360658516,96023718,1.296320193e-11,22075925,1327804,3611876716
2943000,2114591158,95555181,1.2899949435e-11,22249017,1328284,3613205000
2943500,2083623035,95569042,1.290182067e-11,22715453,1328280,3614533280
2944000,2084275158,95933157,1.2950976195000001e-11,22768068,1328804,3615862084
2944500,2104909194,95569947,1.2901942845e-11,22831707,1328752,3617190836
2945000,2093792035,95573527,1.2902426145e-11,22943281,1329312,3618520148
2945500,2093074666,95567745,1.2901645575e-11,22825242,1328312,3619848460
2946000,2091790313,95927943,1.2950272305e-11,22615596,1327780,3621176240
2946500,2083810854,95566160,1.29014316e-11,22743117,1328284,3622504524
2947000,2090472530,95564809,1.2901249215e-11,22611651,1328304,3623832828
2947500,2085739989,95596684,1.290555234e-11,22692860,1328284,3625161112
2948000,2084638442,95578352,1.2903077519999999e-11,22934193,1330180,3626491292
2948500,2082236677,95933089,1.2950967015e-11,22744177,1329260,3627820552
2949000,2078627317,95561696,1.290082896e-11,22616513,1328304,3629148856
2949500,2121269093,95558682,1.2900422070000001e-11,22581588,1327784,3630476640
2950000,2080348788,95565579,1.2901353165e-11,22771651,1328688,3631805328
2950500,2085940490,95567831,1.2901657185000001e-11,22732565,1328812,3633134140
2951000,2089091580,95936835,1.2951472725000002e-11,22828083,1328784,3634462924
2951500,2085218063,95563944,1.2901132440000002e-11,22681595,1328304,3635791228
2952000,2085192185,95582544,1.290364344e-11,23233135,1328304,3637119532
2952500,2082453886,95585424,1.2904032240000002e-11,23312398,1330188,3638449720
2953000,2071136608,95583416,1.2903761160000001e-11,23269933,1328260,3639777980
2953500,4775242537,95951943,1.2953512305e-11,23354765,1328804,3641106784
2954000,3327525784,91048427,1.2291537645000001e-11,23348368,23761388,3664868172
2954500,6604072715,88635360,1.19657736e-11,22290402,39430076,3704298248
2955000,11414801579,93881498,1.2674002230000002e-11,22240822,5413912,3709712160
2955500,11487771410,93801632,1.266322032e-11,21440986,1327812,3711039972
2956000,8840946739,93814763,1.2664993005e-11,21235723,1328284,3712368256
2956500,6606782663,93366768,1.260451368e-11,21362891,1328804,3713697060
2957000,3377482088,93873021,1.2672857834999999e-11,21933045,1331064,3715028124
2957500,3363591563,93348337,1.2602025495e-11,21357864,1328812,3716356936
2958000,3332445946,93349198,1.2602141730000002e-11,21337487,1328312,3717685248
2958500,2092067881,93353236,1.260268686e-11,21498128,1329680,3719014928
2959000,2089848892,93335927,1.2600350144999999e-11,21396830,1328812,3720343740
2959500,2089144414,93327770,1.259924895e-11,21372968,1327812,3721671552
2960000,2094458952,93347263,1.2601880505000002e-11,21434459,1328804,3723000356
2960500,2084480892,93349864,1.2602231640000001e-11,21348721,1327804,3724328160
2961000,2101296497,93726206,1.265303781e-11,21300146,1326780,3725654940
2961500,2086717752,93340696,1.260099396e-11,21422119,1329268,3726984208
2962000,2085881801,93312848,1.2597234480000001e-11,21373962,1327776,3728311984
2962500,2087155867,93324882,1.2598859070000002e-11,21419935,1328772,3729640756
2963000,2089072734,93337321,1.2600538335000001e-11,21540206,1328812,3730969568
2963500,2088195392,93337889,1.2600615015e-11,21476758,1328284,3732297852
2964000,2083694028,93700847,1.2649614345000002e-11,21530712,1328304,3733626156
2964500,3315455530,93362196,1.2603896460000002e-11,21451107,1329280,3734955436
2965000,3313484542,93338793,1.2600737055000001e-11,21543921,1329804,3736285240
2965500,3301266850,94213538,1.271882763e-11,21508812,1330152,3737615392
2966000,3316845325,93312625,1.2597204375e-11,21012984,1328304,3738943696
2966500,2085295028,91203865,1.2312521775e-11,21417531,-99333752,3639609944
2967000,2084782515,84575127,1.1417642145000002e-11,18718948,1331908,3640941852
2967500,2080662208,95953548,1.2953728980000001e-11,23366478,1327804,3642269656
2968000,2087033218,95581076,1.2903445260000002e-11,23147095,1326812,3643596468
2968500,2081523877,95584005,1.2903840675e-11,23236431,1328188,3644924656
2969000,2086133785,95580786,1.290340611e-11,23131450,1328288,3646252944
2969500,2082299984,95952220,1.29535497e-11,23354584,1328804,3647581748
2970000,2083762886,95580248,1.290333348e-11,23281310,1327812,3648909560
2970500,2093845107,95596187,1.2905485245e-11,23603199,1330288,3650239848
2971000,2084731653,95580622,1.2903383970000002e-11,23290109,1328284,3651568132
2971500,2084263796,95578413,1.2903085755000001e-11,23087418,1328312,3652896444
2972000,2165592902,95951247,1.2953418345e-11,23290604,1329160,3654225604
2972500,4762500289,95580644,1.2903386940000001e-11,23102193,1329680,3655555284
2973000,3449101141,95966090,1.2955422150000002e-11,22701638,1328304,3656883588
2973500,4848763045,95574884,1.290260934e-11,23010190,1328796,3658212384
2974000,4946328205,95952345,1.2953566575000001e-11,23366196,1330188,3659542572
2974500,6699394886,95570818,1.2902060430000001e-11,23000390,1327304,3660869876
2975000,6843220912,95984286,1.2957878610000001e-11,23267823,1328812,3662198688
2975500,6722371691,95591360,1.29048336e-11,23498200,1328312,3663527000
2976000,6840692240,95587918,1.290436893e-11,23400036,1328784,3664855784
2976500,11333732536,96169961,1.2982944735e-11,23316591,1329276,3666185060
2977000,2118247639,95586055,1.2904117425000001e-11,23317781,1328284,3667513344
2977500,2105175237,95589983,1.2904647705e-11,23518223,1329784,3668843128
2978000,2103989349,95588229,1.2904410915000002e-11,23350127,1328284,3670171412
2978500,2096258362,95952798,1.295362773e-11,23419611,1329276,3671500688
2979000,2094286992,92586261,1.2499145235000002e-11,23376541,16136428,3687637116
2979500,2092782625,88037578,1.188507303e-11,22277583,39533368,3727170484
2980000,2087430632,93191891,1.2580905285e-11,22315756,10005076,3737175560
2980500,2086980813,93396616,1.2608543160000001e-11,21594441,1330660,3738506220
2981000,2084388667,93432300,1.2613360500000002e-11,21341238,1328784,3739835004
2981500,2083731375,93340822,1.2601010970000002e-11,21326601,1328276,3741163280
2982000,2084975152,93474335,1.2619035225e-11,21324634,1328268,3742491548
2982500,2086967370,93353723,1.2602752605e-11,21437612,1328276,3743819824
2983000,2083173741,93350022,1.260225297e-11,21404319,1327776,3745147600
2983500,2064959424,93714153,1.2651410655000001e-11,21597546,1328768,3746476368
2984000,2097029367,93350095,1.2602262825e-11,21503165,1329276,3747805644
2984500,2085776769,93332075,1.2599830125e-11,21580337,1328772,3749134416
2985000,2087383943,93341978,1.2601167030000001e-11,21535710,1328276,3750462692
2985500,2088289360,93330240,1.2599582400000002e-11,21617188,1327776,3751790468
2986000,2087634810,93687032,1.264774932e-11,20972352,1328304,3753118772
2986500,2086536422,93323160,1.2598626600000001e-11,21009585,1328804,3754447576
2987000,2084420398,93304132,1.259605782e-11,21016546,1328812,3755776388
2987500,3310875796,93396631,1.2608545185000001e-11,21128455,1329688,3757106076
2988000,6564117879,93732008,1.2653821079999999e-11,21204615,1328280,3758434356
2988500,6661928097,93759231,1.2657496185e-11,21378553,1328688,3759763044
2989000,8727119395,93324364,1.259878914e-11,21177068,1328812,3761091856
2989500,8840459015,93690675,1.2648241125e-11,21021464,1328304,3762420160
2990000,6774740866,93685759,1.2647577465e-11,21033304,1327812,3763747972
2990500,6962744389,93756301,1.2657100635e-11,21255960,1329664,3765077636
2991000,4835694742,93889168,1.267503768e-11,20931356,1329272,3766406908
2991500,3353442784,93302137,1.2595788495000001e-11,20912650,1328780,3767735688
2992000,2122220167,83183880,1.1229823800000001e-11,21312719,-96401364,3671334324
2992500,2078775244,84971121,1.1471101335e-11,18731046,1331908,3672666232
2993000,2098756403,95582899,1.2903691365000001e-11,23199677,1328312,3673994544
2993500,2092214087,95590325,1.2904693875000001e-11,23391359,1328812,3675323356
2994000,2092561232,95592667,1.2905010045e-11,23422081,1330180,3676653536
2994500,2090923087,95589320,1.29045582e-11,23382976,1328296,3677981832
2995000,2092520029,95947853,1.2952960155e-11,23252261,1328812,3679310644
2995500,2086930657,95582871,1.2903687585e-11,23312102,1329652,3680640296
2996000,2085222507,95583248,1.290373848e-11,23215088,1329632,3681969928
2996500,2080101600,95580588,1.2903379380000002e-11,23296227,1328776,3683298704
2997000,2088271557,95952300,1.29535605e-11,23246705,1330160,3684628864
2997500,2080784199,95566833,1.2901522455e-11,22723398,1329276,3685958140
2998000,2079665337,95566033,1.2901414455000001e-11,22676005,1328284,3687286424
2998500,2098139045,95575608,1.2902707080000001e-11,22823076,1328276,3688614700
2999000,2086546748,95581196,1.290346146e-11,23291299,1327784,3689942484
2999500,2087216841,95934609,1.2951172215e-11,22853067,1328284,3691270768
3000000,2084496621,95607574,1.290702249e-11,23181366,1328276,3692599044
3000500,2079678451,95586253,1.2904144155000001e-11,23387773,1329312,3693928356
3001000,4773543042,95583132,1.290372282e-11,23282814,1328284,3695256640
3001500,4820504166,95952210,1.2953548350000001e-11,23289507,1329788,3696586428
3002000,3479276545,95582923,1.2903694605e-11,23271657,1328312,3697914740
3002500,4837261858,95955508,1.2953993580000002e-11,23488347,1328284,3699243024
3003000,4833057255,95586728,1.290420828e-11,23336420,1330660,3700573684
3003500,5002849815,95956495,1.2954126825e-11,23438032,1328804,3701902488
3004000,6762198398,95948185,1.2953004975000001e-11,23234440,1328812,3703231300
3004500,6649493362,94133707,1.2708050445000001e-11,23305796,8396776,3711628076
3005000,3482947765,87731298,1.184372523e-11,21701536,39655412,3751283488
3005500,8715775212,92909358,1.254276333e-11,22100638,19151336,3770434824
3006000,3338463206,93403394,1.2609458190000002e-11,21529233,1329776,3771764600
3006500,3331822203,93429641,1.2613001535000002e-11,21369374,1329172,3773093772
3007000,2107131930,93707840,1.26505584e-11,21447526,1329288,3774423060
3007500,2090542959,93456094,1.2616572690000002e-11,21393424,1328796,3775751856
3008000,2090049600,93387572,1.260732222e-11,21489325,1329688,3777081544
3008500,2084500042,93351516,1.260245466e-11,21367964,1328812,3778410356
3009000,2084327049,93352465,1.2602582775e-11,21480682,1327780,3779738136
3009500,2078000633,93704812,1.2650149620000001e-11,21435173,1329296,3781067432
3010000,2082200682,93329042,1.2599420670000001e-11,21443419,1329180,3782396612
3010500,2078391808,93331120,1.2599701200000001e-11,21574605,1329276,3783725888
3011000,2083802023,93348104,1.2601994040000002e-11,21503103,1328276,3785054164
3011500,2081462080,93320926,1.2598325010000001e-11,21091746,1330056,3786384220
3012000,2081673238,93702096,1.264978296e-11,21391074,1328812,3787713032
3012500,2084298705,93318739,1.2598029765e-11,21307422,1328304,3789041336
3013000,2122720413,93358796,1.2603437460000002e-11,21259277,1328788,3790370124
3013500,2094410224,93319424,1.259812224e-11,20879395,1328312,3791698436
3014000,2082799746,93323395,1.2598658325e-11,21396102,1329652,3793028088
3014500,2079484701,93729439,1.2653474265000001e-11,21358605,1328804,3794356892
3015000,2083329688,93338499,1.2600697365e-11,21475995,1328312,3795685204
3015500,2084101739,93339373,1.2600815355000001e-11,21612785,1327312,3797012516
3016000,3314777293,93465629,1.2617859914999999e-11,21453696,1328784,3798341300
3016500,2085608746,94219138,1.2719583630000002e-11,21504143,1330180,3799671480
3017000,2081807608,93333113,1.2599970255000001e-11,21377135,1327784,3800999264
3017500,2076960485,88483960,1.1945334600000001e-11,21330309,-98666408,3702332856
3018000,2089023724,84635411,1.1425780485e-11,18777230,1331916,3703664772
3018500,2097523857,95943476,1.295236926e-11,22975068,1329188,3704993960
3019000,2068498079,95583244,1.2903737940000002e-11,23205477,1329652,3706323612
3019500,2071874168,95573046,1.2902361210000001e-11,22818651,1328812,3707652424
3020000,2077251376,95574257,1.2902524695e-11,22908532,1328812,3708981236
3020500,2085669701,95573043,1.2902360805000001e-11,22904289,1330180,3710311416
3021000,2084285607,95950166,1.2953272410000001e-11,23382784,1327776,3711639192
3021500,2084500268,95585971,1.2904106085000001e-11,23302296,1328296,3712967488
3022000,4794291793,95583612,1.290378762e-11,23418040,1329660,3714297148
3022500,3329333319,95953332,1.295369982e-11,23356096,1328304,3715625452
3023000,3339260004,95582272,1.2903606720000001e-11,23289849,1328312,3716953764
3023500,5015024525,95591956,1.290491406e-11,23414082,1330188,3718283952
3024000,5069419861,95952341,1.2953566035e-11,23211558,1328288,3719612240
3024500,4828750587,95952069,1.2953529315e-11,23355897,1327768,3720940008
3025000,6677136638,95577188,1.2902920380000002e-11,23104268,1329680,3722269688
3025500,4875536432,95602036,1.290627486e-11,22943398,1328652,3723598340
3026000,11246624349,96353026,1.3007658510000002e-11,23405259,1327784,3724926124
3026500,2099499702,95584400,1.2903894000000001e-11,23356664,1328304,3726254428
3027000,2097699013,95585720,1.29040722e-11,23288294,1329672,3727584100
3027500,2091797777,95588089,1.2904392015000002e-11,23398223,1329276,3728913376
3028000,2101896378,95951623,1.2953469105e-11,23371656,1328812,3730242188
3028500,2102331612,95584756,1.2903942060000001e-11,23296163,1328680,3731570868
3029000,2110933573,95585464,1.290403764e-11,23320575,1328796,3732899664
3029500,2093033063,95584211,1.2903868485e-11,23344851,1328304,3734227968
3030000,2086234069,95590990,1.290478365e-11,23440994,1329680,3735557648
3030500,2086202952,88336553,1.1925434655e-11,23481568,38912960,3774470608
3031000,2077528969,91074883,1.2295109205000001e-11,22347884,26970976,3801441584
3031500,2084640006,93439594,1.261434519e-11,21212802,1330536,3802772120
3032000,2085440547,93408860,1.26101961e-11,20990360,1327304,3804099424
3032500,2084732034,93355511,1.2602993985e-11,21501352,1328776,3805428200
3033000,2086077329,93419358,1.261161333e-11,21460983,1328804,3806757004
3033500,2082682778,93790555,1.2661724925e-11,21490272,1327796,3808084800
3034000,2090732703,93352727,1.2602618145000001e-11,21438439,1329148,3809413948
3034500,2088103984,93336092,1.2600372420000002e-11,21449518,1328304,3810742252
3035000,2123041662,93360397,1.2603653595000001e-11,21545758,1328304,3812070556
3035500,2084642890,93702935,1.2649896225e-11,21646607,1328312,3813398868
3036000,2086014984,93317423,1.2597852105000001e-11,21584155,1328268,3814727136
3036500,2080113047,93345432,1.260163332e-11,21461113,1330180,3816057316
3037000,2079153977,93335678,1.260031653e-11,21409852,1328784,3817386100
3037500,4826482721,93737881,1.2654613935000001e-11,21393490,1328304,3818714404
3038000,4819675807,93323638,1.259869113e-11,21490299,1328804,3820043208
3038500,4887472130,93336912,1.260048312e-11,21311357,1330180,3821373388
3039000,6602845637,93319208,1.2598093080000002e-11,21151897,1330144,3822703532
3039500,8846391171,93731059,1.2653692965e-11,21379753,1328804,3824032336
3040000,8852359924,93773377,1.2659405895000001e-11,21510040,1328276,3825360612
3040500,11234809660,93704390,1.2650092650000001e-11,21594591,1328804,3826689416
3041000,2103299509,93326948,1.2599137980000001e-11,21615996,1328784,3828018200
3041500,2089069365,93355580,1.2603003299999999e-11,21489431,1329688,3829347888
3042000,3324013610,94073976,1.269998676e-11,21347180,1327812,3830675700
3042500,2069849841,93507947,1.2623572845000002e-11,21487623,1328760,3832004460
3043000,2081429381,93389858,1.260763083e-11,21448859,-96474512,3735529948
3043500,2090286528,84663145,1.1429524575e-11,18728071,1333756,3736863704
3044000,2099799867,95578949,1.2903158114999999e-11,23086738,1328276,3738191980
3044500,2087514682,95950747,1.2953350845e-11,23255300,1327812,3739519792
3045000,2085530725,95586175,1.2904133625e-11,23296141,1328804,3740848596
3045500,2087869307,95564135,1.2901158225e-11,22537215,1330432,3742179028
3046000,2086529639,95559813,1.2900574755e-11,22532853,1328784,3743507812
3046500,2082127392,95555021,1.2899927835e-11,22339888,1329152,3744836964
3047000,2084926268,95930343,1.2950596305000001e-11,22659802,1327788,3746164752
3047500,2071443123,95565500,1.29013425e-11,22823011,1328304,3747493056
3048000,2121078081,95568896,1.290180096e-11,22807632,1328812,3748821868
3048500,2087639958,95569524,1.290188574e-11,22875372,1328296,3750150164
3049000,2088421223,95572799,1.2902327865000001e-11,22774099,1329672,3751479836
3049500,2082376674,95938951,1.2951758385e-11,22834610,1328812,3752808648
3050000,2078403971,95570983,1.2902082705e-11,22767907,1327780,3754136428
3050500,2078998624,95571465,1.2902147775e-11,22968610,1328804,3755465232
3051000,2085790315,95557844,1.2900308940000001e-11,22437112,1329652,3756794884
3051500,2085088499,95551896,1.2899505960000001e-11,22370571,1328804,3758123688
3052000,2084468883,95964549,1.2955214115000002e-11,22817026,1328804,3759452492
3052500,2075955183,95573059,1.2902362965000002e-11,22970283,1327804,3760780296
3053000,2085707241,95574978,1.2902622030000001e-11,22933473,1329160,3762109456
3053500,2087225733,95564182,1.2901164570000002e-11,22728222,1328276,3763437732
3054000,2109905686,95571555,1.2902159924999999e-11,22827848,1329288,3764767020
3054500,4833233553,95572060,1.29022281e-11,22906579,1327788,3766094808
3055000,5090630910,95935034,1.295122959e-11,22842817,1328304,3767423112
3055500,4862013970,95582124,1.2903586740000002e-11,23156073,1330152,3768753264
3056000,5107478251,89492370,1.208146995e-11,22873279,31124512,3799877776
3056500,4891922891,89217273,1.2044331855e-11,21886450,38450720,3838328496
3057000,6681211458,93646121,1.2642226335e-11,20450219,1328776,3839657272
3057500,6692880377,93377855,1.2606010425e-11,20550242,1328812,3840986084
3058000,5119849071,93375779,1.2605730165e-11,20575233,1329652,3842315736
3058500,3355326951,93831561,1.2667260735e-11,20452739,1328312,3843644048
3059000,3349151044,93428706,1.2612875310000001e-11,20572800,1328304,3844972352
3059500,3329269110,93311112,1.2597000120000002e-11,20463299,1326312,3846298664
3060000,2092005256,93715169,1.2651547815000001e-11,20594610,1328796,3847627460
3060500,2087190238,93343772,1.2601409219999999e-11,20635378,1330160,3848957620
3061000,2086891943,93324996,1.259887446e-11,21057530,1328784,3850286404
3061500,2081623564,93311336,1.259703036e-11,20964316,1329160,3851615564
3062000,2084849596,93328570,1.259935695e-11,21501911,1328804,3852944368
3062500,2085066853,93703745,1.2650005575e-11,21532463,1328804,3854273172
3063000,2085238223,93343640,1.26013914e-11,21529960,1327812,3855600984
3063500,2080922640,93361405,1.2603789675e-11,21529777,1329180,3856930164
3064000,2086774356,93317588,1.259787438e-11,21480216,1327284,3858257448
3064500,2080539653,93340346,1.260094671e-11,21493135,1328280,3859585728
3065000,2087561034,93706033,1.2650314455000002e-11,21548628,1328304,3860914032
3065500,2087774318,93339291,1.2600804285e-11,21536070,1327304,3862241336
3066000,2063318947,93332694,1.2599913690000001e-11,21474780,1328276,3863569612
3066500,2067837705,93320539,1.2598272765000001e-11,21468797,1329152,3864898764
3067000,2077613024,93709983,1.2650847705000001e-11,21311496,1328284,3866227048
3067500,3320664625,93488420,1.26209367e-11,21290483,1329160,3867556208
3068000,2085322518,93776407,1.2659814945e-11,20882149,1328268,3868884476
3068500,2084717565,93304100,1.25960535e-11,20914196,1327812,3870212288
3069000,2087519059,87893885,1.1865674475000002e-11,21421959,-98772752,3771439536
3069500,2086817288,84677316,1.143143766e-11,18238242,1332888,3772772424
3070000,2080355099,95582833,1.2903682455000001e-11,23219947,1327784,3774100208
3070500,2086334570,95586831,1.2904222185e-11,23314824,1328304,3775428512
3071000,2077340108,95592306,1.290496131e-11,23521215,1329784,3776758296
3071500,3289364645,95583628,1.2903789780000001e-11,23131889,1330188,3778088484
3072000,3286237299,95583680,1.29037968e-11,23308764,1328812,3779417296
3072500,3373547073,95579219,1.2903194565e-11,23162190,1327812,3780745108
3073000,3401017180,95949199,1.2953141865000002e-11,23251810,1329660,3782074768
3073500,4827318862,95583135,1.2903723225e-11,23295499,1328796,3783403564
3074000,4822280537,95580318,1.290334293e-11,23195391,1328804,3784732368
3074500,6625341644,95575258,1.2902659830000002e-11,22992210,1329664,3786062032
3075000,4947296346,95935819,1.2951335565000001e-11,22744636,1329644,3787391676
3075500,4823723351,95572071,1.2902229585000002e-11,22830894,1328276,3788719952
3076000,2131004579,95620343,1.2908746305e-11,24354758,1328276,3790048228
3076500,2105128745,95953709,1.2953750715000001e-11,23395105,1330152,3791378380
3077000,2109532041,95583354,1.290375279e-11,23332366,1328284,3792706664
3077500,2103761319,95578380,1.2903081300000002e-11,23204898,1328304,3794034968
3078000,2102765293,95582958,1.290369933e-11,23351033,1327812,3795362780
3078500,2099681230,95957697,1.2954289095e-11,23452390,1330144,3796692924
3079000,2095082647,95579906,1.2903287310000001e-11,23166578,1328276,3798021200
3079500,2090893284,95583549,1.2903779115e-11,23299416,1328812,3799350012
3080000,2083756971,95585149,1.2903995114999999e-11,23301023,1328304,3800678316
3080500,2087810102,95588417,1.2904436295e-11,23410785,1330688,3802009004
3081000,2090119607,95948103,1.2952993905e-11,23197753,1329144,3803338148
3081500,2087916549,95571842,1.290219867e-11,22872587,1329660,3804667808
3082000,2067029077,91078478,1.2295594530000001e-11,23201139,23219232,3827887040
3082500,2063802993,88458031,1.1941834185e-11,22301500,39353504,3867240544
3083000,2090696766,93559698,1.263055923e-11,22399398,5838868,3873079412
3083500,2086079366,93764153,1.2658160655000001e-11,21679539,1330152,3874409564
3084000,2081032666,93405406,1.260972981e-11,21487779,1328312,3875737876
3084500,2084789242,93386306,1.260715131e-11,21557414,1328304,3877066180
3085000,2088175074,93463949,1.2617633114999999e-11,21526931,1329312,3878395492
3085500,2086787544,93371945,1.2605212575e-11,21671030,1328660,3879724152
3086000,2084844224,93711073,1.2650994855e-11,21603219,1328768,3881052920
3086500,2085895678,93362575,1.2603947625e-11,21527343,1329624,3882382544
3087000,2095334757,93325900,1.2598996500000001e-11,21373729,1327776,3883710320
3087500,2170796193,93329130,1.259943255e-11,21405130,1329188,3885039508
3088000,6577149388,93707892,1.265056542e-11,21230300,1328272,3886367780
3088500,6654984547,93326676,1.259910126e-11,21529592,1328812,3887696592
3089000,8912760506,93345301,1.2601615635000001e-11,21557894,1329648,3889026240
3089500,6744165907,93700220,1.2649529700000001e-11,21504447,1328312,3890354552
3090000,8927908528,93711387,1.2651037245e-11,21484374,1328304,3891682856
3090500,8780049112,93349342,1.260216117e-11,21611841,1328312,3893011168
3091000,11255161991,94122023,1.2706473105e-11,21753795,1329284,3894340452
3091500,3337491408,93330953,1.2599678655e-11,21470622,1329160,3895669612
3092000,3334206576,93687650,1.2647832749999999e-11,21332980,1327796,3896997408
3092500,2086953687,93342173,1.2601193355000001e-11,21607297,1328772,3898326180
3093000,2088303212,93343272,1.260134172e-11,21578445,1329296,3899655476
3093500,2081028700,93323533,1.2598676955e-11,21561332,1328304,3900983780
3094000,3315558211,93825274,1.266641199e-11,21495853,1329660,3902313440
3094500,2095156640,93320678,1.2598291530000002e-11,21281789,1329160,3903642600
3095000,2084182365,92201666,1.2447224910000002e-11,21286671,-97137796,3806504804
3095500,2081031625,84725163,1.1437897005e-11,18842738,1331408,3807836212
3096000,2079473849,95572941,1.2902347035e-11,22875383,1328784,3809164996
3096500,2083387328,95941324,1.295207874e-11,22808037,1329188,3810494184
3097000,2085879732,95571650,1.2902172750000001e-11,22925300,1328812,3811822996
3097500,2080100747,95591110,1.290479985e-11,23409676,1329304,3813152300
3098000,2072785596,95580970,1.2903430950000002e-11,23161781,1327812,3814480112
3098500,2084421648,95586203,1.2904137404999999e-11,23340999,1330152,3815810264
3099000,2071181238,95948994,1.2953114190000001e-11,23237927,1328304,3817138568
3099500,2084065139,95583166,1.290372741e-11,23267438,1327804,3818466372
3100000,2083539558,95579038,1.290317013e-11,23210936,1328812,3819795184
3100500,2064303625,95585050,1.290398175e-11,23304516,1328652,3821123836
3101000,2084420624,95595014,1.2905326890000001e-11,23582182,1330036,3822453872
3101500,2084075131,95932451,1.2950880885000001e-11,22610437,1327812,3823781684
3102000,2086100371,95575247,1.2902658345e-11,22836383,1327804,3825109488
3102500,2076363311,95616131,1.2908177685e-11,23395211,1329304,3826438792
3103000,2085700640,95577564,1.290297114e-11,23170020,1327812,3827766604
3103500,2078887304,95950896,1.295337096e-11,23303555,1328688,3829095292
3104000,2086316079,95583085,1.2903716475e-11,23310276,1329296,3830424588
3104500,2084222484,95585843,1.2904088805000002e-11,23316454,1328804,3831753392
3105000,2077627076,95591003,1.2904785405e-11,23463860,1330152,3833083544
3105500,4871145767,95956819,1.2954170565000001e-11,23392158,1329812,3834413356
3106000,3358459533,95589138,1.2904533630000001e-11,23439798,1328276,3835741632
3106500,3350291620,95584794,1.2903947190000001e-11,23353829,1329680,3837071312
3107000,4935472548,95586695,1.2904203825e-11,23302680,1328284,3838399596
3107500,6669928807,95583135,1.2903723225e-11,23352906,1328304,3839727900
3108000,4940556521,93082851,1.2566184885000002e-11,23110439,15281816,3855009716
3108500,6620087472,88093210,1.1892583349999999e-11,21858234,39885712,3894895428
3109000,6613935307,92918428,1.2543987780000002e-11,22371730,12761500,3907656928
3109500,11252545312,93964811,1.2685249485000002e-11,21487884,1327776,3908984704
3110000,3347406252,93423844,1.261221894e-11,21468676,1328304,3910313008
3110500,3334026256,93344750,1.2601541250000002e-11,21490117,1329160,3911642168
3111000,3324163406,93864335,1.2671685225e-11,21631937,1330132,3912972300
3111500,2091209531,93359114,1.2603480390000002e-11,21293809,1327776,3914300076
3112000,3322065793,93351110,1.2602399850000001e-11,21423979,1328276,3915628352
3112500,2089302968,93350184,1.260227484e-11,21403452,1328776,3916957128
3113000,2087709316,93706265,1.2650345775e-11,21432245,1328804,3918285932
3113500,2085654787,93332569,1.2599896815e-11,21512585,1330160,3919616092
3114000,2114919323,93326404,1.259906454e-11,21402185,1326804,3920942896
3114500,2083738565,93341554,1.2601109790000002e-11,21291977,1330160,3922273056
3115000,2082293779,93723668,1.265269518e-11,22025664,1329312,3923602368
3115500,2083008298,93343886,1.260142461e-11,21626873,1329148,3924931516
3116000,2084936035,93309514,1.259678439e-11,21376858,1328260,3926259776
3116500,2083916538,93348666,1.2602069910000001e-11,21575771,1329152,3927588928
3117000,2078204051,93340191,1.2600925785e-11,21548915,1329284,3928918212
3117500,2060977860,93323274,1.2598641990000002e-11,21497543,1328312,3930246524
3118000,2109947662,93333430,1.2600013050000002e-11,21494712,1328304,3931574828
3118500,2110704558,93341512,1.260110412e-11,21642745,1328804,3932903632
3119000,2082796414,93346701,1.2601804635e-11,21609061,1329688,3934233320
3119500,2074590990,93330156,1.259957106e-11,21467841,1328312,3935561632
3120000,2081798873,93336245,1.2600393075e-11,21544977,1328312,3936889944
3120500,2080674623,93349075,1.2602125125e-11,21629843,1329296,3938219240
3121000,2081358863,93328490,1.2599346150000001e-11,21619502,1328784,3939548024
3121500,2083258325,85065762,1.148387787e-11,21153597,-98659824,3840888200
3122000,2084010338,84737612,1.1439577620000001e-11,18296902,1332916,3842221116
3122500,2086440267,95948161,1.2953001735e-11,22962091,1328812,3843549928
3123000,2085899727,95583463,1.2903767505000002e-11,23238747,1328672,3844878600
3123500,2084882710,95583150,1.2903725250000002e-11,23347741,1328276,3846206876
3124000,2082730265,95589796,1.2904622460000001e-11,23361892,1328296,3847535172
3124500,2116199430,95594291,1.2905229285000002e-11,23533535,1328296,3848863468
3125000,4776015030,95995428,1.295938278e-11,23421859,1328304,3850191772
3125500,4862320009,95593970,1.2905185950000002e-11,23623433,1330660,3851522432
3126000,3442902951,95586384,1.290416184e-11,23345053,1328776,3852851208
3126500,5340247529,95580304,1.290334104e-11,23269227,1329688,3854180896
3127000,5150576469,95993855,1.2959170425e-11,23258215,1327804,3855508700
3127500,6629908508,95596219,1.2905489565000002e-11,23687109,1329304,3856838004
3128000,4978076865,96033600,1.2964536000000001e-11,23564796,1329180,3858167184
3128500,4956769112,95592539,1.2904992765000001e-11,23364701,1329152,3859496336
3129000,2351177043,95589407,1.2904569945e-11,23483633,1329304,3860825640
3129500,11224038588,96290010,1.299915135e-11,23345207,1327796,3862153436
3130000,2110143104,95583092,1.290371742e-11,23297014,1328644,3863482080
3130500,2120720229,95587876,1.2904363260000002e-11,23506290,1328268,3864810348
3131000,2096588958,95570316,1.2901992660000002e-11,22885078,1328276,3866138624
3131500,2101257887,95948650,1.295306775e-11,22967407,1329652,3867468276
3132000,2096437523,95586592,1.290418992e-11,23362106,1328776,3868797052
3132500,2094627003,95581665,1.2903524775e-11,23288409,1327812,3870124864
3133000,2100254871,95583552,1.290377952e-11,23300590,1327796,3871452660
3133500,2090371787,95588124,1.2904396740000002e-11,23381231,1329180,3872781840
3134000,2089096635,95957113,1.2954210255000002e-11,23338864,1328812,3874110652
3134500,2079457951,94379573,1.2741242354999999e-11,23267504,7181392,3881292044
3135000,2086907349,87758806,1.1847438810000001e-11,22358206,39652888,3920944932
3135500,2098966784,92544056,1.249344756e-11,22510351,16875812,3937820744
3136000,2079663682,93395414,1.260838089e-11,21516326,1328776,3939149520
3136500,2085689318,93429904,1.2613037040000001e-11,21487536,1330036,3940479556
3137000,2087652332,93323315,1.2598647525e-11,21119603,1329776,3941809332
3137500,2081360550,93464305,1.2617681175e-11,21004626,1328812,3943138144
3138000,2085470705,93368035,1.2604684725000001e-11,20958895,1327804,3944465948
3138500,2079869625,93716726,1.2651758010000001e-11,21031612,1329680,3945795628
3139000,2085467585,93325607,1.2598956945000001e-11,20932519,1328296,3947123924
3139500,2091343079,93335653,1.2600313155e-11,20992427,1328788,3948452712
3140000,2082732123,93319393,1.2598118055e-11,21147166,1329160,3949781872
3140500,6656469241,93724905,1.2652862175e-11,21064492,1328812,3951110684
3141000,6687730879,93328366,1.259932941e-11,21197425,1328776,3952439460
3141500,6648063242,93698903,1.2649351905e-11,21106556,1330160,3953769620
3142000,6749890769,93712880,1.26512388e-11,21602129,1329312,3955098932
3142500,8734027288,93707151,1.2650465385e-11,21599325,1328280,3956427212
3143000,9124316694,93747223,1.2655875105e-11,21563241,1328804,3957756016
3143500,4980575707,93333166,1.259997741e-11,21529090,1329660,3959085676
3144000,8739534765,93741992,1.265516892e-11,21523768,1328796,3960414472
3144500,3434976045,93333400,1.2600009000000002e-11,21492957,1328768,3961743240
3145000,3349253995,93721956,1.265246406e-11,21736050,1329304,3963072544
3145500,3353740848,93338259,1.2600664965000001e-11,21682249,1330144,3964402688
3146000,3348768380,93338454,1.260069129e-11,21456962,1328284,3965730972
3146500,3339509310,93707207,1.2650472945e-11,21408328,1328812,3967059784
3147000,3328569820,93342137,1.2601188495e-11,21393616,1330536,3968390320
3147500,3336224984,93317760,1.25978976e-11,20856108,1328812,3969719132
3148000,2094828890,88769733,1.1983913955000001e-11,20979879,-96834904,3872884228
3148500,2085485479,85152120,1.14955362e-11,18613042,1332908,3874217136
3149000,2089976721,95570344,1.2901996440000001e-11,22819430,1327304,3875544440
3149500,2085569387,95579689,1.2903258015e-11,23171506,1328804,3876873244
3150000,2081160703,95582288,1.290360888e-11,23287449,1329688,3878202932
3150500,2087191636,95958927,1.2954455145000001e-11,23217714,1327312,3879530244
3151000,2078859572,95588860,1.2904496100000001e-11,23375618,1328284,3880858528
3151500,2064193142,95588790,1.2904486650000002e-11,23469826,1328284,3882186812
3152000,2095482888,95580609,1.2903382215e-11,23283957,1328276,3883515088
3152500,2084567688,95589143,1.2904534305e-11,23400174,1328268,3884843356
3153000,2085074527,95955193,1.2953951055000002e-11,23337679,1327784,3886171140
3153500,4767498579,95581382,1.2903486570000001e-11,23221805,1327784,3887498924
3154000,4827423579,95959002,1.2954465270000001e-11,23312470,1327776,3888826700
3154500,4890317195,95588976,1.290451176e-11,23314558,1330652,3890157352
3155000,6753577876,95948511,1.2953048985e-11,22799028,1328276,3891485628
3155500,6912143729,95570022,1.290195297e-11,22854266,1326804,3892812432
3156000,6640592653,95602761,1.2906372735000001e-11,23089647,1327296,3894139728
3156500,6792527300,95994823,1.2959301105e-11,23193153,1328812,3895468540
3157000,6823429563,95582992,1.290370392e-11,23365613,1328812,3896797352
3157500,3368094291,95960899,1.2954721365e-11,23352492,1329180,3898126532
3158000,2116311031,95583652,1.290379302e-11,23253265,1328812,3899455344
3158500,2115753054,95584844,1.290395394e-11,23322367,1328796,3900784140
3159000,2135786868,95586473,1.2904173855e-11,23367416,1329312,3902113452
3159500,2120848432,95963710,1.2955100849999999e-11,23371807,1330180,3903443632
3160000,2111974216,95584574,1.290391749e-11,23300655,1328812,3904772444
3160500,2105790016,95591064,1.2904793640000002e-11,23523195,1329312,3906101756
3161000,2103742943,95586296,1.2904149960000001e-11,23342057,1327760,3907429516
3161500,2105170836,88614202,1.196291727e-11,23312122,37394816,3944824332
3162000,2097679993,90970104,1.228096404e-11,22272756,28126408,3972950740
3162500,2094483530,93391409,1.2607840215e-11,21059002,1327284,3974278024
3163000,3333345723,93440344,1.261444644e-11,21520692,1328784,3975606808
3163500,2092597445,93339345,1.2600811575000001e-11,21180447,1328284,3976935092
3164000,2106716073,93786292,1.266114942e-11,20989137,1328784,3978263876
3164500,2088948042,93413587,1.2610834245000001e-11,20891970,1327776,3979591652
3165000,2086168180,93348888,1.260209988e-11,21185088,1328776,3980920428
3165500,2080130914,93350822,1.260236097e-11,21563113,1328284,3982248712
3166000,2085601343,93341566,1.260111141e-11,21395651,1328776,3983577488
3166500,2089557303,93335507,1.2600293445e-11,21372846,1329304,3984906792
3167000,2087952785,93331772,1.2599789220000001e-11,21515725,1329296,3986236088
3167500,2084479535,93338405,1.2600684675e-11,21528901,1328312,3987564400
3168000,2087649862,93337156,1.260051606e-11,21659277,1330148,3988894548
3168500,2087199290,93703570,1.264998195e-11,21412317,1328312,3990222860
3169000,2081025232,93357743,1.2603295305000001e-11,21406668,1329284,3991552144
3169500,2118553326,93339868,1.2600882180000001e-11,21411072,1329304,3992881448
3170000,6606092369,93708058,1.265058783e-11,21254240,1329680,3994211128
3170500,6701616579,93311579,1.2597063165e-11,21048888,1329304,3995540432
3171000,11943521039,93694415,1.2648746025e-11,21000807,1327776,3996868208
3171500,15068035055,93754295,1.2656829825e-11,21457541,1328312,3998196520
3172000,11712988601,93749789,1.2656221515e-11,21470334,1327796,3999524316
3172500,6750879370,93340839,1.2601013265e-11,21505891,1329688,4000854004
3173000,11271427912,94089888,1.270213488e-11,21421250,1328812,4002182816
3173500,3352148432,93340901,1.2601021635e-11,21507594,1328812,4003511628
3174000,3347395326,93720507,1.2652268445e-11,21608513,1330160,4004841788
3174500,3356745652,93609268,1.2637251180000001e-11,21563792,1329304,4006171092
3175000,2091566621,82781151,1.1175455385000001e-11,21426344,-99256904,3906914188
3175500,2092754073,84816752,1.145026152e-11,18968040,1333916,3908248104
3176000,2089748478,95965120,1.29552912e-11,23315663,1328284,3909576388
3176500,2088219639,95579231,1.2903196185e-11,23138453,1327812,3910904200
3177000,2089309562,95577294,1.2902934690000002e-11,23148417,1328288,3912232488
3177500,2087343058,95550546,1.289932371e-11,22110785,1330940,3913563428
3178000,2084636554,95554811,1.2899899485e-11,22289902,1327780,3914891208
3178500,2082107481,95944195,1.2952466324999999e-11,22738201,1328304,3916219512
3179000,2086480110,95568632,1.2901765320000001e-11,22751784,1329672,3917549184
3179500,2101355106,95565655,1.2901363425000001e-11,22693129,1328804,3918877988
3180000,2076999367,95560760,1.2900702600000002e-11,22693460,1327812,3920205800
3180500,2087087597,95569680,1.2901906800000001e-11,22867911,1327428,3921533228
3181000,2083002378,95942640,1.2952256400000002e-11,22693316,1327784,3922861012
3181500,2078316054,95564804,1.2901248540000001e-11,22601897,1327284,3924188296
3182000,4922277690,95597150,1.2905615250000001e-11,22698605,1328272,3925516568
3182500,5051414015,95994360,1.2959238600000001e-11,22927039,1329784,3926846352
3183000,5072541739,95562219,1.2900899565e-11,22721675,1327776,3928174128
3183500,6682039090,95984497,1.2957907095e-11,22754860,1328776,3929502904
3184000,4921406786,95562390,1.290092265e-11,22716413,1328284,3930831188
3184500,4899755212,95565650,1.290136275e-11,22741214,1328776,3932159964
3185000,7003563197,95567078,1.290155553e-11,22741190,1328804,3933488768
3185500,4872031117,95953375,1.2953705625e-11,22936649,1329144,3934817912
3186000,4949324002,95562883,1.2900989205000001e-11,22673002,1328288,3936146200
3186500,2147830936,95567871,1.2901662585000001e-11,22722540,1328768,3937474968
3187000,2118739002,95948539,1.2953052765e-11,22835143,1328784,3938803752
3187500,2119367542,95576813,1.2902869755e-11,23062632,1328804,3940132556
3188000,2118546414,95587950,1.2904373250000001e-11,23426174,1328304,3941460860
3188500,2125266301,89911365,1.2138034275e-11,23434151,29162872,3970623732
3189000,2112114500,89804414,1.2123595890000001e-11,22323153,34922836,4005546568
3189500,3366651909,93865670,1.267186545e-11,21478174,1328812,4006875380
3190000,3358568319,93406148,1.260982998e-11,21491019,1328768,4008204148
3190500,3350127120,93779193,1.2660191055000002e-11,21574693,1328804,4009532952
3191000,3332581015,93394407,1.2608244945e-11,21523246,1329276,4010862228
3191500,2091379327,93465787,1.2617881245000001e-11,21503318,1328796,4012191024
3192000,2087056925,93336489,1.2600426015e-11,21439564,1328652,4013519676
3192500,2088946021,93360028,1.2603603779999999e-11,21541576,1328764,4014848440
3193000,2087019433,93360185,1.2603624975e-11,21786453,1329688,4016178128
3193500,3335710302,93341864,1.2601151640000002e-11,21563410,1330188,4017508316
3194000,2086059720,93323136,1.259862336e-11,21251011,1327312,4018835628
3194500,2087031481,93339959,1.2600894465e-11,21451834,1327784,4020163412
3195000,3312772610,93708641,1.2650666535e-11,21392473,1328312,4021491724
3195500,3320551002,93351373,1.2602435355000002e-11,21736053,1331164,4022822888
3196000,3325719084,93305606,1.2596256810000001e-11,21080199,1328312,4024151200
3196500,2086521232,93726788,1.265311638e-11,21078903,1329660,4025480860
3197000,3323716587,93329157,1.2599436195000001e-11,21046171,1327784,4026808644
3197500,2086467283,93320689,1.2598293015e-11,21150943,1328776,4028137420
3198000,3316073307,93697465,1.2649157775e-11,21139826,1327812,4029465232
3198500,3315021978,93321585,1.2598413975000002e-11,21095715,1327804,4030793036
3199000,6685500107,93324610,1.2598822349999999e-11,21182584,1329304,4032122340
3199500,6681484692,93334499,1.2600157365e-11,21435884,1329276,4033451616
3200000,8864265713,93760336,1.265764536e-11,21490011,1329152,4034780768
3200500,8856402429,93801833,1.2663247455e-11,21101834,1328780,4036109548
3201000,8814093882,93671675,1.2645676125e-11,20473463,1327784,4037437332
3201500,11414119146,93325376,1.2598925760000002e-11,20924535,1329688,4038767020
3202000,2123017443,88055807,1.1887533945e-11,20856911,-97078624,3941688396
3202500,3387886186,84825369,1.1451424815000001e-11,18297546,1333908,3943022304
3203000,2119600315,95570590,1.290202965e-11,22775814,1329188,3944351492
3203500,2115308669,95569011,1.2901816485000001e-11,22734719,1328804,3945680296
3204000,2127453035,95947052,1.295285202e-11,22764054,1328312,3947008608
3204500,2128079809,95569899,1.2901936365000001e-11,22839585,1328812,3948337420
3205000,2110191480,95572501,1.2902287635e-11,22795482,1329688,3949667108
3205500,2106590044,95569287,1.2901853745e-11,22832940,1327928,3950995036
3206000,2120170665,95955908,1.295404758e-11,22968142,1329276,3952324312
3206500,2100466324,95564675,1.2901231125000001e-11,22687966,1329172,3953653484
3207000,2093666154,95564760,1.29012426e-11,22673079,1329148,3954982632
3207500,2090605959,95556609,1.2900142215000001e-11,22421521,1329312,3956311944
3208000,2087890498,95557214,1.290022389e-11,22422180,1329160,3957641104
3208500,2087612999,95958203,1.2954357405000001e-11,22996068,1329280,3958970384
3209000,2088692352,95603695,1.2906498825e-11,22930500,1327304,3960297688
3209500,2111460987,95581519,1.2903505065e-11,23043264,1329312,3961627000
3210000,2069895690,95569006,1.290181581e-11,22807471,1329188,3962956188
3210500,2102080180,95567042,1.290155067e-11,22831773,1328312,3964284500
3211000,2087776707,95953680,1.29537468e-11,23003551,1328284,3965612784
3211500,2086843191,95570289,1.2901989015000001e-11,22867162,1330188,3966942972
3212000,2088777779,95573453,1.2902416155e-11,22876198,1329296,3968272268
3212500,2085493921,95576280,1.2902797800000001e-11,23032828,1329804,3969602072
3213000,4775020661,95948106,1.295299431e-11,22762575,1327780,3970929852
3213500,3350227554,95577462,1.2902957370000001e-11,22986964,1330536,3972260388
3214000,4985536044,95936382,1.295141157e-11,22371244,1329304,3973589692
3214500,4901447557,95555448,1.289998548e-11,22339984,1328312,3974918004
3215000,4838324213,95948800,1.2953088e-11,22719386,1329688,3976247692
3215500,4832316180,91556119,1.2360076065e-11,22465022,20959184,3997206876
3216000,5321858902,88811563,1.1989561005e-11,21813906,39364020,4036570896
3216500,6645256227,93583770,1.263380895e-11,21790784,5408076,4041978972
3217000,3409286268,93762174,1.265789349e-11,20847545,1327312,4043306284
3217500,3340033811,93399982,1.260899757e-11,20872753,1327804,4044634088
3218000,3337003674,93357029,1.2603198915e-11,21053951,1328312,4045962400
3218500,2085873468,93850245,1.2669783075000002e-11,20992548,1327304,4047289704
3219000,2085637905,93350700,1.2602344500000002e-11,21118073,1329688,4048619392
3219500,2086738110,93325868,1.259899218e-11,20916866,1327780,4049947172
3220000,2086250223,93342114,1.2601185390000002e-11,21033045,1328312,4051275484
3220500,2088920709,93709391,1.2650767785e-11,21229078,1330188,4052605672
3221000,2090519346,93317992,1.259792892e-11,21055302,1328776,4053934448
3221500,2082690848,93332307,1.2599861445000001e-11,20927377,1329160,4055263608
3222000,2084594775,93312904,1.2597242040000002e-11,21024500,1327812,4056591420
3222500,2085483324,93369554,1.2604889790000001e-11,21497246,1327768,4057919188
3223000,2075540093,93338608,1.260071208e-11,21625752,1328796,4059247984
3223500,2084594102,93316377,1.2597710894999999e-11,21604284,1329660,4060577644
3224000,2085185616,93344158,1.260146133e-11,21436503,1328296,4061905940
3224500,2095761779,93338192,1.260065592e-11,21522916,1328304,4063234244
3225000,2097509881,93328471,1.2599343585e-11,21475594,1328304,4064562548
3225500,2082803094,93754030,1.265679405e-11,21655860,1329144,4065891692
3226000,2086410293,93342319,1.2601213065e-11,21595415,1329284,4067220976
3226500,2087586558,93341655,1.2601123425e-11,21522356,1329188,4068550164
3227000,2087436537,93314051,1.2597396885e-11,21242919,1328672,4069878836
3227500,2090954735,93354076,1.260280026e-11,21033254,1329812,4071208648
3228000,2077718889,93322913,1.2598593255000001e-11,21505992,1330188,4072538836
3228500,2073773495,93726356,1.2653058060000002e-11,21568218,1329304,4073868140
3229000,2102452247,92967616,1.2550628160000002e-11,21513058,-98666840,3975201300
3229500,3290558975,84875159,1.1458146465e-11,18965305,1334776,3976536076
3230000,3314657098,95970887,1.2956069745000001e-11,23312011,1328304,3977864380
3230500,4794220693,95594712,1.2905286120000001e-11,23575731,1329304,3979193684
3231000,4981312209,95973381,1.2956406435e-11,23538817,1328768,3980522452
3231500,4821142722,95586053,1.2904117155000002e-11,23362063,1329160,3981851612
3232000,4897974820,95976868,1.295687718e-11,23473088,1328784,3983180396
3232500,6736749377,95591136,1.2904803360000002e-11,23441068,1328804,3984509200
3233000,4868588428,95584990,1.290397365e-11,23367049,1328304,3985837504
3233500,11231504707,96353452,1.300771602e-11,23320751,1330556,3987168060
3234000,2098056904,95572859,1.2902335965e-11,22939780,1327812,3988495872
3234500,2087740832,95583796,1.290381246e-11,23397973,1327796,3989823668
3235000,2089739776,96001059,1.2960142965e-11,24311969,1328304,3991151972
3235500,2081583513,95590383,1.2904701705e-11,23464448,1329160,3992481132
3236000,2085195204,95586331,1.2904154685000002e-11,23328574,1328276,3993809408
3236500,2084698533,95592416,1.290497616e-11,23370351,1328304,3995137712
3237000,2080996123,95583307,1.2903746445e-11,23305524,1330188,3996467900
3237500,2081404894,95972148,1.2956239980000001e-11,23424381,1329296,3997797196
3238000,2083439062,95576204,1.290278754e-11,23138269,1328304,3999125500
3238500,2095783908,95579796,1.290327246e-11,23205249,1328680,4000454180
3239000,2087658109,95583722,1.290380247e-11,23267475,1328796,4001782976
3239500,2084111122,95586051,1.2904116885000001e-11,23351460,1328812,4003111788
3240000,2084468214,95971061,1.2956093235000002e-11,23323029,1330528,4004442316
3240500,2074822088,95576428,1.2902817779999999e-11,23014131,1329304,4005771620
3241000,2083910778,95572616,1.290230316e-11,22948471,1329276,4007100896
3241500,2084513188,95568360,1.2901728600000001e-11,22695662,1329164,4008430060
3242000,2076981494,95562059,1.2900877965000001e-11,22641276,1328312,4009758372
3242500,2080446476,93252851,1.2589134885000002e-11,23009204,12714420,4022472792
3243000,2086762125,87985127,1.1877992145e-11,22427623,39570156,4062042948
3243500,2082491202,93098471,1.2568293585000001e-11,22239574,11177264,4073220212
3244000,2082844067,93409518,1.2610284930000001e-11,21463363,1328312,4074548524
3244500,2075447997,93425555,1.2612449925e-11,21522009,1328312,4075876836
3245000,2078422928,93725770,1.265297895e-11,21364264,1328680,4077205516
3245500,2082548745,93482894,1.2620190690000001e-11,21600708,1329304,4078534820
3246000,2112368197,93402086,1.260928161e-11,21575377,1330600,4079865420
3246500,2152990882,93334171,1.2600113085000002e-11,21365345,1329652,4081195072
3247000,4793421298,93720057,1.2652207695e-11,20865767,1327788,4082522860
3247500,4771243996,93332093,1.2599832555e-11,20838759,1328312,4083851172
3248000,3348999271,93304108,1.2596054580000002e-11,20947493,1329180,4085180352
3248500,4840754554,93742228,1.265520078e-11,21307897,1328804,4086509156
3249000,6625266559,93767753,1.2658646655e-11,21402863,1328312,4087837468
3249500,6606446818,93340769,1.2601003815000001e-11,21410622,1328812,4089166280
3250000,3423915897,93331707,1.2599780445000001e-11,21488769,1329688,4090495968
3250500,8716997541,94022753,1.2693071655000001e-11,22583942,1329812,4091825780
3251000,2126461955,93331367,1.2599734545000001e-11,21564954,1329268,4093155048
3251500,2091683297,93336597,1.2600440595e-11,21421131,1328804,4094483852
3252000,2087685083,93336322,1.260040347e-11,21414881,1328296,4095812148
3252500,2083549300,93720732,1.265229882e-11,21488429,1328784,4097140932
3253000,2096269563,93317532,1.259786682e-11,21385479,1327752,4098468684
3253500,2085463813,93337320,1.2600538200000001e-11,21304831,1328276,4099796960
3254000,2087155719,93337344,1.2600541440000002e-11,21298774,1329172,4101126132
3254500,2086696874,93305031,1.2596179185e-11,20928972,1328284,4102454416
3255000,2088565884,93730473,1.2653613855e-11,21017098,1327276,4103781692
3255500,2085907826,93312942,1.259724717e-11,21513411,1327768,4105109460
3256000,2096294853,93336095,1.2600372825000002e-11,20909856,1327812,4106437272
3256500,2086285142,85410522,1.153042047e-11,21451210,-97138088,4009299184
3257000,2086429037,84900109,1.1461514715000002e-11,18825672,1332408,4010631592
3257500,2081498282,95981202,1.295746227e-11,23511872,1329680,4011961272
3258000,2085951805,95580890,1.290342015e-11,23201772,1328296,4013289568
3258500,2088559698,95577947,1.2903022845e-11,23186974,1326804,4014616372
3259000,2087476053,95581033,1.2903439455e-11,23279507,1328312,4015944684
3259500,2088797217,95592594,1.290500019e-11,23455431,1328812,4017273496
3260000,2080335514,95981214,1.2957463890000001e-11,23512121,1329180,4018602676
3260500,2089967970,95581714,1.2903531390000002e-11,23270021,1328276,4019930952
3261000,2084092919,95578448,1.2903090480000001e-11,23178520,1328304,4021259256
3261500,2085643618,95579356,1.2903213060000002e-11,23096666,1329188,4022588444
3262000,2110467498,95556468,1.2900123180000001e-11,22556380,1328312,4023916756
3262500,2083713594,95955062,1.295393337e-11,22682265,1328660,4025245416
3263000,3305331158,95576936,1.290288636e-11,23074586,1329312,4026574728
3263500,3288329399,95621234,1.2908866590000001e-11,23447550,1329304,4027904032
3264000,3286933438,95976415,1.2956816025000001e-11,23285931,1328680,4029232712
3264500,3313863989,95588177,1.2904403895e-11,23401818,1329280,4030561992
3265000,3321578966,95583867,1.2903822045e-11,23355238,1328804,4031890796
3265500,3623996937,95979279,1.2957202665e-11,23505367,1331180,4033221976
3266000,5364575523,95568211,1.2901708485000002e-11,22880399,1328284,4034550260
3266500,4816001128,95578460,1.29030921e-11,23124548,1329276,4035879536
3267000,8696624967,96390089,1.3012662015000002e-11,22989581,1327760,4037207296
3267500,2101304213,95574376,1.2902540760000001e-11,22987542,1328284,4038535580
3268000,2087762221,95578448,1.2903090480000001e-11,23165810,1328776,4039864356
3268500,2088166958,95592346,1.2904966710000001e-11,23519315,1330188,4041194544
3269000,2086409841,95578384,1.2903081840000001e-11,23056837,1328804,4042523348
3269500,2084997724,95956756,1.2954162060000001e-11,22878615,1327304,4043850652
3270000,2087637415,94992157,1.2823941195000001e-11,23158605,4313868,4048164520
3270500,2082606856,92171056,1.2443092559999999e-11,22031643,13559804,4061724324
3271000,2077054096,93384286,1.260687861e-11,20931286,1328304,4063052628
3271500,2088687023,93415560,1.26111006e-11,21081963,1328804,4064381432
3272000,2084240813,93352472,1.260258372e-11,21644886,1328796,4065710228
3272500,2081680773,93857605,1.2670776675000002e-11,21590311,1330180,4067040408
3273000,2062611701,93405635,1.2609760725e-11,21460857,1329296,4068369704
3273500,2094053823,93360189,1.2603625515e-11,21543068,1328812,4069698516
3274000,2084297133,93350787,1.2602356245e-11,21501967,1328804,4071027320
3274500,2078771923,93733905,1.2654077175e-11,21571038,1329680,4072357000
3275000,2090788055,93327124,1.2599161740000002e-11,21405850,1328272,4073685272
3275500,2089582482,93334666,1.260017991e-11,21661105,1330312,4075015584
3276000,2089368385,93348548,1.2602053980000001e-11,21436111,1328804,4076344388
3276500,2076706040,93326129,1.2599027415e-11,21437225,1328312,4077672700
3277000,2084405213,93726144,1.265302944e-11,21405606,1327812,4079000512
3277500,2089534950,93304291,1.2596079285e-11,20885420,1330024,4080330536
3278000,3318012309,93322294,1.259850969e-11,20957664,1329304,4081659840
3278500,2061246000,93332236,1.2599851860000002e-11,21286833,1328312,4082988152
3279000,4775257232,93716447,1.2651720345e-11,21551173,1329180,4084317332
3279500,4754170794,93331996,1.2599819460000001e-11,21570916,1328812,4085646144
3280000,4808216165,93764964,1.2658270140000002e-11,21471150,1328812,4086974956
3280500,4812675675,93347710,1.2601940850000001e-11,21647894,1329812,4088304768
3281000,6695019105,93718934,1.265205609e-11,21488082,1328276,4089633044
3281500,6817707143,93327838,1.259925813e-11,21388248,1327284,4090960328
3282000,11251558915,94148764,1.271008314e-11,21494575,1328276,4092288604
3282500,2094237113,93341598,1.2601115730000002e-11,21616202,1329284,4093617888
3283000,2066194253,93350728,1.2602348280000001e-11,21614430,1329304,4094947192
3283500,2065667874,88589026,1.1959518510000001e-11,21422868,-32227144,4062720048
3284000,2077783824,84961884,1.1469854340000002e-11,18932497,1333888,4064053936
3284500,2082423864,95977839,1.2957008265000001e-11,23443369,1328284,4065382220
3285000,2075532055,95583165,1.2903727275000001e-11,23256977,1329152,4066711372
3285500,2083396403,95573013,1.2902356755e-11,22969398,1328784,4068040156
3286000,2090237489,95565742,1.290137517e-11,22760825,1328764,4069368920
3286500,2086859344,95961203,1.2954762405e-11,22849635,1329312,4070698232
3287000,2083847616,95583685,1.2903797475e-11,23205474,1328784,4072027016
3287500,2088677791,95593267,1.2905091045e-11,23589354,1329660,4073356676
3288000,2081769655,95584772,1.290394422e-11,23350352,1328812,4074685488
3288500,2079591422,95586691,1.2904203284999999e-11,23366547,1328276,4076013764
3289000,2078195378,95971286,1.2956123610000001e-11,23388297,1328812,4077342576
3289500,2089465863,95583910,1.2903827850000002e-11,23300349,1328296,4078670872
3290000,2095977036,95586291,1.2904149285e-11,23399914,1328804,4079999676
3290500,2080472396,95589936,1.290464136e-11,23381475,1329160,4081328836
3291000,2080035524,95593240,1.2905087400000002e-11,23440853,1329296,4082658132
3291500,2080862113,95977233,1.2956926455000002e-11,23413196,1327812,4083985944
3292000,2074350565,95580318,1.290334293e-11,23302805,1327804,4085313748
3292500,2077309583,95573211,1.2902383485e-11,22879166,1330556,4086644304
3293000,3307839076,95571375,1.2902135625000001e-11,23004802,1328280,4087972584
3293500,3306473242,95975566,1.295670141e-11,23440912,1328804,4089301388
3294000,2070524968,95582048,1.2903576480000001e-11,23237529,1328652,4090630040
3294500,3414424937,95617382,1.290834657e-11,23373098,1328776,4091958816
3295000,4950321330,95971658,1.2956173830000002e-11,23358970,1328804,4093287620
3295500,4877365395,95589669,1.2904605314999999e-11,23435021,1329160,4094616780
3296000,5242158218,95970790,1.295605665e-11,23249758,1328296,4095945076
3296500,4835440963,95580705,1.2903395175e-11,23243024,1328312,4097273388
3297000,3344801902,95975198,1.2956651730000001e-11,23293700,1329656,4098603044
3297500,2105848297,95408533,1.2880151955e-11,23261579,1329304,4099932348
3298000,2103419883,95176394,1.284881319e-11,20640868,1328304,4101260652
3298500,2071596104,95174893,1.2848610555e-11,20696692,1331440,4102592092
3299000,2115544833,95539012,1.289776662e-11,19894082,1328312,4103920404
3299500,2111205813,95143610,1.284438735e-11,20155379,1328804,4105249208
3300000,2079981784,95143926,1.284443001e-11,20165805,1328660,4106577868
3300500,2083252535,95185520,1.2850045200000001e-11,19917557,1327428,4107905296
3301000,2081001194,90567651,1.2226632885e-11,20152304,1328296,4109233592
3301500,2081997251,85358337,1.1523375495000001e-11,18265002,1331916,4110565508
3302000,2092105613,95574137,1.2902508495000001e-11,22894251,1329296,4111894804
3302500,2088712724,95563479,1.2901069665e-11,22641059,1327312,4113222116
3303000,2096502517,95571674,1.290217599e-11,22929624,1328780,4114550896
3303500,2087473233,95568281,1.2901717935e-11,22842548,1328784,4115879680
3304000,2085178033,95956308,1.2954101580000001e-11,22763038,1328312,4117207992
3304500,2084875769,95570824,1.290206124e-11,22764784,1329284,4118537276
3305000,4759218252,95565844,1.290138894e-11,22747551,1328276,4119865552
3305500,3315043073,95962653,1.2954958155000002e-11,22934258,1329780,4121195332
3306000,3343372955,95564087,1.2901151745000001e-11,22662655,1328284,4122523616
3306500,3397863398,95563043,1.2901010805e-11,22736267,1328804,4123852420
