Size,Time,Cycles,Price,Instructions,HeapSize,TotalHeapSize
5000,4421073849,17132924,2.3129447400000003e-12,100933376,2406292,4603524
10000,2358369674,18260237,2.465131995e-12,112728688,2473904,7077428
15000,2095320704,18401267,2.4841710450000003e-12,117212000,2471660,9549088
20000,3194298043,18568794,2.5067871900000004e-12,122756789,2612488,12161576
25000,3189187531,18720694,2.52729369e-12,127693541,2711052,14872628
30000,4208042212,18719558,2.52714033e-12,127556465,2712524,17585152
35000,2532879273,18731166,2.5287074100000002e-12,128033884,2713392,20298544
40000,4392267868,18874320,2.5480332000000002e-12,132686385,2713948,23012492
45000,3090825870,18857269,2.545731315e-12,132132231,2714024,25726516
50000,3161698200,18873067,2.547864045e-12,132645666,2712308,28438824
55000,2249551837,19936439,2.691419265e-12,142127594,2717328,31156152
60000,4509494581,34003035,4.590409725e-12,141154324,11624728,42780880
65000,3185464230,24679983,3.3317977050000005e-12,165824984,-28643808,14137072
70000,3424516943,19901955,2.6867639250000004e-12,140808413,2720400,16857472
75000,2353139364,19896158,2.6859813300000004e-12,140918629,2716524,19573996
80000,3351855554,19921881,2.6894539350000003e-12,141456008,2719676,22293672
85000,2755302039,19881650,2.68402275e-12,140447122,2716484,25010156
90000,2083179174,19909189,2.6877405150000002e-12,141342144,2717048,27727204
95000,2374585851,19959267,2.6945010450000002e-12,142969684,2720624,30447828
100000,4223531944,19913249,2.688288615e-12,141474073,2716308,33164136
105000,3474850581,31413200,4.240782e-12,143438509,3926864,37091000
110000,4805414600,42445745,5.730175575e-12,178488233,17223668,54314668
115000,2183969627,21114116,2.8504056599999998e-12,170911237,-30837192,23477476
120000,4315814955,20099402,2.71341927e-12,147225443,2716032,26193508
125000,2407174347,20038659,2.7052189649999998e-12,145549912,2718200,28911708
130000,4707744132,20078271,2.7105665850000004e-12,146538695,2717896,31629604
135000,2321959340,20102367,2.713819545e-12,147620401,2715140,34344744
140000,4030882301,20066540,2.7089829e-12,146456042,2716752,37061496
145000,2211081895,20079661,2.710754235e-12,146882481,2719860,39781356
150000,2226333246,20064932,2.70876582e-12,146403772,2719212,42500568
155000,4692547747,20070575,2.7095276250000003e-12,146288566,2717724,45218292
160000,2614407400,20039181,2.7052894350000002e-12,145566872,2716088,47934380
165000,3934897830,20053942,2.7072821700000004e-12,145747983,2720296,50654676
170000,2067663045,31039751,4.190366385e-12,147004626,2719308,53373984
175000,2773951477,45971780,6.206190300000001e-12,187018266,22743672,76117656
180000,3217401429,33509887,4.523834745e-12,171107151,-28639420,47478236
185000,2164368423,20031011,2.7041864850000005e-12,145301340,2717596,50195832
190000,3119762849,20098485,2.713295475e-12,147096427,2715648,52911480
195000,802381673,20117088,2.71580688e-12,148098846,2715788,55627268
200000,2244726686,20256411,2.7346154850000002e-12,152626832,2719976,58347244
205000,3447603695,20224603,2.730321405e-12,151593085,2722284,61069528
210000,3643168976,20215299,2.7290653650000003e-12,151290701,2718280,63787808
215000,2233191005,20209013,2.728216755e-12,151086421,2717496,66505304
220000,2779892275,20201805,2.727243675e-12,150852160,2715988,69221292
225000,4206406568,20252204,2.73404754e-12,152092154,2715400,71936692
230000,3204940049,20191295,2.725824825e-12,150510589,2718540,74655232
235000,3977753093,20248229,2.733510915e-12,151963092,2718460,77373692
240000,2303360001,20197711,2.7266909850000002e-12,150719092,2717192,80090884
245000,4167841268,20217519,2.729365065e-12,151362863,2716584,82807468
250000,2793648312,20228940,2.7309069e-12,151336211,2712732,85520200
255000,4081585077,20230030,2.73105405e-12,151769452,2717952,88238152
260000,2491676945,20233107,2.7314694449999997e-12,151869481,2714568,90952720
265000,3985537270,20229550,2.7309892500000002e-12,151356029,2718600,93671320
270000,3568060617,20246949,2.733338115e-12,152319346,2716072,96387392
275000,3144711483,20190045,2.725656075e-12,150469946,2717868,99105260
280000,2228717536,20264063,2.735648505e-12,152477693,2717748,101823008
285000,4054554990,20218719,2.7295270650000002e-12,151401846,2721000,104544008
290000,2285020920,20223166,2.73012741e-12,151546370,2718348,107262356
295000,3804104201,20251654,2.73397329e-12,152074407,2714428,109976784
300000,2904397070,20290358,2.73919833e-12,153730115,2717956,112694740
305000,3445798137,20417660,2.7563841e-12,157867456,2742872,115437612
310000,2791934289,20524075,2.770750125e-12,161325914,2958988,118396600
315000,2965283369,29593211,3.995083485e-12,160500765,2961952,121358552
320000,2127639081,40404434,5.45459859e-12,206698447,2958420,124316972
325000,3035119629,52848375,7.134530625e-12,206235858,37231384,161548356
330000,2462555847,40991964,5.53391514e-12,196809055,10367988,171916344
335000,3227003420,36903703,4.981999905e-12,189024472,2959916,174876260
340000,2202245990,23357180,3.1532193e-12,187469811,-95424276,79451984
345000,2480558195,20513187,2.769280245e-12,160972058,2956668,82408652
350000,3216116860,20525749,2.770976115e-12,161380344,2959372,85368024
355000,2136597642,20501034,2.7676395899999998e-12,159881626,2958772,88326796
360000,4286494912,20562907,2.7759924449999997e-12,162587954,2953164,91279960
365000,2438169283,20503582,2.7679835700000003e-12,160659901,2957996,94237956
370000,2216990777,20582748,2.77867098e-12,162537320,2957116,97195072
375000,2414129621,20526124,2.7710267400000002e-12,161392528,2957492,100152564
380000,2416921944,20590839,2.7797632650000005e-12,162800298,2956080,103108644
385000,2579529337,20509820,2.7688257e-12,160862630,2952508,106061152
390000,2478934258,20568696,2.7767739600000004e-12,162776101,2956668,109017820
395000,2382921654,20536120,2.7723762e-12,161021923,2957024,111974844
400000,2744429908,20516039,2.769665265e-12,161064777,2958940,114933784
405000,2431716188,20536264,2.77239564e-12,161722072,2958312,117892096
410000,3744497894,20415890,2.75614515e-12,157114441,2961408,120853504
415000,3228539140,20368479,2.749744665e-12,156269050,2958188,123811692
420000,2837021146,20433800,2.7585630000000004e-12,158391990,2956484,126768176
425000,2637502702,20383567,2.7517815450000005e-12,156759414,2957408,129725584
430000,3339417207,20430337,2.758095495e-12,158279452,2953232,132678816
435000,2098961832,20403073,2.7544148550000004e-12,156697899,2953516,135632332
440000,4266669245,20431433,2.7582434550000004e-12,158315065,2958180,138590512
445000,992208648,20386749,2.752211115e-12,156862834,2954560,141545072
450000,2310342236,20476779,2.7643651650000002e-12,159093344,2957776,144502848
455000,2907821053,20577712,2.77799112e-12,163069126,2958956,147461804
460000,3909032918,20422667,2.7570600450000006e-12,158030174,2957544,150419348
465000,3108348388,20373105,2.750369175e-12,156419411,2958412,153377760
470000,2390098679,20364197,2.7491665950000003e-12,156129880,2958172,156335932
475000,4338460948,20401046,2.75414121e-12,156632017,2958456,159294388
480000,2191428682,20367034,2.7495495900000002e-12,156222101,2957652,162252040
485000,3861479920,20351828,2.74749678e-12,155727896,2957832,165209872
490000,2513566453,20410631,2.7554351850000004e-12,156943547,2957912,168167784
495000,4213410282,20377570,2.75097195e-12,156564508,2954660,171122444
500000,2319167850,20386121,2.7521263350000003e-12,156842410,2958116,174080560
505000,3137092283,21446745,2.895310575e-12,166365229,2964748,177045308
510000,2333535876,21391154,2.88780579e-12,164558524,2961492,180006800
515000,3724693700,21500837,2.902612995e-12,167427738,2965760,182972560
520000,2183859854,28859195,3.895991325e-12,172159886,2964616,185937176
525000,4366205625,41439171,5.594288085000001e-12,215898591,2962784,188899960
530000,3147083161,41454663,5.596379505e-12,216529560,2960056,191860016
535000,3034761803,50546001,6.8237101349999996e-12,215476312,27654016,219514032
540000,2529795265,46623761,6.2942077350000005e-12,205266675,20365300,239879332
545000,3599288137,37612138,5.0776386300000004e-12,196492694,2960020,242839352
550000,2423783667,37896512,5.1160291200000004e-12,196795345,2961912,245801264
555000,4295468046,30718282,4.14696807e-12,197498992,-129061120,116740144
560000,2116854246,21573957,2.9124841950000003e-12,169605689,2961372,119701516
565000,3790057607,21555363,2.9099740050000005e-12,169895298,2965496,122667012
570000,2134084916,21538600,2.9077109999999997e-12,169350499,2961704,125628716
575000,2921297853,21590699,2.9147443649999998e-12,171043745,2959992,128588708
580000,3570496188,21556936,2.91018636e-12,169946428,2966696,131555404
585000,2995275642,21575493,2.9126915549999997e-12,170549530,2962272,134517676
590000,4119261559,21608474,2.91714399e-12,171621408,2959072,137476748
595000,2835014637,21582169,2.913592815e-12,169872579,2964224,140440972
600000,3777681086,21576059,2.9127679650000003e-12,170567941,2960124,143401096
605000,3241918348,21573248,2.9123884800000004e-12,170476574,2965312,146366408
610000,2334079697,21595408,2.9153800800000003e-12,170302877,2963108,149329516
615000,2701792635,21552741,2.909620035e-12,169810116,2961508,152291024
620000,3909567188,21606310,2.91685185e-12,170657164,2961488,155252512
625000,3136272020,21558156,2.9103510600000003e-12,169986088,2965796,158218308
630000,4362565721,21586657,2.914198695e-12,170912377,2964420,161182728
635000,2716662147,21619979,2.9186971650000004e-12,171101416,2962368,164145096
640000,3595737228,21489937,2.901141495e-12,167768951,2965020,167110116
645000,2234956818,21480568,2.8998766800000003e-12,166570396,2962632,170072748
650000,4361296003,21409589,2.8902945150000003e-12,165157640,2962360,173035108
655000,2073219302,21443900,2.8949265e-12,166272765,2960408,175995516
660000,2378376560,21377388,2.88594738e-12,164111128,2961036,178956552
665000,4631306962,21453069,2.896164315e-12,166570768,2961508,181918060
670000,2544944662,21608730,2.9171785500000003e-12,170735816,2961008,184879068
675000,3875367628,21469514,2.89838439e-12,167105216,2964312,187843380
680000,2580832710,21432873,2.893437855e-12,165914400,2961156,190804536
685000,3356000083,21548964,2.90911014e-12,168793432,2963468,193768004
690000,2218595252,21608041,2.917085535e-12,171607361,2967288,196735292
695000,3490441277,21555028,2.9099287800000002e-12,169884417,2963940,199699232
700000,2163909667,21561071,2.910744585e-12,170080834,2961960,202661192
705000,2753371886,21662863,2.9244865050000004e-12,172495166,2963696,205624888
710000,3953059587,21583814,2.91381489e-12,170819981,2962528,208587416
715000,3062727065,21580779,2.913405165e-12,170721341,2964832,211552248
720000,3208426472,21589769,2.9146188150000004e-12,170119593,2956272,214508520
725000,2468052057,21569557,2.911890195e-12,170356614,2963368,217471888
730000,3738635830,21559952,2.91059352e-12,170044465,2964388,220436276
735000,2403902724,21565279,2.9113126650000003e-12,170217596,2958140,223394416
740000,2077541515,21518073,2.904939855e-12,168683381,2962556,226356972
745000,3829073892,21588807,2.914488945e-12,170088332,2962664,229319636
750000,3193441756,21506767,2.9034135450000002e-12,168315949,2965196,232284832
755000,4261249535,21593226,2.91508551e-12,170231955,2962888,235247720
760000,2774849870,21568740,2.9117799e-12,170330050,2961316,238209036
765000,3443608261,21581152,2.91345552e-12,170733452,2962684,241171720
770000,3010315386,21602450,2.9163307500000004e-12,170531714,2964704,244136424
775000,2629041842,21569957,2.911944195e-12,170369618,2956680,247093104
780000,2454552153,21590073,2.914659855e-12,170129487,2964740,250057844
785000,4104817343,21571585,2.9121639750000003e-12,170422518,2965748,253023592
790000,2143175428,21594245,2.9152230750000003e-12,171158976,2965568,255989160
795000,3973876788,21580143,2.913319305e-12,169806747,2961300,258950460
800000,2821349140,21595550,2.9153992500000003e-12,171201382,2964704,261915164
805000,3964206016,21626048,2.9195164800000003e-12,172192584,2958564,264873728
810000,2565665212,21630000,2.92005e-12,171427097,2960116,267833844
815000,4037393706,21581741,2.913535035e-12,170752363,2962856,270796700
820000,2769024373,21576508,2.9128285800000005e-12,170582513,2966428,273763128
825000,3201248250,26034149,3.5146101150000005e-12,170121733,2965740,276728868
830000,2068024025,41438785,5.594235975e-12,215781413,2966796,279695664
835000,3788821202,41500335,5.602545225e-12,216921543,2962832,282658496
840000,3106778756,41577305,5.612936175e-12,220425388,2962024,285620520
845000,2086013191,41627165,5.619667275e-12,222147791,2958296,288578816
850000,3532475479,53751957,7.256514195e-12,220834436,35823056,324401872
855000,2083015330,49604410,6.696595350000001e-12,211849624,29249000,353650872
860000,3368118484,38753862,5.23177137e-12,202515858,2963128,356614000
865000,2234043545,38621992,5.21396892e-12,201669316,2960512,359574512
870000,3034245782,37599759,5.075967465000001e-12,202866017,2963176,362537688
875000,2339191140,38059517,5.138034795000001e-12,202173640,2966020,365503708
880000,2294626723,31301869,4.225752315e-12,202480963,-196168064,169335644
885000,4396718819,21708552,2.93065452e-12,174873797,2962076,172297720
890000,3202939086,21737494,2.93456169e-12,175814569,2960276,175257996
895000,470369037,21731881,2.9338039350000002e-12,175632164,2962960,178220956
900000,2915776185,21743713,2.9354012550000004e-12,176016706,2962696,181183652
905000,4759441201,21779951,2.9402933850000002e-12,176002839,2965832,184149484
910000,2085468800,21745398,2.9356287300000004e-12,176071458,2961212,187110696
915000,2789727813,21737522,2.9345654700000005e-12,175815485,2959668,190070364
920000,2921801600,21778285,2.9400684750000003e-12,175948687,2962044,193032408
925000,2081615670,21731223,2.9337151050000004e-12,175610773,2963320,195995728
930000,3388641157,21791841,2.941898535e-12,176389283,2964484,198960212
935000,2270477258,21725082,2.93288607e-12,175411179,2963108,201923320
940000,3096236974,21724041,2.9327455350000003e-12,175377346,2962400,204885720
945000,2085725268,21804965,2.9436702750000003e-12,176815778,2960616,207846336
950000,3874878221,21618956,2.91855906e-12,171962085,2962336,210808672
955000,2741649306,21586967,2.914240545e-12,170922430,2961844,213770516
960000,3591237053,21576295,2.912799825e-12,169384031,2958544,216729060
965000,2786253390,21546877,2.9088283950000003e-12,169619500,2964260,219693320
970000,3652099156,21550379,2.9093011650000003e-12,169733340,2967840,222661160
975000,2796443755,21703565,2.9299812750000003e-12,173520305,2965816,225626976
980000,3987678048,21705833,2.9302874550000004e-12,174785571,2962768,228589744
985000,2774115753,21718889,2.932050015e-12,175209916,2962516,231552260
990000,4011329976,21739329,2.934809415e-12,174682609,2965764,234518024
995000,6192288668,21766489,2.9384760150000003e-12,175565153,2959852,237477876
1000000,2209237348,21680601,2.926881135e-12,173965565,2961492,240439368
1005000,3653932284,21746838,2.93582313e-12,176118254,2963536,243402904
1010000,2840679718,21741392,2.9350879200000003e-12,174749681,2963544,246366448
1015000,146081949,21675033,2.926129455e-12,173784576,2957096,249323544
1020000,2075045061,21771978,2.9392170300000002e-12,176935296,2964292,252287836
1025000,2290084245,21742690,2.9352631500000004e-12,175983429,2961400,255249236
1030000,4014376936,21730504,2.93361804e-12,175587386,2964216,258213452
1035000,2168768013,21782014,2.94057189e-12,176069895,2960992,261174444
1040000,3035064760,21710489,2.9309160150000002e-12,174936895,2962720,264137164
1045000,3188271278,21759195,2.9374913249999998e-12,176519852,2965352,267102516
1050000,3564327288,21735765,2.934328275e-12,174566780,2961944,270064460
1055000,2294827868,21759537,2.937537495e-12,176530953,2965220,273029680
1060000,3954644126,21708254,2.93061429e-12,174864279,2963872,275993552
1065000,2350974815,21719395,2.932118325e-12,174034785,2965244,278958796
1070000,3577507378,21758445,2.9373900750000003e-12,176495461,2958140,281916936
1075000,2475361842,21688930,2.92800555e-12,174236257,2956644,284873580
1080000,3721228411,21781412,2.9404906200000002e-12,176050308,2962796,287836376
1085000,2669862694,21696973,2.9290913550000002e-12,174497641,2958412,290794788
1090000,4075680175,21696493,2.929026555e-12,174482056,2960908,293755696
1095000,2428331663,21785276,2.9410122600000004e-12,176175900,2960696,296716392
1100000,2934607509,21673303,2.925895905e-12,173728352,2964232,299680624
1105000,3360587852,21784695,2.9409338250000003e-12,176157020,2961936,302642560
1110000,4139079799,21571257,2.9121196950000003e-12,170411871,2966344,305608904
1115000,2405011752,21568673,2.911770855e-12,170327890,2960964,308569868
1120000,4154663172,21757653,2.937283155e-12,175278139,2963180,311533048
1125000,3164998732,21697562,2.92917087e-12,174516797,2964572,314497620
1130000,5585733473,21771914,2.93920839e-12,175741651,2962500,317460120
1135000,2137312015,21714196,2.93141646e-12,175057371,2960040,320420160
1140000,3253395707,21776869,2.9398773150000006e-12,175902675,2963276,323383436
1145000,2259700749,21579741,2.913265035e-12,170687615,2961976,326345412
1150000,2222569771,21571184,2.91210984e-12,170409489,2962156,329307568
1155000,3268024391,21519081,2.905075935e-12,168716148,2966304,332273872
1160000,2540411464,21597466,2.9156579100000002e-12,171263677,2961084,335234956
1165000,3243835641,21720310,2.9322418500000003e-12,174064244,2962948,338197904
1170000,2058330568,21752721,2.936617335e-12,176309462,2967592,341165496
1175000,3593455124,21746435,2.935768725e-12,174913569,2963400,344128896
1180000,4780328203,21716383,2.9317117050000003e-12,175128451,2966376,347095272
1185000,2636053955,21772455,2.939281425e-12,176950809,2962984,350058256
1190000,4050348597,21738831,2.934742185e-12,174666435,2962884,353021140
1195000,2301496380,21756154,2.9370807900000002e-12,176421024,2966240,355987380
1200000,4124694557,21762639,2.937956265e-12,175440193,2963508,358950888
1205000,2775252779,21733064,2.93396364e-12,175670585,2958840,361909728
1210000,4436705043,21711562,2.9310608700000005e-12,174971787,2962684,364872412
1215000,2644425963,21727910,2.93326785e-12,174311515,2964704,367837116
1220000,3896175736,21718198,2.9319567300000003e-12,175187450,2962012,370799128
1225000,2367723285,21732233,2.9338514550000003e-12,174452017,2964220,373763348
1230000,2068742621,21715004,2.9315255400000003e-12,175083637,2962128,376725476
1235000,33315312,21671404,2.92563954e-12,173666630,2959192,379684668
1240000,3035165348,21740175,2.9349236250000003e-12,175901707,2961380,382646048
1245000,3764472577,21687663,2.927834505e-12,174195055,2961384,385607432
1250000,2830839714,21797097,2.942608095e-12,176560077,2961936,388569368
1255000,4021475639,23347556,3.1519200600000003e-12,174552585,2968712,391538080
1260000,2657243117,41508135,5.603598225000001e-12,218107412,2964328,394502408
1265000,2252600781,41496541,5.602033035000001e-12,216430763,2965028,397467436
1270000,2066559761,41432432,5.59337832e-12,215760324,2962356,400429792
1275000,3207484319,41550064,5.60925864e-12,218067351,2964860,403394652
1280000,2135153010,41424227,5.592270645000001e-12,215427514,2963860,406358512
1285000,3359536082,41501440,5.6026944e-12,216469455,2966372,409324884
1290000,2323630546,45627421,6.159701835e-12,216585424,14248392,423573276
1295000,3292784243,57377943,7.746022305e-12,208610640,46804472,470377748
1300000,5289811729,57265528,7.73084628e-12,212150469,46601048,516978796
1305000,2186420218,41136103,5.553373905e-12,211355952,9713856,526692652
1310000,4372295999,37712692,5.0912134200000006e-12,202911597,2958976,529651628
1315000,2186065934,37561575,5.070812625e-12,202062564,2962876,532614504
1320000,4772470347,39052737,5.272119495e-12,203779106,2960124,535574628
1325000,2065619354,38051107,5.136899445000001e-12,202686353,2960472,538535100
1330000,237145632,38030869,5.1341673150000005e-12,203258984,2960152,541495252
1335000,2168981822,38985741,5.263075035000001e-12,201853434,2960048,544455300
1340000,3867759119,35154268,4.74582618e-12,203927952,-296832344,247622956
1345000,2245318548,21722909,2.932592715e-12,175340548,2959924,250582880
1350000,141827584,21778331,2.9400746850000004e-12,177141784,2965872,253548752
1355000,2927561251,21757959,2.937324465e-12,176479696,2961548,256510300
1360000,2749875462,21703857,2.930020695e-12,174721379,2962312,259472612
1365000,3280798834,21766084,2.9384213400000002e-12,174956871,2958928,262431540
1370000,2071885477,21752113,2.9365352550000003e-12,176289694,2960828,265392368
1375000,3511631491,21739839,2.934878265e-12,175890780,2961556,268353924
1380000,2970815967,21751282,2.9364230700000004e-12,176262691,2965384,271319308
1385000,2374744657,21730537,2.933622495e-12,175588455,2961180,274280488
1390000,4538770108,21705799,2.9302828650000003e-12,174784478,2964860,277245348
1395000,3675002200,21803440,2.9434644e-12,176170918,2961304,280206652
1400000,3463372941,21729135,2.9334332249999998e-12,175542909,2960848,283167500
1405000,2681743303,21714053,2.931397155e-12,175052741,2964940,286132440
1410000,2792591503,21742849,2.9352846150000006e-12,174201719,2960616,289093056
1415000,144638882,21671390,2.9256376500000003e-12,173666203,2962888,292055944
1420000,3065414860,21547666,2.90893491e-12,169645164,2958096,295014040
1425000,2188866316,21541338,2.90808063e-12,169439515,2960008,297974048
1430000,4135127709,21597141,2.9156140350000003e-12,171253087,2963860,300937908
1435000,2857502065,21718633,2.932015455e-12,173414690,2963344,303901252
1440000,2262478285,21763387,2.9380572450000003e-12,176656080,2963056,306864308
1445000,2637526956,21709286,2.93075361e-12,174897813,2960360,309824668
1450000,4028391183,21816259,2.945194965e-12,176587541,2964752,312789420
1455000,2126265526,21782627,2.940654645e-12,177281380,2964464,315753884
1460000,4025944599,21781893,2.9405555550000002e-12,175470655,2962168,318716052
1465000,2710732827,21719505,2.932133175e-12,175229918,2963912,321679964
1470000,4686674747,21670165,2.925472275e-12,173626363,2962088,324642052
1475000,2279874210,21775923,2.9397496050000003e-12,175276632,2955552,327597604
1480000,3978813704,21724427,2.932797645e-12,175389885,2964684,330562288
1485000,2553161301,21709734,2.93081409e-12,174912386,2963348,333525636
1490000,4198846687,21773775,2.9394596250000003e-12,175206822,2963540,336489176
1495000,2697534908,21667186,2.9250701100000003e-12,173529555,2963348,339452524
1500000,3951215507,21717156,2.93181606e-12,175153588,2960472,342412996
1505000,3035771904,21727034,2.93314959e-12,173687740,2963476,345376472
1510000,2864878175,21750657,2.9363386950000002e-12,176242375,2961828,348338300
1515000,2081833354,21729561,2.9334907350000004e-12,175556766,2960928,351299228
1520000,3472916042,21772510,2.9392888500000002e-12,175165709,2961996,354261224
1525000,3359270658,21733394,2.93400819e-12,175681321,2963764,357224988
1530000,3675928144,21742168,2.93519268e-12,174179586,2960680,360185668
1535000,3145105774,21724319,2.932783065e-12,175386386,2959044,363144712
1540000,2393176587,21683569,2.9272818150000006e-12,174062000,2959092,366103804
1545000,335739569,21764187,2.938165245e-12,174895198,2965364,369069168
1550000,2101717095,21699290,2.9294041500000004e-12,174572744,2962872,372032040
1555000,2917374615,21687805,2.9278536750000004e-12,174199675,2959260,374991300
1560000,3768067831,21803566,2.9434814100000004e-12,176175041,2960792,377952092
1565000,2253486532,21692881,2.928538935e-12,174364637,2960920,380913012
1570000,2843868851,21749984,2.93624784e-12,176220507,2963488,383876500
1575000,2061260829,21676594,2.9263401900000003e-12,173835311,2960248,386836748
1580000,3355925499,21767612,2.93862762e-12,175006526,2961972,389798720
1585000,4264265897,21725325,2.932918875e-12,175419072,2961368,392760088
1590000,7943731717,21754520,2.9368602e-12,174581022,2962296,395722384
1595000,2081962745,21739099,2.9347783650000003e-12,175866738,2960140,398682524
1600000,2945837688,21685516,2.9275446600000002e-12,174125269,2960872,401643396
1605000,2142194870,21770414,2.93900589e-12,176884460,2967728,404611124
1610000,3490582932,21902394,2.95682319e-12,181173837,2960680,407571804
1615000,2921805127,21842832,2.94878232e-12,179238065,2963836,410535640
1620000,3395940888,21953589,2.9637345150000004e-12,181050778,2962792,413498432
1625000,2857314283,21890496,2.9552169600000003e-12,180787118,2962500,416460932
1630000,4142362965,21926058,2.9600178300000003e-12,180156004,2963524,419424456
1635000,2360087686,21920955,2.959328925e-12,181777057,2964340,422388796
1640000,2205775781,21913123,2.9582716050000004e-12,179735642,2965412,425354208
1645000,3320856187,21905143,2.957194305e-12,181263175,2964368,428318576
1650000,2599013485,21855979,2.9505571650000002e-12,179665342,2960868,431279444
1655000,4454239699,21938452,2.9616910200000004e-12,180558810,2965408,434244852
1660000,3444747139,21882974,2.9542014900000004e-12,180542659,2963748,437208600
1665000,2105135754,21852345,2.9500665750000002e-12,179547214,2957520,440166120
1670000,3277199611,21896328,2.9560042800000002e-12,180976669,2960560,443126680
1675000,2488918316,21837801,2.9481031350000002e-12,179074546,2961544,446088224
1680000,2775607523,21895793,2.955932055e-12,180959305,2960968,449049192
1685000,3422379815,21864423,2.9516971050000002e-12,179939757,2967192,452016384
1690000,2066437631,21856021,2.9505628350000004e-12,179666683,2960988,454977372
1695000,61719428,21879418,2.9537214300000003e-12,180427095,2961484,457938856
1700000,2538673318,21875813,2.953234755e-12,180309920,2962500,460901356
1705000,4118202809,21990544,2.9687234399999998e-12,182251811,2969976,463871332
1710000,3638854441,22033925,2.9745798750000004e-12,185448583,2960204,466831536
1715000,3315508090,21963523,2.965075605e-12,181373620,2960424,469791960
1720000,4084655864,21877015,2.9533970250000002e-12,180349017,2958696,472750656
1725000,3197108298,21873993,2.952989055e-12,178463892,2959696,475710352
1730000,3053647588,21859743,2.9510653050000002e-12,179787666,2962332,478672684
1735000,2191834845,21808900,2.9442015000000004e-12,178135268,2960740,481633424
1740000,2787492360,21912026,2.9581235100000004e-12,181486860,2958676,484592100
1745000,3052872425,21837460,2.9480571000000002e-12,179063467,2962036,487554136
1750000,2700982563,21909616,2.95779816e-12,181408524,2962792,490516928
1755000,2864674566,21892670,2.9555104500000005e-12,180857789,2970620,493487548
1760000,2479920174,21862113,2.951385255e-12,179864686,2964248,496451796
1765000,4177671648,21975495,2.9666918250000004e-12,181762726,2961104,499412900
1770000,2203706148,21846282,2.9492480700000004e-12,179350195,2962628,502375528
1775000,3933127890,21961403,2.964789405e-12,181304718,2966120,505341648
1780000,2218206296,21875663,2.953214505e-12,180305059,2960300,508301948
1785000,4244083445,21869978,2.95244703e-12,180120312,2962376,511264324
1790000,2569126651,21936984,2.96149284e-12,180511124,2959208,514223532
1795000,4282138964,21907465,2.9575077750000003e-12,181338621,2963592,517187124
1800000,2100668266,21989129,2.968532415e-12,182205822,2960284,520147408
1805000,173229791,21883473,2.9542688550000005e-12,180558888,2966808,523114216
1810000,2534070761,21826906,2.94663231e-12,176933595,2960628,526074844
1815000,191426654,21709951,2.9308433850000005e-12,174919417,2958516,529033360
1820000,2429637186,21823879,2.946223665e-12,176835209,2965244,531998604
1825000,1629085136,21730430,2.9336080499999997e-12,175585004,2958104,534956708
1830000,2644202404,21759187,2.937490245e-12,176519601,2965768,537922476
1835000,2102134086,21739833,2.934877455e-12,175890568,2961296,540883772
1840000,3961126836,21729555,2.933489925e-12,175556541,2964020,543847792
1845000,2256931084,21781233,2.940466455e-12,177236092,2963884,546811676
1850000,6839254428,21758858,2.93744583e-12,174722034,2959732,549771408
1855000,3741221723,21792266,2.9419559100000003e-12,177594656,2963488,552734896
1860000,2123061968,21822349,2.9460171150000003e-12,178572342,2965504,555700400
1865000,2732140383,21846160,2.9492316000000005e-12,179346205,2961948,558662348
1870000,2355053486,21789217,2.9415442950000002e-12,175708690,2959988,561622336
1875000,2098126224,22242213,3.0026987550000005e-12,176052948,2967652,564589988
1880000,4197302291,41686722,5.62770747e-12,222184644,2960660,567550648
1885000,2068559285,41625517,5.619444795e-12,221945545,2964788,570515436
1890000,2364280784,41650272,5.6227867200000004e-12,222773556,2960756,573476192
1895000,2078158711,41591148,5.61480498e-12,220901529,2959980,576436172
1900000,4447502492,41643214,5.621833890000001e-12,222590516,2960296,579396468
1905000,2524033440,41634041,5.620595535000001e-12,222258257,2961372,582357840
1910000,2359662863,41662437,5.624428995000001e-12,221301030,2963992,585321832
1915000,4383167635,41631808,5.62029408e-12,220287524,2962856,588284688
1920000,3380266265,41595509,5.6153937150000004e-12,221083705,2961588,591246276
1925000,2395564092,41701387,5.629687245e-12,224334636,2965616,594211892
1930000,3577538199,55094241,7.437722535e-12,226267200,38882508,633094400
1935000,3751664395,57635194,7.78075119e-12,216656086,46686472,679780872
1940000,2577386524,57187082,7.72025607e-12,215511594,46769220,726550092
1945000,5797104846,54193807,7.316163945000001e-12,216555903,39260484,765810576
1950000,3593470297,38017507,5.132363445e-12,207995809,2962964,768773540
1955000,3292878166,37852516,5.11008966e-12,211306606,2963104,771736644
1960000,2808780347,37762721,5.0979673350000005e-12,206123604,2960104,774696748
1965000,4081676210,37801313,5.103177255e-12,206829558,2960856,777657604
1970000,2844507226,40503653,5.467993155e-12,206879940,2961120,780618724
1975000,4600965140,38578933,5.208155955e-12,206421787,2962372,783581096
1980000,2292020290,38206524,5.1578807400000006e-12,206934756,2964252,786545348
1985000,3157381231,37955195,5.1239513250000006e-12,207021056,2959480,789504828
1990000,2247237404,38778898,5.23515123e-12,206356208,2959988,792464816
1995000,2764453486,38127341,5.147191035000001e-12,206957078,2962452,795427268
2000000,2307761494,38081005,5.140935675e-12,205812262,2965800,798393068
2005000,2658662084,25115942,3.3906521700000005e-12,206840171,-431015652,367377416
2010000,3245370449,21863141,2.9515240350000003e-12,179898092,2963568,370340984
2015000,2062900733,21907977,2.957576895e-12,181355278,2957280,373298264
2020000,2191897875,21850288,2.94978888e-12,179480362,2958652,376256916
2025000,1488255830,21932165,2.9608422750000002e-12,179659973,2963276,379220192
2030000,2335224763,21882251,2.954103885e-12,180519163,2961012,382181204
2035000,137854476,21846064,2.94921864e-12,179343085,2962452,385143656
2040000,3297116194,21955108,2.96393958e-12,180405623,2964904,388108560
2045000,2067403392,21828667,2.946870045e-12,178777678,2962712,391071272
2050000,36939459,21881883,2.954054205e-12,180507213,2961012,394032284
2055000,2274517983,21866794,2.95201719e-12,180016824,2963548,396995832
2060000,2851569774,21880810,2.9539093500000003e-12,180472346,2960224,399956056
2065000,2941314116,21734457,2.9341516950000003e-12,175715885,2959788,402915844
2070000,4840293946,21813828,2.94486678e-12,175814018,2963232,405879076
2075000,2228212900,21718978,2.93206203e-12,175212803,2961004,408840080
2080000,2902641762,21782897,2.940691095e-12,174808752,2960052,411800132
2085000,3185686935,21761452,2.93779602e-12,176593207,2959708,414759840
2090000,2064364138,21810970,2.94448095e-12,178202537,2964540,417724380
2095000,2627885895,21926629,2.9600949150000005e-12,181961470,2963388,420687768
2100000,5697006049,21795206,2.94235281e-12,175208816,2957028,423644796
2105000,3746836202,21767340,2.9385909e-12,176784549,2963636,426608432
2110000,3604748892,21917893,2.958915555e-12,181677550,2959168,429567600
2115000,3462792382,21851154,2.94990579e-12,179508518,2965280,432532880
2120000,3253373752,21909297,2.957755095e-12,181398182,2961736,435494616
2125000,2199762877,21941211,2.962063485e-12,179953951,2966256,438460872
2130000,4054918406,21900157,2.956521195e-12,181101123,2964644,441425516
2135000,2093437180,21902438,2.9568291299999998e-12,181175266,2961240,444386756
2140000,2386554968,21869098,2.9523282300000002e-12,180091707,2964252,447351008
2145000,2205044046,21905905,2.9572971750000003e-12,181287947,2961204,450312212
2150000,3969593781,21859291,2.951004285e-12,179772977,2962328,453274540
2155000,2332127844,21920225,2.9592303750000003e-12,181753316,2963072,456237612
2160000,2462125334,21908026,2.95758351e-12,178875461,2962764,459200376
2165000,4532480210,21852991,2.950153785e-12,179568235,2961696,462162072
2170000,3135944979,21888545,2.9549535750000005e-12,180723743,2960596,465122668
2175000,3969484344,21910129,2.957867415e-12,178943809,2961460,468084128
2180000,2263540260,21951028,2.9633887800000003e-12,180273001,2957580,471041708
2185000,151223940,21867578,2.95212303e-12,180042315,2963396,474005104
2190000,2255415331,21890867,2.955267045e-12,180799206,2963520,476968624
2195000,2073953860,21872985,2.952852975e-12,180218015,2961076,479929700
2200000,4394216348,21905782,2.95728057e-12,181283933,2961948,482891648
2205000,2835328538,21927471,2.960208585e-12,179507420,2963052,485854700
2210000,2965768353,21877801,2.953503135e-12,180374562,2963072,488817772
2215000,2209404444,21772411,2.9392754850000003e-12,174467957,2959144,491776916
2220000,2364569106,21718437,2.9319889950000003e-12,175195222,2960400,494737316
2225000,2613705653,21810767,2.944453545e-12,175714531,2967224,497704540
2230000,2073840504,21720063,2.9322085050000003e-12,175248065,2965044,500669584
2235000,4400264384,21819270,2.9456014500000003e-12,175990886,2965912,503635496
2240000,2078949412,21697282,2.9291330700000004e-12,174507678,2962360,506597856
2245000,4416093218,21797741,2.9426950350000004e-12,177772614,2963256,509561112
2250000,2896248835,22015975,2.9721566250000002e-12,182383784,2967736,512528848
2255000,3345614701,21916155,2.9586809249999998e-12,181621041,2962708,515491556
2260000,2099619218,21895657,2.9559136950000003e-12,180954862,2965252,518456808
2265000,6173157868,21938850,2.96174475e-12,179877221,2961928,521418736
2270000,2660750591,21982926,2.96769501e-12,181309701,2963008,524381744
2275000,169456995,21861905,2.951357175e-12,179857912,2961704,527343448
2280000,2200833056,21918548,2.95900398e-12,181698835,2960712,530304160
2285000,3199146753,21878201,2.9535571350000002e-12,180387563,2960972,533265132
2290000,4393798018,21866651,2.951997885e-12,180012169,2963500,536228632
2295000,2347339309,21877444,2.95345494e-12,180362687,2959976,539188608
2300000,3742193529,21867120,2.9520612e-12,180027413,2962152,542150760
2305000,2098160964,21908838,2.95769313e-12,181383251,2961088,545111848
2310000,2873314497,21915800,2.958633e-12,181609518,2958784,548070632
2315000,2615722593,21979001,2.967165135e-12,181182142,2961336,551031968
2320000,2309385606,21924617,2.959823295e-12,181896073,2961456,553993424
2325000,4153596272,21970187,2.9659752450000005e-12,180895669,2965036,556958460
2330000,2296409255,21909598,2.95779573e-12,181407942,2962852,559921312
2335000,4272743119,21916602,2.95874127e-12,181635568,2961012,562882324
2340000,2903450504,21966652,2.96549802e-12,180780814,2960280,565842604
2345000,2171814230,21927305,2.960186175e-12,181983408,2960908,568803512
2350000,3834282159,21955185,2.963949975e-12,180408136,2964336,571767848
2355000,2686494769,21926592,2.9600899200000003e-12,181960253,2966760,574734608
2360000,3042137102,21884669,2.954430315e-12,180597763,2964480,577699088
2365000,3230338614,21890546,2.9552237100000002e-12,178307352,2962864,580661952
2370000,2156033841,21760785,2.937705975e-12,176571532,2959956,583621908
2375000,3283748698,21795310,2.94236685e-12,177693582,2964740,586586648
2380000,3478869346,21917954,2.95892379e-12,181679530,2959616,589546264
2385000,12071243467,22011588,2.9715643800000003e-12,179759824,2957740,592504004
2390000,2146037613,21907183,2.9574697050000004e-12,181329477,2960964,595464968
2395000,2192085517,21936359,2.9614084650000002e-12,179796276,2962040,598427008
2400000,3364725625,21887047,2.9547513450000002e-12,180675055,2961052,601388060
2405000,2236736860,21988937,2.968506495e-12,181505051,2963256,604351316
2410000,2075915814,21847939,2.9494717650000005e-12,179404020,2963828,607315144
2415000,2380373336,21909741,2.9578150350000005e-12,181412613,2964512,610279656
2420000,2732511016,21859068,2.95097418e-12,179765726,2958440,613238096
2425000,2132762266,21977225,2.966925375e-12,181124414,2962528,616200624
2430000,7302959065,21870842,2.9525636700000004e-12,180148384,2965680,619166304
2435000,3166720420,21942510,2.96223885e-12,179996179,2959916,622126220
2440000,3760348884,21911351,2.9580323850000003e-12,181464921,2959604,625085824
2445000,2131935676,21923562,2.9596808700000004e-12,179380376,2962396,628048220
2450000,4402704180,21913478,2.9583195300000002e-12,181534050,2961724,631009944
2455000,2082051512,21969205,2.965842675e-12,180863771,2970552,633980496
2460000,2177906862,21870113,2.952465255e-12,180124701,2960656,636941152
2465000,4150346891,21904105,2.957054175e-12,178747702,2961972,639903124
2470000,2145977051,21869172,2.95233822e-12,180094094,2961836,642864960
2475000,5568385298,21900260,2.9565351000000002e-12,178623039,2960460,645825420
2480000,2305647904,21914494,2.9584566900000003e-12,181567058,2959568,648784988
2485000,2090996540,21843853,2.9489201550000003e-12,179271226,2964204,651749192
2490000,3202146721,21897845,2.9562090750000003e-12,181025994,2961520,654710712
2495000,2599124955,21925052,2.9598820200000002e-12,179428816,2961832,657672544
2500000,4068081037,21839408,2.9483200800000004e-12,179126758,2963460,660636004
2505000,2580914376,21897550,2.95616925e-12,181016379,2960588,663596592
2510000,3110204444,21926492,2.96007642e-12,179475588,2962456,666559048
2515000,2138641722,21889633,2.955100455e-12,180759089,2961876,669520924
2520000,5716280964,21939299,2.961805365e-12,179891830,2966628,672487552
2525000,2178300680,21864692,2.95173342e-12,179948499,2964704,675452256
2530000,2870022402,21910395,2.957903325e-12,181433861,2960336,678412592
2535000,3485195980,22044673,2.9760308550000005e-12,185797880,2959728,681372320
2540000,2950168685,22026304,2.97355104e-12,182719485,2962504,684334824
2545000,3093275329,21869015,2.952317025e-12,180089013,2961412,687296236
2550000,3577348027,21845404,2.94912954e-12,179321630,2964692,690260928
2555000,2124565828,22001703,2.9702299049999997e-12,181919952,2966604,693227532
2560000,2234363602,21859548,2.95103898e-12,179781336,2958612,696186144
2565000,2712388880,21880529,2.953871415e-12,180463199,2964248,699150392
2570000,93002132,21864739,2.951739765e-12,179950043,2960840,702111232
2575000,2203770062,21944535,2.962512225e-12,182543401,2963724,705074956
2580000,2886579025,22070333,2.979494955e-12,186631855,2962212,708037168
2585000,4373413931,22013955,2.9718839250000003e-12,184799564,2962684,710999852
2590000,2208495110,22014337,2.971935495e-12,184811953,2961504,713961356
2595000,111378028,22029895,2.974035825e-12,185317600,2961688,716923044
2600000,2313126296,22111285,2.9850234750000005e-12,185481387,2960856,719883900
2605000,2123827781,22058299,2.9778703650000002e-12,186240734,2958980,722842880
2610000,2865369824,22025957,2.973504195e-12,185189631,2967884,725810764
2615000,4533826773,22015372,2.9720752200000002e-12,184845611,2964644,728775408
2620000,2102742665,22034492,2.9746564200000003e-12,185467008,2964784,731740192
2625000,3681576906,22114833,2.9855024549999998e-12,185596692,2965352,734705544
2630000,3502944293,22029821,2.974025835e-12,185315182,2967192,737672736
2635000,2467448871,22048059,2.9764879650000003e-12,185907544,2960588,740633324
2640000,3416359187,22114079,2.9854006650000005e-12,185572183,2960160,743593484
2645000,4050962811,22073576,2.9799327600000003e-12,186737233,2958644,746552128
2650000,4161775566,22107122,2.98446147e-12,185346087,2966180,749518308
2655000,2107258295,22040398,2.97545373e-12,185658939,2963012,752481320
2660000,4445208197,22035319,2.9747680650000003e-12,185493868,2959652,755440972
2665000,3557115097,22091264,2.98232064e-12,184830702,2964092,758405064
2670000,2088563875,22020611,2.972782485e-12,185015871,2964312,761369376
2675000,2376711132,22004803,2.970648405e-12,182020709,2961256,764330632
2680000,6298899304,21908191,2.9576057850000004e-12,181362230,2961404,767292036
2685000,2293346199,21868467,2.9522430450000003e-12,180071204,2963404,770255440
2690000,3004002581,21955241,2.963957535e-12,180409946,2963508,773218948
2695000,2066734114,21882660,2.9541591e-12,180532460,2965720,776184668
2700000,3838063445,22111944,2.98511244e-12,185502768,2959712,779144380
2705000,2466007529,21961758,2.96483733e-12,183103150,2965196,782109576
2710000,3299808531,22056145,2.977579575e-12,186170734,2964912,785074488
2715000,2701322111,22014513,2.971959255e-12,184817701,2963376,788037864
2720000,3200098799,22067669,2.9791353150000002e-12,186545267,2962420,791000284
2725000,2200833020,22092143,2.9824393050000002e-12,184859245,2963540,793963824
2730000,2235462383,22137453,2.988556155e-12,186331837,2957184,796921008
2735000,415207211,22000726,2.97009801e-12,184369605,2966732,799887740
2740000,3956811479,22043739,2.975904765e-12,185767542,2966300,802854040
2745000,2226732586,22143094,2.9893176900000002e-12,186515167,2959020,805813060
2750000,2880765691,22022715,2.9730665250000004e-12,185084263,2963684,808776744
2755000,3927731431,22149732,2.99021382e-12,186730901,2965400,811742144
2760000,2183462060,22020240,2.9727324e-12,185003819,2959080,814701224
2765000,4772895946,22107376,2.98449576e-12,185354317,2961976,817663200
2770000,3275298797,22027745,2.973745575e-12,185247713,2960204,820623404
2775000,2710680247,22091482,2.98235007e-12,184837769,2960844,823584248
2780000,3291379770,22025655,2.973463425e-12,185179796,2962284,826546532
2785000,2584003566,22080080,2.9808108e-12,184467221,2961048,829507580
2790000,2583213180,22792019,3.0769225650000004e-12,186317656,2962620,832470200
2795000,2260298786,41877508,5.6534635799999995e-12,230177574,2961932,835432132
2800000,3033735832,42007838,5.671058130000001e-12,231841686,2961936,838394068
2805000,2192337736,41917589,5.658874515e-12,230575150,2962708,841356776
2810000,2292905552,41933183,5.6609797050000005e-12,231876451,2962708,844319484
2815000,6987016971,41906333,5.657354955e-12,231077846,2962912,847282396
2820000,2844075884,41993027,5.669058645e-12,231118217,2963412,850245808
2825000,2064151478,41890767,5.655253545e-12,230565025,2962012,853207820
2830000,3160969846,41939331,5.661809685e-12,229422138,2964124,856171944
2835000,2339195926,41777128,5.639912280000001e-12,226898646,2960916,859132860
2840000,3288051460,41724092,5.63275242e-12,225185759,2962312,862095172
2845000,2147398944,41752520,5.6365902e-12,226145812,2960540,865055712
2850000,1138327128,41919724,5.65916274e-12,231510586,2964388,868020100
2855000,2900826681,41910000,5.657850000000001e-12,231204915,2964060,870984160
2860000,5125070711,42008763,5.671183005000001e-12,231754087,2960936,873945096
2865000,2102850817,41999411,5.6699204850000005e-12,231302581,2962828,876907924
2870000,2936300285,55732159,7.523841465e-12,231387488,40364464,917272388
2875000,4623245049,57853524,7.810225740000001e-12,220217037,46789204,964061592
2880000,3341768560,57693747,7.788655845000001e-12,220113059,46670980,1010732572
2885000,2682266323,57401543,7.749208305e-12,220608055,46809864,1057542436
2890000,2197244215,39984697,5.397934095e-12,219730639,6521852,1064064288
2895000,2410245498,38014926,5.13201501e-12,212350546,2964128,1067028416
2900000,3288885946,37883572,5.11428222e-12,211804670,2961008,1069989424
2905000,2102807483,38043806,5.135913810000001e-12,213049796,2960432,1072949856
2910000,4720104103,37944650,5.12252775e-12,212957133,2959600,1075909456
2915000,2069235062,37947573,5.122922355e-12,212170590,2963708,1078873164
2920000,4014830104,37886038,5.1146151300000005e-12,211480989,2963108,1081836272
2925000,2651370117,37967184,5.12556984e-12,211519792,2956048,1084792320
2930000,112951598,38094867,5.1428070450000004e-12,212459227,2961064,1087753384
2935000,2234278552,41738665,5.634719775e-12,211627012,2961348,1090714732
2940000,3510494365,39681380,5.3569863e-12,212349791,2961436,1093676168
2945000,2094926716,38359139,5.178483765e-12,212114423,2962320,1096638488
2950000,2173363823,37973618,5.12643843e-12,212098265,2962032,1099600520
2955000,3695736029,38353462,5.17771737e-12,211750331,2967712,1102568232
2960000,5347371201,39004227,5.265570645e-12,212104511,2964036,1105532268
2965000,3310315197,37997017,5.129597295e-12,211932665,2962808,1108495076
2970000,2175715196,36586758,4.9392123299999995e-12,213152526,-565259940,543235136
2975000,2452818532,22024013,2.973241755e-12,185126451,2964000,546199136
2980000,4406544050,22062421,2.978426835e-12,186374703,2960220,549159356
2985000,2703325305,22112746,2.98522071e-12,184437429,2962212,552121568
2990000,3749871811,22043491,2.9758712850000003e-12,185759487,2959304,555080872
2995000,3359894132,21887367,2.954794545e-12,180685446,2963312,558044184
3000000,3118070614,22003881,2.970523935e-12,180899332,2963372,561007556
3005000,2619772597,21846656,2.94929856e-12,179362336,2964288,563971844
3010000,4665855092,22007501,2.971012635e-12,181016980,2960292,566932136
3015000,2489502844,21872878,2.95283853e-12,180214558,2962328,569894464
3020000,4067055522,21906024,2.9573132400000002e-12,181291807,2963088,572857552
3025000,3483765541,21993430,2.9691130500000002e-12,180559685,2962436,575819988
3030000,2582599278,21910911,2.957972985e-12,181450633,2958200,578778188
3035000,2624534751,22060171,2.978123085e-12,186301582,2959112,581737300
3040000,3887191191,22144189,2.9894655150000003e-12,185459335,2964868,584702168
3045000,2161332469,22057748,2.97779598e-12,186222825,2960980,587663148
3050000,2267122939,22027739,2.973744765e-12,185247541,2965140,590628288
3055000,3675045573,22041265,2.9755707750000005e-12,185687145,2963688,593591976
3060000,2058593308,22022285,2.9730084750000004e-12,185070258,2961160,596553136
3065000,2594086555,22027707,2.9737404450000002e-12,185246507,2964696,599517832
3070000,3024388040,22149560,2.9901906e-12,185633882,2959936,602477768
3075000,2272869665,22016813,2.972269755e-12,184892441,2965360,605443128
3080000,2167103345,22061937,2.9783614950000005e-12,186358956,2966172,608409300
3085000,4104555077,22034129,2.974607415e-12,185455223,2963904,611373204
3090000,3575673009,22136568,2.98843668e-12,185211663,2963236,614336440
3095000,3254450602,22060732,2.9781988200000003e-12,186319816,2967112,617303552
3100000,2068061219,22163709,2.992100715e-12,186093739,2962388,620265940
3105000,3345542722,22048522,2.97655047e-12,185922979,2958352,623224292
3110000,3391424002,21991708,2.9688805800000003e-12,180503715,2956512,626180804
3115000,2531607898,21938163,2.961652005e-12,182336301,2964120,629144924
3120000,4048105758,21878943,2.953657305e-12,180411652,2962272,632107196
3125000,2150954719,22081123,2.980951605e-12,183409689,2966204,635073400
3130000,3647547259,21913142,2.95827417e-12,181523127,2958588,638031988
3135000,3623290881,21944508,2.96250858e-12,182542525,2963984,640995972
3140000,4378479163,22004911,2.970662985e-12,180932799,2965248,643961220
3145000,2099670478,22042270,2.97570645e-12,185719789,2959460,646920680
3150000,4184649495,22162451,2.9919308850000003e-12,186052842,2962388,649883068
3155000,3340444418,22016985,2.972292975e-12,184898008,2964260,652847328
3160000,3252545956,21940941,2.9620270350000004e-12,182426580,2959672,655807000
3165000,2778163435,21910072,2.95785972e-12,181423350,2960960,658767960
3170000,241443372,21934975,2.9612216250000003e-12,182232710,2959912,661727872
3175000,2514967770,22003597,2.970485595e-12,180890089,2960336,664688208
3180000,4458434371,21941181,2.962059435e-12,182434405,2961044,667649252
3185000,2965094625,21996241,2.969492535e-12,180651035,2965808,670615060
3190000,3009318526,21911913,2.9581082550000002e-12,181483006,2960300,673575360
3195000,3805020646,22058585,2.977908975e-12,182677189,2963152,676538512
3200000,2056805525,21909590,2.9577946500000003e-12,181407683,2963548,679502060
3205000,119521289,21967753,2.965646655e-12,183297977,2956232,682458292
3210000,3449244647,21884550,2.95441425e-12,177021079,2958896,685417188
3215000,4210368983,21732767,2.9339235450000003e-12,175660950,2961092,688378280
3220000,2325882327,21903520,2.9569752000000002e-12,177637598,2961604,691339884
3225000,4732510485,21786691,2.941203285e-12,177413468,2960332,694300216
3230000,2505147503,21950989,2.9633835149999998e-12,182753152,2962960,697263176
3235000,3315999808,21902198,2.95679673e-12,181167460,2962380,700225556
3240000,4135275447,21948542,2.9630531700000004e-12,182673621,2967248,703192804
3245000,2069725101,21906494,2.95737669e-12,181307059,2963428,706156232
3250000,2065196763,22002976,2.9704017600000002e-12,180869917,2962376,709118608
3255000,4172131378,21967271,2.9655815850000006e-12,183282322,2963484,712082092
3260000,3314770267,21880856,2.95391556e-12,180473835,2960592,715042684
3265000,4582381933,22017263,2.9723305050000002e-12,181334233,2963460,718006144
3270000,2470442728,21935332,2.96126982e-12,182244292,2959620,720965764
3275000,297442932,21911259,2.958019965e-12,181461935,2963736,723929500
3280000,2327167533,21936146,2.96137971e-12,182270773,2965824,726895324
3285000,2479200820,22028698,2.97387423e-12,181705893,2962152,729857476
3290000,4309662312,21906795,2.9574173250000002e-12,181316866,2960072,732817548
3295000,2786266657,22030763,2.974153005e-12,181772986,2964944,735782492
3300000,3362882227,21881247,2.953968345e-12,180486542,2963324,738745816
3305000,2318061774,21872699,2.9528143650000002e-12,180208722,2961356,741707172
3310000,5776787934,22043298,2.9758452300000004e-12,182180362,2963624,744670796
3315000,2203527456,21896209,2.9559882150000003e-12,180972800,2959104,747629900
3320000,2636232363,21934588,2.9611693800000003e-12,182220111,2963492,750593392
3325000,3524638880,21896919,2.9560840650000003e-12,180995896,2960112,753553504
3330000,2201114928,21958299,2.9643703650000004e-12,182990744,2962884,756516388
3335000,2651905460,21878233,2.953561455e-12,180388572,2961252,759477640
3340000,3019258369,21997396,2.96964846e-12,180688575,2963924,762441564
3345000,2067215314,21909974,2.9578464900000003e-12,181420186,2961732,765403296
3350000,2066012106,21856322,2.9506034699999997e-12,179676475,2965216,768368512
3355000,3231705498,22035624,2.9748092400000002e-12,181930984,2964768,771333280
3360000,2257360973,22033880,2.9745738e-12,185446845,2962904,774296184
3365000,2132383597,22119615,2.9861480250000002e-12,184660690,2959600,777255784
3370000,3580301081,22050296,2.9767899600000003e-12,185980619,2959652,780215436
3375000,2226853293,22130268,2.98758618e-12,185006909,2965948,783181384
3380000,2836248956,22068190,2.9792056500000005e-12,186562191,2960564,786141948
3385000,5830392610,22125043,2.986880805e-12,184837083,2964432,789106380
3390000,2144472990,22071628,2.97966978e-12,186673913,2963348,792069728
3395000,3924759785,22026091,2.9735222850000002e-12,185193958,2962016,795031744
3400000,2315719617,22148743,2.990080305e-12,185607352,2960876,797992620
3405000,3102718899,22047229,2.9763759150000003e-12,185880966,2961064,800953684
3410000,3038261817,22119355,2.986112925e-12,184652246,2960084,803913768
3415000,3905706371,22004228,2.9705707800000002e-12,184483423,2958656,806872424
3420000,2824927641,21994749,2.969291115e-12,184175350,2957628,809830052
3425000,3546922143,22148043,2.989985805e-12,185584601,2965108,812795160
3430000,2812681664,22010323,2.971393605e-12,184681513,2962768,815757928
3435000,281116354,22056983,2.977692705e-12,186197977,2966708,818724636
3440000,2262056769,22004026,2.97054351e-12,184476871,2962456,821687092
3445000,2598536640,22005603,2.970756405e-12,184528122,2964376,824651468
3450000,2203205484,22153283,2.990693205e-12,185754907,2954776,827606244
3455000,3355590248,22032152,2.97434052e-12,185390956,2960756,830567000
3460000,2211859376,22045555,2.9761499250000004e-12,185826548,2961960,833528960
3465000,2228318430,22010018,2.97135243e-12,184671603,2961996,836490956
3470000,4374053737,22167046,2.9925512099999998e-12,186202172,2964012,839454968
3475000,2171905942,22102469,2.983833315e-12,187676257,2962160,842417128
3480000,4782967267,22218308,2.9994715800000003e-12,191441025,2962828,845379956
3485000,2374081335,22014193,2.9719160549999997e-12,184807277,2962848,848342804
3490000,2837521751,22153943,2.990782305e-12,185776329,2963336,851306140
3495000,3092491527,22032364,2.9743691400000002e-12,185397851,2961976,854268116
3500000,2335446825,22002127,2.970287145e-12,184415134,2963488,857231604
3505000,3906885161,22059035,2.9779697250000003e-12,186264649,2963320,860194924
3510000,3934874224,22021085,2.972846475e-12,181458458,2960128,863155052
3515000,2131389359,21901527,2.9567061449999998e-12,181145638,2963888,866118940
3520000,18501926664,22178770,2.99413395e-12,182295843,2961448,869080388
3525000,2243814957,21866161,2.951931735e-12,179996232,2959016,872039404
3530000,4759607774,22018867,2.9725470450000004e-12,181386041,2959800,874999204
3535000,3370558494,21886043,2.954615805e-12,180642414,2964272,877963476
3540000,2371540898,21885465,2.954537775e-12,180623608,2961948,880925424
3545000,3262647535,21930901,2.9606716350000004e-12,182100308,2962412,883887836
3550000,2793352931,21894852,2.9558050200000002e-12,180928697,2958308,886846144
3555000,2259456202,21910230,2.95788105e-12,181428494,2962324,889808468
3560000,604509599,21887408,2.9548000799999998e-12,177113965,2962068,892770536
3565000,2345670119,21739777,2.934869895e-12,175888775,2963948,895734484
3570000,3047731043,21779162,2.94018687e-12,177168774,2961152,898695636
3575000,2712355742,21826289,2.946549015e-12,175127570,2961292,901656928
3580000,4400842735,21773967,2.939485545e-12,176999944,2959732,904616660
3585000,2183960361,21967262,2.9655803700000003e-12,179709220,2965080,907581740
3590000,2144301985,21921391,2.9593877850000004e-12,181791220,2961904,910543644
3595000,4109377485,22062442,2.9784296700000002e-12,182802577,2962328,913505972
3600000,2158119397,21904525,2.9571108750000002e-12,181243063,2960824,916466796
3605000,732458170,21946963,2.962840005e-12,182622325,2966220,919433016
3610000,2513928652,21982915,2.967693525e-12,180217926,2963700,922396716
3615000,3098625975,21871569,2.9526618150000002e-12,180171992,2960080,925356796
3620000,2310111586,21890335,2.955195225e-12,180781913,2961136,928317932
3625000,670206899,21901971,2.9567660850000004e-12,181160067,2962208,931280140
3630000,2150407711,21913054,2.95826229e-12,181520282,2961860,934242000
3635000,2722962404,22020778,2.9728050300000003e-12,181448480,2963012,937205012
3640000,3463807997,21897013,2.9560967550000003e-12,180998924,2964228,940169240
3645000,2058303094,21916515,2.958729525e-12,181632757,2964024,943133264
3650000,3753529302,21889636,2.95510086e-12,180759188,2958532,946091796
3655000,2821667365,21971459,2.966146965e-12,179845626,2961016,949052812
3660000,2066570915,21924432,2.95979832e-12,181890053,2961656,952014468
3665000,3685106504,21902254,2.95680429e-12,181169283,2962784,954977252
3670000,3175533747,22006024,2.97081324e-12,180968967,2961932,957939184
3675000,3408372631,21916942,2.9587871700000003e-12,181646637,2964864,960904048
3680000,2164251522,21997287,2.9696337450000004e-12,180685035,2961420,963865468
3685000,4045286924,21930670,2.96064045e-12,182092804,2964684,966830152
3690000,2087934714,21923741,2.959705035e-12,181867617,2962684,969792836
3695000,5937047948,22011517,2.9715547950000003e-12,181147493,2958324,972751160
3700000,2120812421,21940253,2.961934155e-12,182403841,2962336,975713496
3705000,2121380274,21807066,2.94395391e-12,178075651,2965192,978678688
3710000,4091519974,21718390,2.93198265e-12,175193701,2962880,981641568
3715000,2468071890,21736119,2.9343760650000003e-12,175769874,2962048,984603616
3720000,3045413442,21769670,2.93890545e-12,176860300,2961632,987565248
3725000,3601617500,21836023,2.9478631050000003e-12,175443948,2958900,990524148
3730000,2267237181,21775688,2.93971788e-12,177055859,2962436,993486584
3735000,6769323373,22030268,2.97408618e-12,181756892,2962496,996449080
3740000,2367197117,21861767,2.9513385450000004e-12,179853455,2958316,999407396
3745000,125833329,21762355,2.9379179250000005e-12,176622544,2966244,1002373640
3750000,2793809948,21852226,2.95005051e-12,179543357,2959040,1005332680
3755000,118679969,21905802,2.95728327e-12,181284573,2965476,1008298156
3760000,3120468437,22009178,2.9712390300000003e-12,181071474,2959056,1011257212
3765000,2434453626,21895766,2.95592841e-12,180958420,2964984,1014222196
3770000,3769060804,22002902,2.9703917700000002e-12,180867489,2961504,1017183700
3775000,2198084566,21892717,2.955516795e-12,180859336,2962244,1020145944
3780000,159789434,21935079,2.9612356650000003e-12,182236072,2962140,1023108084
3785000,2710465118,21916906,2.9587823100000002e-12,181645475,2962520,1026070604
3790000,2248079849,21885998,2.9546097299999998e-12,180640949,2965672,1029036276
3795000,31879934,21927269,2.9601813150000003e-12,181982260,2963904,1032000180
3800000,2278546953,22018669,2.972520315e-12,181379923,2963216,1034963396
3805000,3456328675,21933070,2.96096445e-12,182170798,2963916,1037927312
3810000,2096221447,22022141,2.972989035e-12,181492785,2960552,1040887864
3815000,3233453597,21890219,2.955179565e-12,180778144,2965164,1043853028
3820000,5033365907,22003777,2.970509895e-12,180895950,2959960,1046812988
3825000,3953784424,21901558,2.9567103300000003e-12,181146663,2960992,1049773980
3830000,2202166650,21997036,2.96959986e-12,180676877,2960956,1052734936
3835000,183636700,21904447,2.957100345e-12,181240535,2965872,1055700808
3840000,2231245091,21869293,2.9523545550000005e-12,180098037,2962564,1058663372
3845000,2107805443,21912986,2.95825311e-12,181518051,2960964,1061624336
3850000,1564944859,21880904,2.9539220400000003e-12,180475383,2961004,1064585340
3855000,3329925378,21869353,2.9523626550000003e-12,180099983,2963284,1067548624
3860000,2110928454,21925310,2.95991685e-12,181918579,2968936,1070517560
3865000,2226196695,21730484,2.93361534e-12,175586754,2964380,1073481940
3870000,4227604564,21717849,2.9319096150000003e-12,175175649,2962504,1076444444
3875000,2223874777,21766666,2.93849991e-12,176762668,2967112,1079411556
3880000,3531220406,21836556,2.94793506e-12,175461275,2961596,1082373152
3885000,3847078787,21751269,2.936421315e-12,176262243,2958932,1085332084
3890000,2250722388,21721467,2.932398045e-12,175293686,2960444,1088292528
3895000,8168480116,21946611,2.962792485e-12,179038066,2964744,1091257272
3900000,2628108871,21947609,2.962927215e-12,182643324,2963312,1094220584
3905000,4267882550,21927453,2.960206155e-12,181988223,2965992,1097186576
3910000,2138754239,21999879,2.9699836650000003e-12,180769273,2958032,1100144608
3915000,2739855252,21904993,2.957174055e-12,181258283,2961960,1103106568
3920000,3870469700,21985955,2.968103925e-12,180316725,2967340,1106073908
3925000,2107281265,21938014,2.9616318900000004e-12,182331485,2960144,1109034052
3930000,3050789260,22017411,2.972350485e-12,181339060,2964236,1111998288
3935000,3179399507,21901613,2.9567177550000005e-12,181148455,2962868,1114961156
3940000,2880394423,22048551,2.976554385e-12,182351111,2962448,1117923604
3945000,2613689759,21896349,2.9560071150000003e-12,180977366,2958500,1120882104
3950000,4360710175,22023346,2.97315171e-12,181531920,2958140,1123840244
3955000,2225823851,21959921,2.9645893350000005e-12,183043453,2968928,1126809172
3960000,514896130,21836772,2.94796422e-12,179041096,2960292,1129769464
3965000,2978165715,21881272,2.95397172e-12,180487354,2963312,1132732776
3970000,2281294183,21898606,2.9563118100000003e-12,181050715,2963464,1135696240
3975000,2356760387,21898542,2.9563031700000002e-12,181048636,2960468,1138656708
3980000,3351000436,21903406,2.9569598100000003e-12,181206699,2959568,1141616276
3985000,3058831691,21898165,2.956252275e-12,181036384,2961372,1144577648
3990000,2269630716,21862810,2.9514793500000003e-12,179887328,2962424,1147540072
3995000,2073350225,21901413,2.956690755e-12,181141918,2961028,1150501100
4000000,2215284325,21864041,2.951645535e-12,179927334,2963396,1153464496
4005000,2103260819,21845433,2.949133455e-12,179322579,2960832,1156425328
4010000,4143688322,21925361,2.959923735e-12,181920230,2959456,1159384784
4015000,2721014054,21737113,2.9345102549999998e-12,175802188,2962584,1162347368
4020000,2139606404,21895156,2.9558460600000004e-12,177365767,2961304,1165308672
4025000,128015971,21757721,2.9372923350000005e-12,176471944,2961972,1168270644
4030000,2548052957,21991539,2.968857765e-12,180498222,2957952,1171228596
4035000,2172630804,21855877,2.950543395e-12,179662019,2960788,1174189384
4040000,3711413559,22051626,2.97696951e-12,182450408,2968748,1177158132
4045000,3681733674,21869544,2.9523884400000003e-12,180106198,2962480,1180120612
4050000,3355912104,22048854,2.97659529e-12,182360936,2960828,1183081440
4055000,2137088102,21892741,2.9555200350000004e-12,180860117,2962916,1186044356
4060000,4416727219,21982655,2.967658425e-12,180209495,2961360,1189005716
4065000,2371882485,21927312,2.9601871200000002e-12,181983655,2962516,1191968232
4070000,2562200657,21896429,2.956017915e-12,180979970,2962488,1194930720
4075000,9773177408,22041890,2.97565515e-12,182134609,2961272,1197891992
4080000,4181315176,21886574,2.9546874900000003e-12,180659672,2964036,1200856028
4085000,2187042964,22020366,2.9727494100000004e-12,181435073,2964240,1203820268
4090000,3526507424,21896617,2.956043295e-12,180986086,2958024,1206778292
4095000,3715058481,22008108,2.97109458e-12,180937482,2963008,1209741300
4100000,2162502162,21926410,2.9600653500000005e-12,181954353,2962020,1212703320
4105000,4268129626,21929018,2.9604174300000004e-12,182039102,2962688,1215666008
4110000,2578240538,21886148,2.95462998e-12,180645819,2964712,1218630720
4115000,3830685900,21994552,2.96926452e-12,180496917,2964716,1221595436
4120000,4753185521,21923475,2.9596691250000004e-12,181858942,2967088,1224562524
4125000,3090687520,22015100,2.9720385000000003e-12,181164709,2961380,1227523904
4130000,3210321376,21892783,2.9555257050000002e-12,180861472,2964696,1230488600
4135000,2138157485,22064011,2.978641485e-12,182754312,2962584,1233451184
4140000,3883585327,21903047,2.9569113450000003e-12,181195043,2960272,1236411456
4145000,2980869091,21914471,2.9584535850000003e-12,181566322,2962232,1239373688
4150000,4472475245,22024758,2.97334233e-12,181379383,2965312,1242339000
4155000,2687032497,21895982,2.9559575700000002e-12,180965435,2962208,1245301208
4160000,4898421879,23143741,3.124405035e-12,181421761,2965804,1248267012
4165000,2313738218,41688941,5.628007035e-12,224053430,2961964,1251228976
4170000,2268626778,41719418,5.632121430000001e-12,221073134,2961328,1254190304
4175000,4265329801,41675386,5.62617711e-12,223508396,2966504,1257156808
4180000,2726368939,41767609,5.6386272150000005e-12,226647370,2959148,1260115956
4185000,2804695638,41855914,5.6505483900000006e-12,225392462,2962480,1263078436
4190000,2307140195,41636118,5.6208759300000005e-12,222293656,2963376,1266041812
4195000,4586302244,41801930,5.64326055e-12,223677119,2963776,1269005588
4200000,3232285837,41618253,5.618464155e-12,221763807,2961152,1271966740
4205000,3149563168,41623927,5.619230145000001e-12,221715417,2967360,1274934100
4210000,3341223221,41657565,5.623771275000001e-12,222195124,2960280,1277894380
4215000,2129086298,41577399,5.612948865e-12,220298417,2964724,1280859104
4220000,4619037730,41656943,5.623687305e-12,222901016,2964012,1283823116
4225000,2303607432,41722057,5.632477695e-12,225068384,2964260,1286787376
4230000,3575724442,41907897,5.6575660950000004e-12,227006958,2963232,1289750608
4235000,2895692453,41825206,5.64640281e-12,228394264,2963760,1292714368
4240000,2325178288,41768898,5.63880123e-12,226665487,2960552,1295674920
4245000,3423592509,41934161,5.661111735e-12,227947503,2960008,1298634928
4250000,2664281469,41743400,5.6353590000000006e-12,225652809,2965780,1301600708
4255000,2544941743,41796011,5.642461485000001e-12,227618781,2961288,1304561996
4260000,3348619259,41785610,5.64105735e-12,227256035,2960088,1307522084
4265000,3053466878,41759690,5.63755815e-12,226404843,2961772,1310483856
4270000,4065329286,41772740,5.6393199e-12,226791070,2962036,1313445892
4275000,2936095352,48479057,6.544672695e-12,225842996,21203404,1334649296
4280000,3293960983,57807505,7.804013175e-12,216451280,46780372,1381429668
4285000,4816786582,57617141,7.778314035000001e-12,216258989,46788304,1428217972
4290000,3296297810,57771024,7.79908824e-12,216529164,46759264,1474977236
4295000,6547016823,57436246,7.75389321e-12,216786186,46817780,1521795016
4300000,3853784647,57484240,7.760372400000001e-12,217564684,46708424,1568503440
4305000,3694518699,55367116,7.47456066e-12,215500664,41322932,1609826372
4310000,3950232616,38252809,5.164129215000001e-12,210299924,2963148,1612789520
4315000,2350250601,37801836,5.10324786e-12,207475699,2965240,1615754760
4320000,2685920883,38036337,5.134905495000001e-12,209540841,2963152,1618717912
4325000,4082126003,37772260,5.099255100000001e-12,203789949,2963952,1621681864
4330000,2351626648,37563791,5.071111785e-12,204119244,2965348,1624647212
4335000,3991654483,37836970,5.107990950000001e-12,202123744,2965476,1627612688
4340000,2069680421,37731714,5.09378139e-12,203383904,2965980,1630578668
4345000,3637161211,37891049,5.1152916150000006e-12,204398096,2963208,1633541876
4350000,5560899973,37793785,5.102160975000001e-12,202081139,2961468,1636503344
4355000,4534009995,37875126,5.1131420100000006e-12,205011583,2970396,1639473740
4360000,3241354944,37868040,5.1121854000000004e-12,208574402,2962984,1642436724
4365000,3340149210,37863204,5.11153254e-12,208353251,2960316,1645397040
4370000,3161506201,37770807,5.099058945000001e-12,208627027,2962540,1648359580
4375000,3472314337,40271365,5.436634275e-12,207916210,2962784,1651322364
4380000,2145851297,40776395,5.504813325e-12,208367626,2963948,1654286312
4385000,4294289373,38379754,5.18126679e-12,207620906,2961252,1657247564
4390000,2174201544,38189337,5.155560495e-12,208174293,2965872,1660213436
4395000,3644886309,37774250,5.09952375e-12,207410606,2961752,1663175188
4400000,6985797847,38435116,5.188740660000001e-12,208662805,2963072,1666138260
4405000,2690124391,37847331,5.109389685e-12,207969354,2959736,1669097996
4410000,2852699748,38106867,5.144427045e-12,208868419,2959576,1672057572
4415000,4175211473,38099371,5.143415085e-12,208457639,2963880,1675021452
4420000,2117386311,38474040,5.1939954000000005e-12,210046689,2960012,1677981464
4425000,4327776728,38115424,5.14558224e-12,207557165,2963876,1680945340
4430000,2231500984,38971925,5.261209875e-12,209183329,-867255988,813689352
4435000,2972972144,22048108,2.97649458e-12,180649968,2961860,816651212
4440000,2447271148,21937226,2.96152551e-12,182305866,2965448,819616660
4445000,2308328966,22060343,2.9781463050000003e-12,181047618,2959564,822576224
4450000,2164934724,22059283,2.9780032050000005e-12,181013163,2963404,825539628
4455000,3911631237,21930578,2.9606280300000004e-12,182089812,2960880,828500508
4460000,4657335709,22066015,2.9789120250000002e-12,181231962,2962220,831462728
4465000,2402060474,21849584,2.9496938400000002e-12,179457483,2962324,834425052
4470000,4306353235,22090730,2.98224855e-12,182035195,2958600,837383652
4475000,3261406722,21866505,2.9519781750000003e-12,180007417,2965184,840348836
4480000,2806253956,22064786,2.97874611e-12,181192013,2965672,843314508
4485000,2176058255,21916194,2.9586861900000003e-12,181622315,2966768,846281276
4490000,3149550810,21755031,2.936929185e-12,176384517,2964148,849245424
4495000,2831490406,21755044,2.93693094e-12,176384952,2963276,852208700
4500000,2240925993,21704668,2.9301301800000005e-12,174747735,2959516,855168216
4505000,3045563784,21785238,2.94100713e-12,177366267,2966580,858134796
4510000,4129651742,22064369,2.9786898150000003e-12,181178455,2958716,861093512
4515000,108530721,21892441,2.955479535e-12,180850357,2962032,864055544
4520000,3213240037,21887278,2.95478253e-12,180682556,2959120,867014664
4525000,4698372948,21901539,2.956707765e-12,181146035,2960860,869975524
4530000,3607017430,21867334,2.95209009e-12,180034372,2960528,872936052
4535000,2093846141,21897431,2.956153185e-12,181012524,2963432,875899484
4540000,5322477519,21924293,2.959779555e-12,181885535,2965132,878864616
4545000,2274592524,21862338,2.9514156300000005e-12,179871994,2961836,881826452
4550000,134665299,21919461,2.9591272350000002e-12,181728516,2965708,884792160
4555000,3087772199,21928277,2.960317395e-12,182015003,2965020,887757180
4560000,2109799086,22048035,2.976484725e-12,180647622,2962776,890719956
4565000,6869477237,21888229,2.9549109150000004e-12,180713470,2960456,893680412
4570000,2207230663,21893084,2.95556634e-12,180871240,2960644,896641056
4575000,2876103909,21880689,2.9538930150000005e-12,180468398,2960768,899601824
4580000,5966056177,22073796,2.9799624600000004e-12,181484842,2962348,902564172
4585000,2350822263,21877773,2.9534993549999998e-12,180373653,2960576,905524748
4590000,2099062554,22045054,2.97608229e-12,180550561,2962532,908487280
4595000,3793147344,21887745,2.9548455750000003e-12,180697724,2961712,911448992
4600000,3329825244,22002249,2.970303615e-12,179159587,2964724,914413716
4605000,3800183496,21847930,2.9494705500000003e-12,179403737,2963208,917376924
4610000,2684431547,22085303,2.9815159050000003e-12,181858815,2961984,920338908
4615000,2189919305,21866383,2.9519617050000003e-12,180003452,2962916,923301824
4620000,1097816342,21905545,2.957248575e-12,181276229,2966716,926268540
4625000,2401535535,22090562,2.9822258699999997e-12,182029753,2955788,929224328
4630000,2080224013,21861853,2.9513501550000003e-12,179856218,2962304,932186632
4635000,4029626314,22095253,2.9828591550000002e-12,182182183,2963296,935149928
4640000,2129009678,21867828,2.9521567800000002e-12,180050430,2961332,938111260
4645000,2821237193,21870328,2.95249428e-12,180131682,2960856,941072116
4650000,2244019227,21770653,2.939038155e-12,176892254,2961484,944033600
4655000,4781022308,21753636,2.93674086e-12,176339195,2963268,946996868
4660000,2218934549,21879500,2.9537325e-12,175170221,2962392,949959260
4665000,150560470,21693281,2.9285929350000003e-12,174377634,2958140,952917400
4670000,2307969693,21741191,2.9350607850000003e-12,175934726,2960600,955878000
4675000,3263885897,21695620,2.9289087000000003e-12,174453649,2962332,958840332
4680000,3240654879,21748976,2.93611176e-12,176187738,2962440,961802772
4685000,2148701273,21795571,2.942402085e-12,177702070,2965188,964767960
4690000,3181684730,21944600,2.9625210000000004e-12,182545517,2962972,967730932
4695000,2021988547,21873097,2.952868095e-12,180221666,2963328,970694260
4700000,2103199435,22078254,2.9805642900000004e-12,181629742,2959528,973653788
4705000,2847905628,21916217,2.958689295e-12,181623050,2964824,976618612
4710000,4527474539,22043418,2.97586143e-12,180497550,2961400,979580012
4715000,3423325182,21927526,2.96021601e-12,181990600,2961428,982541440
4720000,2353608278,21864597,2.9517205950000004e-12,179945422,2962332,985503772
4725000,2604087012,21902957,2.956899195e-12,181192122,2960832,988464604
4730000,3652475537,21899280,2.9564028000000002e-12,181072598,2959492,991424096
4735000,2222916283,21863787,2.951611245e-12,179919102,2961656,994385752
4740000,2780479395,22081121,2.9809513349999998e-12,181722927,2964432,997350184
4745000,4209279153,21885264,2.95451064e-12,180617079,2963764,1000313948
4750000,2354387253,21899743,2.956465305e-12,181087665,2965304,1003279252
4755000,4130500063,22090859,2.9822659650000004e-12,182039402,2957120,1006236372
4760000,2385868045,21926360,2.9600586e-12,181952476,2963216,1009199588
4765000,4179131948,21862245,2.951403075e-12,179868975,2963404,1012162992
4770000,2062463867,22077194,2.98042119e-12,181595297,2960780,1015123772
4775000,3867944285,21891000,2.955285e-12,180803505,2961920,1018085692
4780000,2330197845,22101018,2.9836374300000004e-12,182369573,2958192,1021043884
4785000,2191556662,21913138,2.9582736300000004e-12,181522998,2965224,1024009108
4790000,3939464141,22109774,2.9848194900000002e-12,182654132,2965160,1026974268
4795000,2289877096,22074911,2.980112985e-12,186780622,2961776,1029936044
4800000,3499295048,21912175,2.9581436250000002e-12,181491691,2963700,1032899744
4805000,2062805127,22118889,2.986050015e-12,182950359,2964720,1035864464
4810000,3614839156,21814770,2.94499395e-12,178326050,2963628,1038828092
4815000,2607945371,21918473,2.958993855e-12,181696373,2961924,1041790016
4820000,3910379457,22034489,2.974656015e-12,180207366,2965012,1044755028
4825000,4971224981,21921293,2.959374555e-12,181788056,2963360,1047718388
4830000,4169212889,22045246,2.97610821e-12,180556967,2963048,1050681436
4835000,1632800661,21869887,2.9524347450000002e-12,180117353,2961500,1053642936
4840000,3919677976,21882372,2.95412022e-12,180523106,2963804,1056606740
4845000,3412556295,22017479,2.9723596649999998e-12,179654534,2960656,1059567396
4850000,2962361235,21905609,2.9572572149999998e-12,181278301,2962864,1062530260
4855000,2982114907,21897844,2.95620894e-12,181025933,2959952,1065490212
4860000,3074148029,22077820,2.9805057e-12,181615631,2964904,1068455116
4865000,2090705263,21891008,2.95528608e-12,180803786,2960636,1071415752
4870000,3919913551,22075548,2.9801989800000002e-12,181541781,2961164,1074376916
4875000,5873153024,21918400,2.9589840000000003e-12,181694000,2964312,1077341228
4880000,3320275712,22053302,2.97719577e-12,180818795,2958092,1080299320
4885000,2064398771,21929060,2.9604231e-12,182040475,2959500,1083258820
4890000,3853798011,21903604,2.95698654e-12,181213131,2964848,1086223668
4895000,2160534827,22074489,2.9800560150000006e-12,181507367,2964500,1089188168
4900000,4044844313,21926093,2.9600225550000002e-12,181944024,2962284,1092150452
4905000,2586800650,21905832,2.95728732e-12,181285564,2965272,1095115724
4910000,2450620515,21787780,2.9413503000000004e-12,177448869,2965776,1098081500
4915000,3504786361,21730749,2.9336511150000003e-12,175595338,2960492,1101041992
4920000,2191520366,21767149,2.938565115e-12,176778346,2959744,1104001736
4925000,2502154331,21918310,2.95897185e-12,176431557,2963120,1106964856
4930000,2659086192,21801343,2.9431813049999998e-12,177889345,2963632,1109928488
4935000,2384620759,21933440,2.9610144000000002e-12,182182821,2961396,1112889884
4940000,3974495264,22025951,2.9735033850000002e-12,179929892,2964544,1115854428
4945000,2631116961,21784800,2.940948e-12,177352021,2960980,1118815408
4950000,3984008988,21757930,2.93732055e-12,176478739,2959900,1121775308
4955000,2851708699,21979826,2.96727651e-12,178430814,2963212,1124738520
4960000,3602009442,21731951,2.9338133850000004e-12,175634411,2959956,1127698476
4965000,4067938292,21869409,2.952370215e-12,174842277,2964412,1130662888
4970000,3127317991,21746548,2.93578398e-12,176108816,2960348,1133623236
4975000,2816294588,21743484,2.93537034e-12,176009240,2965100,1136588336
4980000,3758793678,21906593,2.957390055e-12,176050758,2962804,1139551140
4985000,3096695340,21742117,2.935185795e-12,175964818,2958988,1142510128
4990000,2338346109,21742575,2.9352476250000003e-12,175979712,2958060,1145468188
4995000,2190736056,21759719,2.9375620650000006e-12,176536885,2963732,1148431920
5000000,3550564477,21714277,2.9314273950000004e-12,175060013,2961680,1151393600
5005000,2057307146,23007110,3.10595985e-12,186715042,2969356,1154362956
5010000,1560394507,22832991,3.0824537850000003e-12,186315722,2965688,1157328644
5015000,2953682684,22950937,3.098376495e-12,184889420,2961112,1160289756
5020000,2153092179,22880789,3.0889065150000003e-12,187869165,2966036,1163255792
5025000,3547371761,23126466,3.12207291e-12,190594127,2963600,1166219392
5030000,2607428005,22986195,3.1031363250000003e-12,191294839,2968752,1169188144
5035000,4273369584,22971614,3.1011678900000005e-12,190820963,2968052,1172156196
5040000,2412858698,23125232,3.12190632e-12,190554006,2965916,1175122112
5045000,3706529885,23009555,3.106289925e-12,192054034,2966044,1178088156
5050000,2488841115,22969764,3.10091814e-12,190760828,2968240,1181056396
5055000,4141510108,23147351,3.1248923850000003e-12,191272867,2967344,1184023740
5060000,4834499744,22976354,3.10180779e-12,190975002,2966968,1186990708
5065000,2222227832,22955055,3.098932425e-12,190282806,2966884,1189957592
5070000,3170203144,22999801,3.1049731349999997e-12,191737035,2968368,1192925960
5075000,2130621401,22920148,3.09421998e-12,189148335,2967984,1195893944
5080000,2265019312,22989687,3.103607745e-12,191408322,2968868,1198862812
5085000,3369744036,22929138,3.09543363e-12,189440491,2965084,1201827896
5090000,2852491033,23147423,3.1249021050000004e-12,191275202,2965680,1204793576
5095000,3817086304,22946342,3.0977561700000003e-12,189999624,2968180,1207761756
5100000,2124275884,22956496,3.0991269600000003e-12,190329236,2965364,1210727120
5105000,4181842719,23139818,3.1238754300000002e-12,191028060,2966520,1213693640
5110000,2310459751,23001324,3.1051787400000003e-12,191786523,2967100,1216660740
5115000,3056743736,22960478,3.09966453e-12,190459050,2967556,1219628296
5120000,3914612669,23001445,3.105195075e-12,191790463,2967476,1222595772
5125000,2140798242,22989424,3.10357224e-12,191399770,2969200,1225564972
5130000,3305399595,22946740,3.0978099e-12,190012538,2965516,1228530488
5135000,3240166716,23135795,3.123332325e-12,190897299,2966116,1231496604
5140000,2091896085,23020013,3.1077017550000002e-12,192393936,2969100,1234465704
5145000,3769661266,23134257,3.123124695e-12,190847331,2962348,1237428052
5150000,3552678695,22938381,3.096681435e-12,189740904,2968732,1240396784
5155000,3394743596,22885666,3.08956491e-12,188027662,2966540,1243363324
5160000,2437505091,22950571,3.098327085e-12,184877521,2968020,1246331344
5165000,3947965948,22801479,3.0781996650000005e-12,185291578,2966080,1249297424
5170000,2792300775,22808463,3.079142505e-12,185518556,2964956,1252262380
5175000,3711272117,22956233,3.099091455e-12,185061540,2968736,1255231116
5180000,14143089128,22855328,3.0854692800000004e-12,187041656,2966276,1258197392
5185000,8697558052,23130005,3.122550675e-12,185449595,2968008,1261165400
5190000,2129438638,22857607,3.0857769450000002e-12,187115732,2964124,1264129524
5195000,2912356396,22956652,3.0991480200000004e-12,185075143,2968692,1267098216
5200000,138395393,22863910,3.08662785e-12,187320573,2968616,1270066832
5205000,2098353464,22998978,3.10486203e-12,191710282,2970968,1273037800
5210000,3371293428,22973040,3.1013604000000003e-12,190867291,2971572,1276009372
5215000,4310717619,22999491,3.104931285e-12,191726950,2963072,1278972444
5220000,2161967809,23126915,3.122133525e-12,190608715,2966604,1281939048
5225000,4171613007,22996798,3.10456773e-12,191639438,2964192,1284903240
5230000,2348842478,23002164,3.1052921400000003e-12,191813853,2971760,1287875000
5235000,4787877793,23161840,3.1268484000000004e-12,191743763,2966816,1290841816
5240000,2692640163,22953931,3.098780685e-12,190246251,2966580,1293808396
5245000,3926913562,23161450,3.12679575e-12,191731083,2965008,1296773404
5250000,2460709791,22977460,3.1019571e-12,191010939,2966296,1299739700
5255000,3522776963,23007482,3.1060100700000002e-12,191986678,2970304,1302710004
5260000,2473578855,23138626,3.12371451e-12,190989318,2969172,1305679176
5265000,4889269690,22962784,3.0999758400000002e-12,190534006,2970736,1308649912
5270000,2165189239,23024656,3.1083285600000004e-12,192544810,2965084,1311614996
5275000,3894343271,23131081,3.1226959349999998e-12,190744088,2967492,1314582488
5280000,2059568138,23007817,3.106055295e-12,191997557,2969912,1317552400
5285000,159538968,22945072,3.0975847200000003e-12,189958345,2965400,1320517800
5290000,2108874421,22966015,3.100412025e-12,190639000,2966048,1323483848
5295000,2731256533,23180492,3.12936642e-12,192349944,2969612,1326453460
5300000,3753057814,22970524,3.10102074e-12,190785543,2966512,1329419972
5305000,3100555833,23035481,3.1097899350000003e-12,192896641,2967380,1332387352
5310000,4824561317,23133656,3.12304356e-12,190827805,2966268,1335353620
5315000,676410474,22968226,3.10071051e-12,190710856,2967820,1338321440
5320000,2090709061,22984343,3.102886305e-12,191234664,2971352,1341292792
5325000,2131911592,22990078,3.1036605300000003e-12,191421037,3134888,1344427680
5330000,3849636571,23096403,3.1180144050000003e-12,194876589,3207356,1347635036
5335000,2184125590,23205428,3.13273278e-12,193160368,3208748,1350843784
5340000,4051614033,23099262,3.11840037e-12,194969519,3206836,1354050620
5345000,2100664006,23266884,3.1410293400000003e-12,200417224,3206160,1357256780
5350000,4121192917,23345600,3.151656e-12,197715952,3204700,1360461480
5355000,881817428,23279667,3.142755045e-12,200832686,3207432,1363668912
5360000,4853889464,23223532,3.13517682e-12,199008299,3201648,1366870560
5365000,2482834340,23254692,3.1393834200000004e-12,200020984,3210344,1370080904
5370000,3525078722,23207866,3.1330619100000004e-12,198499166,3207616,1373288520
5375000,2117164238,23242787,3.137776245e-12,199634097,3204952,1376493472
5380000,2834094343,23245274,3.13811199e-12,199714917,3207444,1379700916
5385000,4131369988,23387783,3.1573507050000003e-12,199086917,3210784,1382911700
5390000,2237439486,23277920,3.1425192e-12,200775907,3207764,1386119464
5395000,3997091545,23396579,3.1585381650000005e-12,199372770,3208884,1389328348
5400000,2067531490,23206501,3.1328776350000002e-12,198454807,3209208,1392537556
5405000,6241852428,23465693,3.167868555e-12,201618988,3206076,1395743632
5410000,2197036219,23262948,3.14049798e-12,200289307,3203960,1398947592
5415000,2463459725,23238387,3.137182245e-12,199491078,3205552,1402153144
5420000,4267962803,23434457,3.163651695e-12,200603835,3203672,1405356816
5425000,2409349986,23247172,3.13836822e-12,199776599,3205132,1408561948
5430000,4129164182,23430907,3.1631724450000005e-12,200488447,3206356,1411768304
5435000,2910449795,23231798,3.1362927300000004e-12,199276936,3207496,1414975800
5440000,3961353643,23275040,3.1421304000000003e-12,200682304,3205296,1418181096
5445000,2453979818,23390941,3.157777035e-12,199189560,3205356,1421386452
5450000,5709608450,23253148,3.13917498e-12,199970799,3209184,1424595636
5455000,2077893865,23437503,3.164062905e-12,200702812,3213372,1427809008
5460000,2356649848,23209522,3.1332854700000002e-12,198552959,3202920,1431011928
5465000,3585029818,23226216,3.13553916e-12,199095508,3204996,1434216924
5470000,2851109423,23363799,3.154112865e-12,198307432,3207648,1437424572
5475000,2331396408,23190769,3.1307538150000003e-12,197943495,3206868,1440631440
5480000,2232220179,23066928,3.1140352800000003e-12,193918671,3201896,1443833336
5485000,3508096759,23281268,3.1429711800000004e-12,195625171,3206380,1447039716
5490000,2094009188,23242921,3.1377943350000003e-12,199638454,3205948,1450245664
5495000,4503400219,23393306,3.15809631e-12,199266411,3205400,1453451064
5500000,2497831487,23210684,3.13344234e-12,198590725,3204400,1456655464
5505000,2863907631,23183592,3.12978492e-12,197710263,3212432,1459867896
5510000,4005536274,23210300,3.1333905e-12,198578251,3207348,1463075244
5515000,3553926572,23268861,3.141296235e-12,195221958,3205688,1466280932
5520000,3144065700,23084896,3.11646096e-12,194502646,3210132,1469491064
5525000,2623128619,23126461,3.1220722350000004e-12,195853483,3203216,1472694280
5530000,3853454244,23242884,3.13778934e-12,194377683,3206876,1475901156
5535000,2436320219,23182022,3.12957297e-12,197658652,3206348,1479107504
5540000,3802695871,23246138,3.13822863e-12,199742981,3208272,1482315776
5545000,2180532878,23246427,3.138267645e-12,199752378,3205436,1485521212
5550000,2984004878,23371627,3.1551696449999997e-12,198561841,3208896,1488730108
5555000,2275680057,23196851,3.131574885e-12,198141150,3209468,1491939576
5560000,2998002014,23253375,3.1392056250000002e-12,199978198,3206720,1495146296
5565000,3067549836,23352941,3.1526470350000003e-12,197954557,3206688,1498352984
5570000,2743358517,23215072,3.13403472e-12,198733330,3208900,1501561884
5575000,3586374586,23418715,3.1615265249999998e-12,200092200,3210456,1504772340
5580000,2355151678,23243674,3.1378959900000002e-12,199662924,3208872,1507981212
5585000,2542297393,23452613,3.166102755e-12,201193883,3208824,1511190036
5590000,3867825530,23213553,3.1338296550000002e-12,198683969,3208508,1514398544
5595000,3268667124,23211660,3.1335741000000003e-12,198622444,3211740,1517610284
5600000,2098399295,23444720,3.1650372e-12,200937381,3206352,1520816636
5605000,2180708346,23259255,3.139999425e-12,200169295,3204504,1524021140
5610000,3875336422,23399993,3.1589990550000003e-12,199483748,3208904,1527230044
5615000,2617959896,23204150,3.13256025e-12,198378378,3207276,1530437320
5620000,3041677275,23246383,3.138261705e-12,199750952,3206120,1533643440
5625000,3465537258,23385390,3.15702765e-12,199009142,3206504,1536849944
5630000,2330891827,23248840,3.1385934000000002e-12,199830812,3204676,1540054620
5635000,2185394416,23410694,3.1604436900000002e-12,199831529,3209160,1543263780
5640000,2524464844,23232662,3.13640937e-12,199304362,3207516,1546471296
5645000,2456529546,23274965,3.142120275e-12,200679884,3210752,1549682048
5650000,916216840,23263837,3.1406179950000002e-12,200318204,3208060,1552890108
5655000,2136456508,23235914,3.1368483900000005e-12,199410715,3212060,1556102168
5660000,2457660857,23437392,3.1640479200000002e-12,200699227,3207460,1559309628
5665000,2199240184,23224847,3.1353543450000002e-12,199051028,3208380,1562518008
5670000,3132939953,23460206,3.16712781e-12,201440676,3205280,1565723288
5675000,2097440659,23417403,3.161349405e-12,205309096,3208392,1568931680
5680000,2303436756,23388003,3.157380405e-12,204353588,3207444,1572139124
5685000,4002846795,23606595,3.186890325e-12,206198309,3208460,1575347584
5690000,2692045694,23411104,3.16049904e-12,205104388,3205188,1578552772
5695000,3892204288,23576825,3.182871375e-12,205230793,3208680,1581761452
5700000,3989250571,23406383,3.159861705e-12,204950959,3206596,1584968048
5705000,2854316668,23614782,3.18799557e-12,206464378,3210420,1588178468
5710000,3432637879,23433845,3.1635690750000003e-12,205843467,3203496,1591381964
5715000,2653170616,23375688,3.1557178800000004e-12,203953359,3205512,1594587476
5720000,3463721545,23589340,3.1845609e-12,205637505,3207972,1597795448
5725000,2663432903,23398779,3.1588351650000003e-12,204703823,3206164,1601001612
5730000,3288827447,23438032,3.16413432e-12,205979542,3205632,1604207244
5735000,2163256151,23429218,3.16294443e-12,205693081,3208200,1607415444
5740000,3292910908,23379647,3.1562523450000003e-12,204082029,3207384,1610622828
5745000,3823117298,23577252,3.18292902e-12,205244657,3205056,1613827884
5750000,3215622916,23384855,3.156955425e-12,204251306,3207208,1617035092
5755000,2120169114,23428285,3.1628184750000004e-12,205662779,3203872,1620238964
5760000,2207539679,23431644,3.16327194e-12,205771938,3207100,1623446064
5765000,4283759749,23402227,3.1593006450000002e-12,204815874,3206472,1626652536
5770000,2525337705,23399099,3.158878365e-12,204714214,3209812,1629862348
5775000,3712607493,23392568,3.1579966800000004e-12,204501973,3206748,1633069096
5780000,2365140315,23586013,3.184111755e-12,205529396,3209944,1636279040
5785000,3878356066,23285410,3.1435303500000002e-12,201019334,3206820,1639485860
5790000,5457701601,23053987,3.1122882450000002e-12,193498084,3205920,1642691780
5795000,3478067714,23221794,3.1349421900000003e-12,193692266,3209700,1645901480
5800000,2589977835,23065565,3.113851275e-12,193874373,3207828,1649109308
5805000,3641403459,23321784,3.1484408400000003e-12,196941937,3207408,1652316716
5810000,2154247588,23248174,3.1385034900000003e-12,199809154,3206728,1655523444
5815000,3052044572,23229082,3.1359260700000003e-12,199188682,3208876,1658732320
5820000,2062990039,23278844,3.1426439399999998e-12,200805927,3206520,1661938840
5825000,3654463991,23244965,3.138070275e-12,199704866,3209148,1665147988
5830000,3003452879,23391476,3.15784926e-12,199206933,3207324,1668355312
5835000,6014140611,23294698,3.14478423e-12,201321183,3208488,1671563800
5840000,2355153541,23389432,3.1575733200000003e-12,199140488,3210500,1674774300
5845000,2560323222,23278851,3.1426448850000005e-12,200806164,3206744,1677981044
5850000,3993976989,23409932,3.16034082e-12,199806757,3206240,1681187284
5855000,3022040507,23294572,3.1447672200000003e-12,201317103,3208556,1684395840
5860000,3038668626,23240629,3.137484915e-12,199563967,3203276,1687599116
5865000,2110524581,23396904,3.1585820400000003e-12,199383333,3204816,1690803932
5870000,4185772954,23252028,3.13902378e-12,199934415,3204668,1694008600
5875000,3290171533,23195346,3.13137171e-12,198092238,3203196,1697211796
5880000,2307191804,23433207,3.163482945e-12,200563181,3206316,1700418112
5885000,2060895694,23359934,3.15359109e-12,198181823,3207756,1703625868
5890000,3515314096,23242206,3.13769781e-12,199615205,3206784,1706832652
5895000,2633167723,23236344,3.1369064400000005e-12,199424676,3210312,1710042964
5900000,2230449729,23212136,3.13363836e-12,198637933,3209928,1713252892
5905000,3602273055,23290704,3.14424504e-12,201191394,3206112,1716459004
5910000,2319154095,23220618,3.1347834300000003e-12,198913587,3207108,1719666112
5915000,2634391087,23259482,3.14003007e-12,200176677,3205124,1722871236
5920000,2135018282,23234488,3.13665588e-12,199364352,3210208,1726081444
5925000,3244419698,23387487,3.157310745e-12,199077300,3204460,1729285904
5930000,4374110601,23266006,3.14091081e-12,200388715,3207316,1732493220
5935000,2832335708,23220935,3.134826225e-12,198923895,3203500,1735696720
5940000,2200421870,23448152,3.1655005200000003e-12,201048913,3206312,1738903032
5945000,3101554526,23257591,3.139774785e-12,200115202,3207900,1742110932
5950000,3995415930,23423212,3.1621336200000002e-12,200238344,3207196,1745318128
5955000,2994537822,23266695,3.141003825e-12,200411083,3213872,1748532000
5960000,2961050793,23291974,3.14441649e-12,201232655,3208408,1751740408
5965000,2167026535,23584888,3.1839598800000003e-12,205492841,3204100,1754944508
5970000,4659271223,23368808,3.15478908e-12,203729753,3207544,1758152052
5975000,5908827860,23604436,3.1865988600000004e-12,206128133,3205592,1761357644
5980000,2474088877,23378839,3.156143265e-12,204055785,3206080,1764563724
5985000,2827059583,23583798,3.18381273e-12,205457417,3204604,1767768328
5990000,3701087143,23369751,3.1549163850000005e-12,203760423,3207976,1770976304
5995000,2370103564,23415076,3.16103526e-12,205233489,3203712,1774180016
6000000,2435353794,23375262,3.15566037e-12,203939526,3207404,1777387420
6005000,3384305554,23420823,3.1618111050000003e-12,205420260,3207728,1780595148
6010000,2352228064,23572277,3.182257395e-12,204983738,3203832,1783798980
6015000,3962837051,23378755,3.1561319250000005e-12,204053038,3211732,1787010712
6020000,4552229039,23591633,3.1848704550000004e-12,205612832,3209648,1790220360
6025000,2251841669,23447232,3.1653763200000004e-12,206278564,3208336,1793428696
6030000,3169244357,23407547,3.1600188450000004e-12,204988785,3207340,1796636036
6035000,3170166434,23577285,3.1829334750000004e-12,205146516,3209168,1799845204
6040000,3048724595,23400723,3.1590976050000002e-12,204767010,3205068,1803050272
6045000,4409774470,23551792,3.17949192e-12,204317992,3208912,1806259184
6050000,1390156961,23366024,3.1544132400000003e-12,203639304,3208492,1809467676
6055000,3061237306,23353775,3.152759625e-12,203241203,3208160,1812675836
6060000,2438238242,23563224,3.1810352400000003e-12,204590301,3207592,1815883428
6065000,6351896343,23424834,3.1623525900000004e-12,205550622,3208216,1819091644
6070000,2290179212,23538500,3.1776975000000003e-12,203786777,3203864,1822295508
6075000,3046145010,23433004,3.16345554e-12,205816144,3204248,1825499756
6080000,3320322796,23508946,3.17370771e-12,202826263,3208968,1828708724
6085000,2174308533,23431293,3.163224555e-12,205760522,3202492,1831911216
6090000,4193208599,23399480,3.1589298000000004e-12,204726608,3202100,1835113316
6095000,2764162693,23615400,3.188079e-12,206286012,3206564,1838319880
6100000,3953287313,23273695,3.141948825e-12,200638600,3206484,1841526364
6105000,2066071043,23307203,3.1464724050000004e-12,201727616,3209556,1844735920
6110000,6484427490,23588426,3.1844375100000004e-12,205409382,3206132,1847942052
6115000,2651611503,23526310,3.17605185e-12,203291385,3207084,1851149136
6120000,2409151816,23409728,3.1603132800000004e-12,205059670,3204016,1854353152
6125000,2178004029,23362027,3.153873645e-12,203509377,3207524,1857560676
6130000,2426181067,23398887,3.158849745e-12,204707319,3207908,1860768584
6135000,2361796209,23404868,3.15965718e-12,204901737,3206124,1863974708
6140000,2274765399,23593885,3.185174475e-12,205487560,3207936,1867182644
6145000,3697166321,25048192,3.3815059200000004e-12,205074520,3210228,1870392872
6150000,2808700573,43942461,5.932232235e-12,254299306,3206012,1873598884
6155000,3247411622,44132970,5.95795095e-12,254710018,3210908,1876809792
6160000,3987020824,44011797,5.9415925949999996e-12,256424912,3210376,1880020168
6165000,3130282624,43909061,5.9277232350000004e-12,253301262,3207488,1883227656
6170000,3184864703,44138742,5.95873017e-12,254934771,3204616,1886432272
6175000,3243760969,43920326,5.92924401e-12,253573268,3210668,1889642940
6180000,2299291315,43909914,5.92783839e-12,253273988,3206456,1892849396
6185000,3603775326,44128792,5.95738692e-12,254542259,3205156,1896054552
6190000,2486172071,43917533,5.928866955e-12,253559970,3203984,1899258536
6195000,3374765037,44158557,5.961405195000001e-12,255458831,3206048,1902464584
6200000,2389720566,43939260,5.9318001e-12,254149952,3208536,1905673120
6205000,3690602273,43973436,5.93641386e-12,255434514,3204224,1908877344
6210000,2832329727,43997767,5.939698545e-12,250229091,3208308,1912085652
6215000,3738244010,43790307,5.9116914450000004e-12,248470291,3206332,1915291984
6220000,3273001132,43805016,5.91367716e-12,249851048,3207584,1918499568
6225000,5318355873,43939550,5.93183925e-12,248291765,3203660,1921703228
6230000,2068256574,43798757,5.9128321950000006e-12,249628392,3209640,1924912868
6235000,3366001830,43809912,5.914338120000001e-12,250022235,3205012,1928117880
6240000,2992788435,43782457,5.910631695e-12,249038024,3207368,1931325248
6245000,2439115176,44011275,5.941522125e-12,250547704,3209796,1934535044
6250000,4312440105,43894689,5.925783015000001e-12,252821613,3204028,1937739072
6255000,2156807945,43968118,5.93569593e-12,254862966,3213580,1940952652
6260000,3527690678,43988470,5.93844345e-12,249888558,3209456,1944162108
6265000,3206064465,43793693,5.912148555000001e-12,249411852,3210276,1947372384
6270000,3244696552,43825474,5.91643899e-12,250569586,3206704,1950579088
6275000,4061580382,43983748,5.937805980000001e-12,249517511,3208920,1953788008
6280000,3545190302,43829544,5.91698844e-12,250533169,3209140,1956997148
6285000,2399690869,43993192,5.9390809200000005e-12,249880383,3207636,1960204784
6290000,3723532608,43791142,5.91180417e-12,249487327,3206056,1963410840
6295000,2796149162,43825295,5.9164148250000006e-12,250377514,3206152,1966616992
6300000,3642679664,43999425,5.9399223750000006e-12,250029404,3209980,1969826972
6305000,2809617034,43753769,5.906758815000001e-12,248120567,3207492,1973034464
6310000,4132206394,54057177,7.297718895e-12,248726203,31016964,2004051428
6315000,3600087669,60325744,8.14397544e-12,237624790,48357548,2052408976
6320000,5284405385,60150935,8.120376225e-12,239536703,48350408,2100759384
6325000,3550143665,60529101,8.171428635e-12,242899570,48331808,2149091192
6330000,2805850064,60374119,8.150506065000001e-12,244889880,48360300,2197451492
6335000,4373868099,60390880,8.152768800000001e-12,244859525,48290416,2245741908
6340000,3554039077,60124996,8.11687446e-12,244434607,48331160,2294073068
6345000,7234428161,55462048,7.48737648e-12,244198228,36382772,2330455840
6350000,2620938668,40085951,5.411603385000001e-12,235146559,3209740,2333665580
6355000,2228081381,39821498,5.3759022300000005e-12,234330957,3204856,2336870436
6360000,3781369372,40021565,5.402911275e-12,234645756,3212100,2340082536
6365000,2556744862,39923006,5.38960581e-12,232630867,3209208,2343291744
6370000,3104018360,39892634,5.38550559e-12,234921357,3206984,2346498728
6375000,2083491684,39839652,5.3783530199999995e-12,233025483,3211216,2349709944
6380000,3201266626,39867868,5.382162180000001e-12,234242939,3207520,2352917464
6385000,3690375601,39846365,5.379259275e-12,232169711,3209720,2356127184
6390000,3239136640,40016136,5.402178360000001e-12,234519980,3207352,2359334536
6395000,4589744860,39762174,5.36789349e-12,232989407,3209220,2362543756
6400000,2205598176,40125054,5.4168822899999995e-12,235001394,3210164,2365753920
6405000,3647687209,39939086,5.39177661e-12,233646800,3207944,2368961864
6410000,3526689704,39551759,5.339487465e-12,232332271,3206268,2372168132
6415000,2906634096,40100054,5.41350729e-12,234486389,3203280,2375371412
6420000,2823488078,39829890,5.37703515e-12,232806758,3207608,2378579020
6425000,3970999738,39889931,5.385140685e-12,234687071,3208444,2381787464
6430000,2283776500,39867775,5.382149625e-12,233378199,3207496,2384994960
6435000,4063264702,39708810,5.360689350000001e-12,233778450,3209164,2388204124
6440000,2761970823,39902044,5.386775940000001e-12,234866916,3203956,2391408080
6445000,3903101848,39970838,5.396063130000001e-12,229620900,3207740,2394615820
6450000,5125975410,40912710,5.52321585e-12,229331301,3206204,2397822024
6455000,2143149066,45917100,6.1988085e-12,229812842,3210028,2401032052
6460000,3534881765,45612352,6.15766752e-12,227828646,3206484,2404238536
6465000,3133295484,41369114,5.58483039e-12,227668152,3205936,2407444472
6470000,3599932665,40224178,5.4302640300000005e-12,229826597,3203596,2410648068
6475000,2752414959,40366039,5.449415265e-12,230349555,3207528,2413855596
6480000,2758725152,39932092,5.39083242e-12,236416860,3207000,2417062596
6485000,4220221682,40193470,5.42611845e-12,228606343,3207436,2420270032
6490000,2919887831,39943272,5.39234172e-12,229185144,3207196,2423477228
6495000,3915129676,40245676,5.43316626e-12,230535633,3203672,2426680900
6500000,3148592859,40582968,5.47870068e-12,235082685,3210512,2429891412
6505000,3030870167,39900820,5.3866107e-12,233954411,3208308,2433099720
6510000,5655677185,40420308,5.45674158e-12,233594751,3208600,2436308320
6515000,2173984806,40054369,5.407339815e-12,232854618,3205400,2439513720
6520000,3700413415,40331044,5.444690940000001e-12,233351485,3206512,2442720232
6525000,2396411049,32359559,4.368540465e-12,233662802,-1236098748,1206621484
6530000,2062747422,23374351,3.155537385e-12,203909919,3205304,1209826788
6535000,3570320730,23367776,3.15464976e-12,203696081,3210896,1213037684
6540000,2538347243,23410889,3.160470015e-12,205097405,3205032,1216242716
6545000,3244680160,23382879,3.1566886650000003e-12,204187075,3209388,1219452104
6550000,2873295670,23648504,3.19254804e-12,205278318,3209348,1222661452
6555000,4136157854,23403822,3.15951597e-12,204867728,3210016,1225871468
6560000,5689246130,23653990,3.19328865e-12,205456613,3209344,1229080812
6565000,3720857412,23375178,3.1556490300000003e-12,203936783,3207412,1232288224
6570000,2567557692,23390402,3.1577042700000004e-12,204431579,3205592,1235493816
6575000,3597434035,23620142,3.1887191700000003e-12,204356562,3205600,1238699416
6580000,2551277964,23386162,3.1571318700000003e-12,204293762,3202560,1241901976
6585000,3516176032,23387411,3.157300485e-12,204334351,3206412,1245108388
6590000,2286243223,23630588,3.19012938e-12,204696076,3208872,1248317260
6595000,3549932893,23398054,3.15873729e-12,204680265,3206152,1251523412
6600000,2453602409,23360442,3.15365967e-12,203457866,3208148,1254731560
6605000,3012568257,23395988,3.15845838e-12,204613101,3210836,1257942396
6610000,5282405397,23349497,3.152182095e-12,203102177,3208636,1261151032
6615000,4447529185,23507297,3.173485095e-12,200689092,3204728,1264355760
6620000,2418018005,23226400,3.1355640000000003e-12,199101522,3208312,1267564072
6625000,3747340371,23263856,3.1406205600000004e-12,200318817,3204432,1270768504
6630000,2413304567,23434290,3.16362915e-12,198316364,3207180,1273975684
6635000,4527305660,23295172,3.1448482200000002e-12,201336579,3210708,1277186392
6640000,2122441855,23212217,3.1336492950000002e-12,198640561,3205588,1280391980
6645000,2821619673,23519928,3.17519028e-12,201099613,3208168,1283600148
6650000,2564570801,23404077,3.159550395e-12,204876003,3204104,1286804252
6655000,3633743935,23440163,3.164422005e-12,206048812,3212800,1290017052
6660000,2189503582,23400438,3.1590591300000002e-12,204757733,3204416,1293221468
6665000,2800666343,23603144,3.18642444e-12,203804145,3208364,1296429832
6670000,3630902011,23404731,3.159638685e-12,204897256,3208508,1299638340
6675000,2235125772,23390848,3.15776448e-12,204446062,3206412,1302844752
6680000,3875474559,23645134,3.19209309e-12,205168812,3209100,1306053852
6685000,2773564241,23379933,3.156290955e-12,204091342,3208496,1309262348
6690000,4068452586,23415700,3.1611195000000003e-12,205253762,3207452,1312469800
6695000,2649894195,23621829,3.1889469150000002e-12,204411384,3206252,1315676052
6700000,3409875832,23418865,3.161546775e-12,205356628,3209968,1318886020
6705000,2376793719,23642862,3.19178637e-12,205094973,3212176,1322098196
6710000,2396222337,23426022,3.16251297e-12,205589209,3202616,1325300812
6715000,4137776459,23593528,3.18512628e-12,203491607,3205692,1328506504
6720000,2414438584,23429463,3.162977505e-12,205701058,3202096,1331708600
6725000,3424846771,23401764,3.1592381400000002e-12,204800841,3208904,1334917504
6730000,2061730795,23438224,3.16416024e-12,205985793,3212024,1338129528
6735000,2255465318,23430206,3.1630778100000003e-12,205725188,3205688,1341335216
6740000,3804397395,23631484,3.19025034e-12,204725160,3208340,1344543556
6745000,2531081356,23450479,3.165814665e-12,206384071,3202188,1347745744
6750000,6797068886,23612606,3.18770181e-12,204111652,3206888,1350952632
6755000,2678834687,23432785,3.163425975e-12,205809008,3212056,1354164688
6760000,2853749837,23434018,3.16359243e-12,205849097,3204072,1357368760
6765000,2739985175,23314546,3.14746371e-12,201966244,3207312,1360576072
6770000,3476067518,23282427,3.143127645e-12,200922395,3206096,1363782168
6775000,2153931242,23546113,3.1787252550000005e-12,201950618,3209172,1366991340
6780000,2353955472,23449496,3.16568196e-12,206352132,3207448,1370198788
6785000,2824244102,23629283,3.1899532050000002e-12,204653637,3210324,1373409112
6790000,2129737547,23428333,3.162824955e-12,205664328,3207360,1376616472
6795000,5862925795,23652846,3.1931342100000002e-12,205419453,3205644,1379822116
6800000,2484359192,23411244,3.16051794e-12,205108925,3207012,1383029128
6805000,2848052039,23436070,3.16386945e-12,205915783,3210552,1386239680
6810000,2658651832,23602925,3.186394875e-12,203796999,3208876,1389448556
6815000,3964269048,23415884,3.1611443400000004e-12,205259749,3208420,1392656976
6820000,2127051152,23373784,3.15546084e-12,203891502,3206328,1395863304
6825000,3326478554,23647616,3.19242816e-12,205249477,3207064,1399070368
6830000,3468577870,23410060,3.1603581e-12,205070446,3205456,1402275824
6835000,3094884897,23645544,3.1921484400000005e-12,205182117,3205472,1405481296
6840000,2232719133,23411797,3.160592595e-12,205126903,3209396,1408690692
6845000,3244038523,23391379,3.157836165e-12,204463037,3210344,1411901036
6850000,2305968128,23428372,3.16283022e-12,205665616,3205136,1415106172
6855000,3749603739,23618714,3.1885263900000002e-12,204310165,3207944,1418314116
6860000,3053022979,23440934,3.16452609e-12,206073871,3209176,1421523292
6865000,2950245313,23376448,3.1558204800000003e-12,203978061,3205424,1424728716
6870000,3846181563,23629215,3.1899440250000003e-12,204651437,3207300,1427936016
6875000,2563414560,23424285,3.1622784750000005e-12,205532761,3206968,1431142984
6880000,4129630084,23606965,3.186940275e-12,203928327,3207812,1434350796
6885000,2189051454,23449029,3.1656189150000005e-12,206336945,3212084,1437562880
6890000,5468514351,23397749,3.158696115e-12,204670340,3207792,1440770672
6895000,2093956848,23409027,3.1602186450000002e-12,205036896,3206492,1443977164
6900000,2852030601,23681317,3.196977795e-12,206344755,3205896,1447183060
6905000,4158637508,23411531,3.160556685e-12,205118275,3206628,1450389688
6910000,3486167053,23404989,3.1596735150000003e-12,204905653,3210296,1453599984
6915000,3588315629,23569441,3.181874535e-12,202708778,3211088,1456811072
6920000,2213154958,23237244,3.1370279400000004e-12,199453943,3207544,1460018616
6925000,3811649062,23288736,3.1439793600000002e-12,201127442,3204940,1463223556
6930000,2629395117,23414636,3.1609758600000002e-12,205219165,3207932,1466431488
6935000,3453108717,23381877,3.156553395e-12,204154523,3206016,1469637504
6940000,2055053462,23660441,3.1941595350000004e-12,205666270,3205736,1472843240
6945000,3027100382,23395401,3.158379135e-12,204594049,3209116,1476052356
6950000,2806897724,23423648,3.16219248e-12,205511769,3207512,1479259868
6955000,2799073362,23610764,3.18745314e-12,204051794,3209536,1482469404
6960000,2561365778,23231727,3.1362831450000004e-12,199274643,3206756,1485676160
6965000,3479907863,23212709,3.133715715e-12,198656553,3208848,1488885008
6970000,3107261825,23249088,3.1386268800000004e-12,199838881,3206876,1492091884
6975000,2314900926,23317860,3.1479111000000003e-12,202073952,3206284,1495298168
6980000,2158782421,23638235,3.191161725e-12,204944586,3207804,1498505972
6985000,4840304470,23406959,3.1599394650000004e-12,204969669,3208168,1501714140
6990000,3146852691,23642465,3.191732775e-12,205082070,3206228,1504920368
6995000,2162821379,23447613,3.165427755e-12,206290924,3208504,1508128872
7000000,2820196523,23386409,3.1571652150000004e-12,204301808,3209528,1511338400
7005000,2590854835,23393346,3.1581017100000003e-12,204527258,3208420,1514546820
7010000,3880749635,23407462,3.1600073700000002e-12,204986032,3204840,1517751660
7015000,2249396119,23644155,3.191960925e-12,205136987,3209472,1520961132
7020000,4308526496,23453763,3.166258005e-12,206490790,3205064,1524166196
7025000,2626700275,23392981,3.1580524349999997e-12,204515389,3207992,1527374188
7030000,3138704891,23641562,3.1916108700000002e-12,205052717,3201784,1530575972
7035000,2074871671,23600828,3.18611178e-12,203728839,3203120,1533779092
7040000,2770989297,23389029,3.157518915e-12,204386962,3202588,1536981680
7045000,2223139159,23395111,3.158339985e-12,204584627,3208204,1540189884
7050000,140644787,23419769,3.1616688150000002e-12,205386016,3208248,1543398132
7055000,2172860715,23379806,3.1562738100000005e-12,204086847,3206504,1546604636
7060000,2831927691,23609242,3.1872476700000002e-12,204002303,3208864,1549813500
7065000,3507475803,23361174,3.1537584900000003e-12,203481657,3207924,1553021424
7070000,3377563371,23434060,3.1635981000000005e-12,205850456,3206000,1556227424
7075000,6730987512,23487529,3.1708164150000003e-12,200046650,3209612,1559437036
7080000,2221116248,23493626,3.1716395100000002e-12,200244801,3208740,1562645776
7085000,2821945869,23277478,3.14245953e-12,200761528,3211848,1565857624
7090000,2931158607,23235303,3.136765905e-12,199390864,3211288,1569068912
7095000,2758270573,23281561,3.143010735e-12,200894246,3204360,1572273272
7100000,3705962265,23245642,3.13816167e-12,199726860,3205152,1575478424
7105000,2924960335,23314376,3.1474407600000003e-12,201960732,3203292,1578681716
7110000,2212206464,23388679,3.1574716650000003e-12,204375577,3206308,1581888024
7115000,3802327482,23406754,3.15991179e-12,204963005,3206168,1585094192
7120000,2111710208,23420933,3.161825955e-12,205423824,3203472,1588297664
7125000,5362838800,23374852,3.15560502e-12,203926207,3204880,1591502544
7130000,2310285827,23441108,3.1645495800000003e-12,206079499,3205428,1594707972
7135000,3148841369,23597468,3.18565818e-12,203619649,3210096,1597918068
7140000,138380042,23406404,3.1598645400000003e-12,204951644,3211396,1601129464
7145000,2076883896,23405105,3.159689175e-12,204909426,3205036,1604334500
7150000,2925823279,23644104,3.19195404e-12,205135309,3209480,1607543980
7155000,3882174770,23458611,3.166912485e-12,206648372,3206648,1610750628
7160000,2349222457,23376992,3.15589392e-12,203995737,3205380,1613956008
7165000,3391108691,23672467,3.1957830450000002e-12,206057114,3205020,1617161028
7170000,2269747477,23403950,3.1595332500000002e-12,204871870,3207784,1620368812
7175000,5937800999,23679214,3.1966938900000003e-12,206276408,3206732,1623575544
7180000,2073328758,23379741,3.1562650350000003e-12,204085086,3209772,1626785316
7185000,3406331538,23640944,3.1915274400000003e-12,205032628,3208532,1629993848
7190000,2589796255,23436194,3.1638861900000003e-12,205919826,3203048,1633196896
7195000,3989024413,23403082,3.15941607e-12,204843685,3208772,1636405668
7200000,2388562123,23674099,3.1960033650000004e-12,206110162,3205052,1639610720
7205000,4138346459,23412912,3.16074312e-12,205163138,3208316,1642819036
7210000,2653975072,23416570,3.16123695e-12,205282026,3205828,1646024864
7215000,3911645181,23601523,3.1862056049999997e-12,203751441,3209856,1649234720
7220000,2846377420,23431281,3.163222935e-12,205760134,3206164,1652440884
7225000,3868199270,23253146,3.13917471e-12,199970747,3207372,1655648256
7230000,2173833162,23275869,3.142242315e-12,200709239,3205952,1658854208
7235000,2522683965,23447944,3.16547244e-12,198760145,3207520,1662061728
7240000,2815364651,23282771,3.1431740850000002e-12,200933564,3207520,1665269248
7245000,2821534361,23629642,3.1900016700000003e-12,204665321,3206472,1668475720
7250000,3811691290,23407421,3.160001835e-12,204984679,3206728,1671682448
7255000,2115337236,23454796,3.16639746e-12,206524384,3206124,1674888572
7260000,3657411391,23597806,3.1857038100000003e-12,203630638,3209872,1678098444
7265000,2157930439,23436594,3.16394019e-12,205932827,3205956,1681304400
7270000,7626707404,23625167,3.189397545e-12,204519885,3203896,1684508296
7275000,2337620081,23428044,3.16278594e-12,205654934,3207508,1687715804
7280000,2698102483,23427691,3.1627382850000002e-12,205643465,3206208,1690922012
7285000,2285357244,23673042,3.1958606700000002e-12,206075814,3204792,1694126804
7290000,3412318622,23416908,3.16128258e-12,205293021,3208816,1697335620
7295000,2549851848,23396598,3.1585407300000002e-12,204632931,3205524,1700541144
7300000,3683217512,23640543,3.1914733050000005e-12,205019597,3205104,1703746248
7305000,2608008270,23433439,3.163514265e-12,205830266,3204428,1706950676
7310000,3515527402,23417238,3.16132713e-12,205303731,3204204,1710154880
7315000,2510252637,23605517,3.186744795e-12,203881267,3207984,1713362864
7320000,4106918752,23415255,3.161059425e-12,205239293,3209796,1716572660
7325000,2146491990,23375592,3.15570492e-12,203950249,3207264,1719779924
7330000,2841911948,23441743,3.164635305e-12,206100156,3203756,1722983680
7335000,3696887129,23636681,3.190951935e-12,204894090,3208200,1726191880
7340000,2251213139,23413397,3.1608085950000003e-12,205178908,3208648,1729400528
7345000,3924812655,23419836,3.16167786e-12,205388189,3204864,1732605392
7350000,2062419030,23419583,3.161643705e-12,205379954,3210936,1735816328
7355000,2597013887,23430311,3.1630919850000004e-12,205728609,3205544,1739021872
7360000,2904359312,23654368,3.1933396800000003e-12,205468908,3206828,1742228700
7365000,2140750388,23601152,3.1861555200000002e-12,203739403,3203732,1745432432
7370000,2588886106,23410614,3.16043289e-12,205088450,3211212,1748643644
7375000,4149628010,23675206,3.19615281e-12,206146150,3208320,1751851964
7380000,2810747243,23254078,3.1393005300000003e-12,200001056,3208600,1755060564
7385000,3976321813,23237422,3.1370519700000003e-12,199459732,3206564,1758267128
7390000,2201107880,23511429,3.174042915e-12,200823399,3207804,1761474932
7395000,2190210485,23340167,3.150922545e-12,202798936,3210396,1764685328
7400000,3795608038,23702328,3.19981428e-12,207027601,3206656,1767891984
7405000,2070128146,23424244,3.16227294e-12,205531455,3202792,1771094776
7410000,3612189416,23455388,3.1664773800000004e-12,199002057,3208996,1774303772
7415000,2565151453,23285778,3.14358003e-12,201031296,3205800,1777509572
7420000,2575958678,23400935,3.159126225e-12,204773902,3206600,1780716172
7425000,4031955906,23393656,3.15814356e-12,204537310,3206544,1783922716
7430000,2198348867,23390482,3.15771507e-12,204434179,3207972,1787130688
7435000,4259140134,23638276,3.19116726e-12,204945910,3210804,1790341492
7440000,3034653257,23401939,3.159261765e-12,204806519,3207076,1793548568
7445000,4361023643,23635439,3.190784265e-12,204853711,3210812,1796759380
7450000,2190502515,23400801,3.1591081350000005e-12,204769550,3210088,1799969468
7455000,2845068727,23412363,3.160669005e-12,205145295,3207868,1803177336
7460000,4099001215,23429174,3.16293849e-12,205691676,3206128,1806383464
7465000,2538326487,23635318,3.19076793e-12,204849788,3208308,1809591772
7470000,4089840960,23426852,3.16262502e-12,205616214,3203160,1812794932
7475000,2311834610,23405984,3.1598078400000003e-12,204937971,3209904,1816004836
7480000,3933577630,23681616,3.19701816e-12,206354470,3208088,1819212924
7485000,2271395800,23418093,3.161442555e-12,205331542,3208344,1822421268
7490000,4175550266,23443263,3.1648405050000002e-12,206149552,3212632,1825633900
7495000,129196423,23438607,3.164211945e-12,205998232,3210756,1828844656
7500000,2872459271,23416065,3.161168775e-12,205265636,3205896,1832050552
7505000,2564361744,23367331,3.154589685e-12,203681775,3208468,1835259020
7510000,3406360127,23450092,3.16576242e-12,206371513,3208328,1838467348
7515000,2554525038,23384866,3.1569569100000002e-12,204251641,3205820,1841673168
7520000,3586803191,23661280,3.1942728000000003e-12,205693550,3209036,1844882204
7525000,2622831981,23401775,3.159239625e-12,204800637,3207276,1848089480
7530000,3701920825,23431910,3.16330785e-12,205780594,3207420,1851296900
7535000,2479415381,23784255,3.210874425e-12,209690247,3207072,1854503972
7540000,3160721435,23442076,3.16468026e-12,206110986,3206528,1857710500
7545000,3167642721,23626098,3.1895232300000004e-12,204550129,3206388,1860916888
7550000,4305500001,23359707,3.153560445e-12,203433994,3210168,1864127056
7555000,3577687432,23399872,3.1589827200000005e-12,204739362,3209892,1867336948
7560000,3678666349,23635999,3.190859865e-12,204871921,3207928,1870544876
7565000,2574443392,23445887,3.165194745e-12,206234839,3208344,1873753220
7570000,4221990018,23623474,3.18916899e-12,204464866,3205004,1876958224
7575000,2509083083,23437598,3.16407573e-12,205965430,3206040,1880164264
7580000,3917934043,23369244,3.1548479400000004e-12,203743930,3207036,1883371300
7585000,2559123608,23645214,3.19210389e-12,205171415,3210744,1886582044
7590000,3205517865,23457236,3.1667268600000005e-12,206603671,3211192,1889793236
7595000,2073729413,23622250,3.18900375e-12,204425062,3209332,1893002568
7600000,3918869176,23436038,3.16386513e-12,205914737,3205864,1896208432
7605000,2104642483,23431321,3.163228335e-12,205761441,3204492,1899412924
7610000,3774643278,23525118,3.1758909300000005e-12,201268280,3205372,1902618296
7615000,677685318,23235699,3.136819365e-12,199403726,3209644,1905827940
7620000,2166243540,23282139,3.143088765e-12,200913011,3202480,1909030420
7625000,2525602572,23479260,3.1697001e-12,199777894,3204184,1912234604
7630000,3586931911,23267686,3.14113761e-12,200442669,3210320,1915444924
7635000,2636395168,23299167,3.145387545e-12,201466439,3210372,1918655296
7640000,3986771364,23477209,3.169423215e-12,199711250,3207832,1921863128
7645000,3263639680,23299890,3.14548515e-12,201489922,3207832,1925070960
7650000,4307135420,23519852,3.1751800200000004e-12,201097146,3204976,1928275936
7655000,2180161585,23277992,3.1425289200000003e-12,200778267,3207332,1931483268
7660000,2560549726,23211311,3.1335269850000002e-12,198611116,3208380,1934691648
7665000,3725788004,23252341,3.139066035e-12,199944590,3207504,1937899152
7670000,2097705696,23498571,3.172307085e-12,200405491,3206076,1941105228
7675000,3929322415,23253528,3.1392262800000003e-12,199983153,3203632,1944308860
7680000,2648192288,23280973,3.142931355e-12,200875119,3210644,1947519504
7685000,3898476522,23659015,3.1939670250000003e-12,205619942,3209188,1950728692
7690000,2936176050,23386015,3.1571120250000004e-12,204288986,3209068,1953937760
7695000,7037730534,23672532,3.19579182e-12,206059218,3206092,1957143852
7700000,2190052486,23417531,3.1613666850000005e-12,205313269,3206800,1960350652
7705000,2231592966,23599126,3.18588201e-12,203673554,3207192,1963557844
7710000,2890781039,23429042,3.1629206699999998e-12,205687382,3206156,1966764000
7715000,2070007656,23368872,3.1547977200000003e-12,203731864,3208736,1969972736
7720000,3762322226,23671397,3.195638595e-12,206022351,3208348,1973181084
7725000,2969348611,23398065,3.158738775e-12,204680622,3206748,1976387832
7730000,3608969080,23392298,3.15796023e-12,204493179,3208984,1979596816
7735000,14091124662,23660516,3.19416966e-12,205668026,3209788,1982806604
7740000,17996692198,24081419,3.250991565e-12,204264957,3204220,1986010824
7745000,2064826945,23389470,3.15757845e-12,204401294,3207608,1989218432
7750000,2065808899,23408068,3.1600891800000003e-12,205005699,3205348,1992423780
7755000,2062105914,23425697,3.162469095e-12,205578657,3203572,1995627352
7760000,5009593691,23636584,3.19093884e-12,204890916,3208816,1998836168
7765000,2480642177,23389249,3.1575486150000003e-12,204394108,3209488,2002045656
7770000,3750482674,23638095,3.191142825e-12,204940025,3207424,2005253080
7775000,2586292669,23367984,3.15467784e-12,203702992,3205464,2008458544
7780000,3218221265,23413916,3.16087866e-12,205195780,3206428,2011664972
7785000,2595755442,23604301,3.186580635e-12,203841737,3206784,2014871756
7790000,3697726391,23431089,3.1631970150000003e-12,205753896,3207948,2018079704
7795000,2124586733,23371918,3.15520893e-12,203830847,3208320,2021288024
7800000,3267783458,23659681,3.1940569350000006e-12,205641575,3203520,2024491544
7805000,2060799466,23278492,3.1425964200000005e-12,200794517,3210496,2027702040
7810000,6017770899,23524279,3.175777665e-12,201241009,3211988,2030914028
7815000,2063707770,23252085,3.139031475e-12,199936285,3203284,2034117312
7820000,3612426671,23276280,3.1422978e-12,200722605,3212192,2037329504
7825000,3119617796,23514718,3.1744869300000002e-12,200930297,3211392,2040540896
7830000,3257159481,23356046,3.15306621e-12,203315008,3209472,2043750368
7835000,3461976442,23470604,3.16853154e-12,207038149,3205792,2046956160
7840000,3184244185,23400941,3.1591270350000005e-12,204774087,3210348,2050166508
7845000,2179546601,23469312,3.16835712e-12,206996165,3207132,2053373640
7850000,3977589316,23641229,3.191565915e-12,205041880,3206528,2056580168
7855000,3184144456,23443104,3.16481904e-12,206144397,3208740,2059788908
7860000,2389956372,23437256,3.1640295600000004e-12,205954336,3206912,2062995820
7865000,2595320765,23416075,3.161170125e-12,205265937,3207956,2066203776
7870000,3845231440,23419442,3.16162467e-12,205375367,3205956,2069409732
7875000,2135648350,23395401,3.158379135e-12,204594040,3206688,2072616420
7880000,2368197426,23458021,3.1668328350000003e-12,206629194,3208260,2075824680
7885000,3916164319,23640632,3.19148532e-12,205022491,3207380,2079032060
7890000,2306814036,23409987,3.1603482450000003e-12,205068092,3204356,2082236416
7895000,4119672077,23658356,3.1938780600000003e-12,205598522,3205204,2085441620
7900000,3329017681,23387166,3.15726741e-12,204326415,3204664,2088646284
7905000,4003263894,23431161,3.1632067350000004e-12,205756248,3211940,2091858224
7910000,2082650178,23381764,3.1565381400000003e-12,204150835,3207892,2095066116
7915000,3654845609,23434906,3.1637123100000003e-12,205877948,3209528,2098275644
7920000,2622825444,23403741,3.159505035e-12,204865105,3206980,2101482624
7925000,4203179637,23644861,3.1920562350000004e-12,205159944,3208152,2104690776
7930000,3112776269,23429958,3.16304433e-12,205717130,3206520,2107897296
7935000,2524394243,23393916,3.1581786600000003e-12,204545797,3205868,2111103164
7940000,2506677838,23439759,3.1643674650000002e-12,206035665,3212036,2114315200
7945000,2096430793,23392373,3.157970355e-12,204495645,3204260,2117519460
7950000,3635791455,23244201,3.1379671350000003e-12,199680037,3207048,2120726508
7955000,3489876262,23161577,3.1268128950000003e-12,196994756,3206540,2123933048
7960000,2064678203,23301140,3.1456539000000003e-12,193989010,3211388,2127144436
7965000,3509759768,23106295,3.119349825e-12,195198101,3210204,2130354640
7970000,2912617840,23133415,3.1230110250000002e-12,196079482,3209032,2133563672
7975000,2275210921,23424655,3.162328425e-12,198003242,3207804,2136771476
7980000,3370352841,23295716,3.14492166e-12,201354265,3205460,2139976936
7985000,4535225753,23334820,3.1502007000000005e-12,195083605,3206464,2143183400
7990000,3431961220,23128839,3.122393265e-12,195930774,3204928,2146388328
7995000,2266915392,23280186,3.14282511e-12,200849551,3208964,2149597292
8000000,2081948486,23258898,3.1399512300000003e-12,200157704,3206700,2152803992
8005000,2442567165,23470009,3.168451215e-12,199477235,3208788,2156012780
8010000,3049701669,23323507,3.148673445e-12,202257481,3209504,2159222284
8015000,2743825844,23283405,3.1432596750000003e-12,200954160,3210012,2162432296
8020000,3081027891,23538437,3.1776889950000004e-12,201701165,3206424,2165638720
8025000,2816900853,23248198,3.13850673e-12,199809935,3206868,2168845588
8030000,3967434246,23489454,3.17107629e-12,200109204,3208200,2172053788
8035000,2066472685,23256892,3.1396804200000002e-12,200092493,3205088,2175258876
8040000,3836508403,23269621,3.141398835e-12,200506190,3208700,2178467576
8045000,3936060506,23261256,3.14026956e-12,200234323,3205640,2181673216
8050000,2201720663,23268187,3.141205245e-12,200459590,3206304,2184879520
8055000,4542556076,23500537,3.172572495e-12,200469394,3205988,2188085508
8060000,2165327919,23262897,3.140491095e-12,200287671,3204912,2191290420
8065000,3611975260,23532163,3.1768420050000002e-12,201497254,3208120,2194498540
8070000,3010690454,23228460,3.1358421000000005e-12,199168472,3203480,2197702020
8075000,3223189369,23307113,3.1464602550000003e-12,201724687,3206320,2200908340
8080000,2516094166,23496028,3.17196378e-12,200322866,3205656,2204113996
8085000,4087086331,23302047,3.145776345e-12,201560019,3204612,2207318608
8090000,5525364319,23232189,3.1363455150000002e-12,199289642,3207432,2210526040
8095000,2116430643,23300120,3.1455162e-12,201497409,3208968,2213735008
8100000,3751736954,23486239,3.170642265e-12,200004712,3205440,2216940448
8105000,2869434331,23317456,3.14785656e-12,202060843,3214008,2220154456
8110000,3420125917,23070960,3.1145796e-12,194049725,3206784,2223361240
8115000,2188642886,23047516,3.1114146600000003e-12,193287782,3202248,2226563488
8120000,4414613832,23110148,3.11986998e-12,195323302,3205800,2229769288
8125000,2698568062,23418275,3.1614671250000002e-12,197795878,3208088,2232977376
8130000,5143983516,23249767,3.138718545e-12,199860937,3209920,2236187296
8135000,2167170953,23503791,3.173011785e-12,199820983,3205540,2239392836
8140000,2207811902,23244143,3.137959305e-12,199678146,3207636,2242600472
8145000,3893092134,23524426,3.1757975100000005e-12,201245804,3207212,2245807684
8150000,3453074624,23211579,3.133563165e-12,198619823,3207296,2249014980
8155000,2952296214,23309864,3.1468316400000003e-12,201814082,3207584,2252222564
8160000,2630484944,23462537,3.167442495e-12,199234403,3211252,2255433816
8165000,3260589888,23234755,3.1366919250000003e-12,199373040,3205892,2258639708
8170000,2068925781,23276156,3.14228106e-12,200718572,3207856,2261847564
8175000,4538216420,23472064,3.1687286400000003e-12,199544028,3207404,2265054968
8180000,2577917653,23513401,3.174309135e-12,200887482,3204056,2268259024
8185000,2353389316,23250541,3.1388230350000004e-12,199886088,3207768,2271466792
8190000,4537710921,23255888,3.13954488e-12,200059870,3203856,2274670648
8195000,3079358482,23519550,3.17513925e-12,201087308,3205924,2277876572
8200000,3443948967,23224071,3.1352495850000002e-12,199025801,3203544,2281080116
8205000,2139171393,23545021,3.178577835e-12,201914201,3209904,2284290020
8210000,3942625403,23295545,3.1448985750000004e-12,201348720,3208836,2287498856
8215000,2227700767,23201578,3.1322130300000004e-12,198294803,3205376,2290704232
8220000,4611818762,23521793,3.1754420550000003e-12,201160212,3205080,2293909312
8225000,2092885955,23239987,3.1373982450000003e-12,199543077,3210344,2297119656
8230000,2537549088,23290411,3.1442054850000003e-12,201181866,3206744,2300326400
8235000,3802592858,23230429,3.1361079150000004e-12,199232457,3206328,2303532728
8240000,2741287586,23494020,3.1716927e-12,200257608,3207436,2306740164
8245000,4045672645,23288869,3.1439973150000003e-12,201131758,3205148,2309945312
8250000,2818267702,23244757,3.138042195e-12,199698099,3207008,2313152320
8255000,4027427516,23564301,3.181180635e-12,202541739,3208508,2316360828
8260000,2753231164,23237900,3.1371165000000003e-12,199475256,3208572,2319569400
8265000,3892524279,23221071,3.134844585e-12,198928298,3209776,2322779176
8270000,2166853706,23120470,3.1212634500000003e-12,195658770,3210428,2325989604
8275000,2700636870,23441830,3.1646470499999998e-12,198561433,3210400,2329200004
8280000,3952508840,23260276,3.14013726e-12,200202468,3208272,2332408276
8285000,2997076556,23279374,3.1427154900000003e-12,200823168,3207316,2335615592
8290000,3967817035,23475400,3.1691790000000003e-12,199652457,3208188,2338823780
8295000,2782378640,23278393,3.142583055e-12,200791283,3205428,2342029208
8300000,2745397693,23279814,3.1427748900000003e-12,200837458,3208324,2345237532
8305000,2207432463,23122491,3.121536285e-12,195724469,3205120,2348442652
8310000,3943244724,23143132,3.1243228200000003e-12,196394336,3208612,2351651264
8315000,2100991064,23079076,3.1156752600000005e-12,194313472,3207508,2354858772
8320000,3211537654,23370581,3.155028435e-12,196245825,3210784,2358069556
8325000,2375114523,23268344,3.1412264400000002e-12,200464682,3205132,2361274688
8330000,2119014684,23268555,3.141254925e-12,200471550,3208512,2364483200
8335000,3933945422,23540539,3.1779727650000003e-12,201769464,3205060,2367688260
8340000,2102417927,23279049,3.142671615e-12,200812597,3205904,2370894164
8345000,3731124555,23315798,3.1476327299999998e-12,202006931,3208840,2374103004
8350000,3261244731,23501616,3.1727181600000005e-12,200504468,3209976,2377312980
8355000,3096976104,23297131,3.1451126850000005e-12,201400252,3211100,2380524080
8360000,2951327591,23509538,3.17378763e-12,200761942,3205804,2383729884
8365000,2068416313,23230957,3.136179195e-12,199249606,3209144,2386939028
8370000,3553117768,23528804,3.1763885400000002e-12,201388082,3205360,2390144388
8375000,3384269262,23247411,3.138400485e-12,199784354,3206184,2393350572
8380000,4571838139,23288698,3.14397423e-12,201126198,3208796,2396559368
8385000,3061598178,23248714,3.13857639e-12,199826699,3210252,2399769620
8390000,3782639200,23293395,3.144608325e-12,201278831,3205516,2402975136
8395000,2843481131,23459994,3.1670991900000004e-12,199151761,3207332,2406182468
8400000,4264380993,23306004,3.1463105400000004e-12,201688651,3207352,2409389820
8405000,5520457285,23473933,3.168980955e-12,199604758,3210764,2412600584
8410000,2914134570,23256454,3.13962129e-12,200078260,3205408,2415805992
8415000,2358689863,23298024,3.1452332400000005e-12,201429300,3207460,2419013452
8420000,3402344374,23395386,3.15837711e-12,197051999,3211604,2422225056
8425000,2616166722,23146579,3.124788165e-12,196507335,3205120,2425430176
8430000,3254206991,23243227,3.1378356450000004e-12,199648390,3210248,2428640424
8435000,2614355595,23465838,3.1678881299999997e-12,199341696,3208272,2431848696
8440000,4062130061,23132678,3.12291153e-12,196055553,3205456,2435054152
8445000,2298853946,23047375,3.111395625e-12,193283190,3202156,2438256308
8450000,4411561965,23370304,3.1549910400000006e-12,196236816,3207712,2441464020
8455000,3121466802,23119424,3.12112224e-12,195624780,3206548,2444670568
8460000,4657007020,23482654,3.1701582900000004e-12,199888206,3207116,2447877684
8465000,2657270697,23222679,3.1350616650000002e-12,198980570,3207316,2451085000
8470000,3140231596,23265135,3.1407932250000002e-12,200360386,3204108,2454289108
8475000,2747887145,23220797,3.1348075950000004e-12,198919419,3206976,2457496084
8480000,3919483574,23239823,3.137376105e-12,199537751,3204620,2460700704
8485000,2489076909,23487714,3.17084139e-12,200052643,3206460,2463907164
8490000,3193899439,23254621,3.139373835e-12,200018690,3207152,2467114316
8495000,3925547382,23487058,3.1707528300000003e-12,200031337,3206972,2470321288
8500000,4221926843,23245295,3.1381148250000002e-12,199715593,3205624,2473526912
8505000,3010569648,23258106,3.1398443100000002e-12,200131938,3210676,2476737588
8510000,2065268930,23291778,3.1443900300000004e-12,201226289,3207248,2479944836
8515000,3821282490,23267995,3.141179325e-12,200453345,3211960,2483156796
8520000,3239948755,23471509,3.1686537150000003e-12,199525994,3206360,2486363156
8525000,3260384177,23292857,3.1445356950000004e-12,201261370,3208032,2489571188
8530000,2635376622,23222666,3.1350599100000002e-12,198980154,3207276,2492778464
8535000,3786935159,23522136,3.17548836e-12,201171369,3207500,2495985964
8540000,2871279284,23267383,3.1410967050000004e-12,200433456,3208552,2499194516
8545000,3476801580,23255142,3.13944417e-12,200035636,3209840,2502404356
8550000,2067545318,23283223,3.143235105e-12,200948266,3205932,2505610288
8555000,2593608592,23268816,3.14129016e-12,200480019,3204948,2508815236
8560000,6894093193,23476920,3.1693842e-12,199701862,3205812,2512021048
8565000,2519669302,23243533,3.137876955e-12,199658341,3204368,2515225416
8570000,4319967085,23468197,3.168206595e-12,199418364,3212660,2518438076
8575000,749213212,23269835,3.141427725e-12,200513138,3207840,2521645916
8580000,2172866240,23230465,3.1361127750000004e-12,199233611,3206424,2524852340
8585000,2660345211,23256809,3.139669215e-12,200089801,3203564,2528055904
8590000,3714004029,23256035,3.139564725e-12,200064653,3203464,2531259368
8595000,2139631542,23503975,3.173036625e-12,200581123,3208744,2534468112
8600000,2820447995,23436764,3.1639631400000003e-12,205938319,3206992,2537675104
8605000,3258562635,23629004,3.1899155400000004e-12,204644578,3206676,2540881780
8610000,2220517303,23456391,3.166612785e-12,206576226,3203592,2544085372
8615000,6042640325,23653045,3.193161075e-12,205425922,3206376,2547291748
8620000,2629971538,23430478,3.16311453e-12,205734037,3208336,2550500084
8625000,130937530,23464732,3.1677388200000003e-12,206847316,3208220,2553708304
8630000,2133014604,23437332,3.16403982e-12,205956807,3208204,2556916508
8635000,2701398012,23454844,3.1664039400000005e-12,206525954,3209688,2560126196
8640000,3326141023,23653012,3.1931566200000003e-12,205325606,3206224,2563332420
8645000,2071314061,23454722,3.1663874700000005e-12,206521979,3210660,2566543080
8650000,3631926077,23701836,3.1997478600000004e-12,206912378,3204448,2569747528
8655000,2817601451,23449292,3.1656544200000002e-12,206345496,3208244,2572955772
8660000,3466217089,23396925,3.158584875e-12,204643563,3205980,2576161752
8665000,2085481496,23660660,3.1941891000000004e-12,205574183,3208016,2579369768
8670000,7181390891,23464714,3.1677363900000002e-12,206846717,3208768,2582578536
8675000,2980925547,23677907,3.196517445e-12,206035469,3209196,2585787732
8680000,2446061769,23427227,3.1626756450000005e-12,205628394,3207384,2588995116
8685000,2526455742,23442919,3.164794065e-12,206138383,3207936,2592203052
8690000,4057255444,23644903,3.192061905e-12,204962864,3203224,2595406276
8695000,2701359102,23468456,3.1682415600000004e-12,206968323,3207376,2598613652
8700000,3073484131,23446652,3.16529802e-12,206259691,3211616,2601825268
8705000,2140909556,23421491,3.1619012850000005e-12,205441955,3205788,2605031056
8710000,4103603902,23396448,3.1585204800000003e-12,204628087,3206156,2608237212
8715000,2223700040,23646635,3.192295725e-12,205019137,3208504,2611445716
8720000,3908203958,23384054,3.15684729e-12,204225266,3205140,2614650856
8725000,6706054368,23658571,3.193907085e-12,205307829,3208904,2617859760
8730000,3432488568,23417251,3.1613288850000005e-12,205304177,3205612,2621065372
8735000,2226626722,23342206,3.1511978099999998e-12,202865202,3206980,2624272352
8740000,3485680038,23496399,3.172013865e-12,200037262,3208308,2627480660
8745000,2061840485,23263764,3.14060814e-12,200315854,3210992,2630691652
8750000,3570039515,23309687,3.146807745e-12,201808338,3207404,2633899056
8755000,2710020897,23663539,3.194577765e-12,205469301,3210656,2637109712
8760000,3327348557,23274465,3.142052775e-12,200663631,3211232,2640320944
8765000,2821214210,23556119,3.180076065e-12,201978131,3205876,2643526820
8770000,4128388711,23264451,3.1407008850000003e-12,200338149,3206560,2646733380
8775000,2059790123,23575349,3.182672115e-12,202603117,3206112,2649939492
8780000,50402934,23421520,3.1619052e-12,205442917,3210080,2653149572
8785000,2107604608,23449299,3.165655365e-12,206345719,3208240,2656357812
8790000,3656183382,23656912,3.19368312e-12,205154703,3207976,2659565788
8795000,2681810758,23442264,3.1647056400000004e-12,206117092,3206928,2662772716
8800000,4013548972,23676555,3.196334925e-12,205793085,3207012,2665979728
8805000,2711852952,23440762,3.16450287e-12,206068266,3209332,2669189060
8810000,3572076250,23403023,3.159408105e-12,204841749,3208800,2672397860
8815000,2149579921,23659568,3.19404168e-12,205241019,3206420,2675604280
8820000,6663467323,23474063,3.168998505e-12,207150548,3207280,2678811560
8825000,3287182098,23686456,3.1976715600000002e-12,205321028,3207352,2682018912
8830000,2351436862,23470265,3.168485775e-12,207027127,3206832,2685225744
8835000,3455865748,23657710,3.1937908500000004e-12,205081410,3206072,2688431816
8840000,3496512986,23465268,3.1678111800000005e-12,206864729,3205992,2691637808
8845000,3087723729,23421182,3.1618595700000003e-12,205431922,3210360,2694848168
8850000,2207475364,23389307,3.1575564450000003e-12,204395969,3208852,2698057020
8855000,3010303504,23487108,3.17075958e-12,207574500,3208392,2701265412
8860000,4522100124,23668127,3.195197145e-12,205419957,3209836,2704475248
8865000,2055347008,23670672,3.19554072e-12,205502678,3206512,2707681760
8870000,3062844174,23422335,3.162015225e-12,205469389,3205136,2710886896
8875000,3061214252,23410212,3.16037862e-12,205075417,3204432,2714091328
8880000,2864605727,23408436,3.16013886e-12,205017687,3207064,2717298392
8885000,2417294702,23395858,3.1584408300000003e-12,204607516,3206884,2720505276
8890000,3477752318,23419656,3.16165356e-12,205382309,3205432,2723710708
8895000,313102398,23391188,3.15781038e-12,204457132,3205712,2726916420
8900000,2324164875,23696966,3.19909041e-12,206258016,3206384,2730122804
8905000,3688943935,23317734,3.14789409e-12,202069857,3210104,2733332908
8910000,3034076686,23297059,3.1451029650000004e-12,201397932,3207852,2736540760
8915000,2420496969,23230204,3.1360775400000002e-12,199225155,3207964,2739748724
8920000,2071674429,23292918,3.1445439300000003e-12,201263328,3208428,2742957152
8925000,3560687561,23477983,3.1695277050000003e-12,199141074,3207912,2746165064
8930000,2067852674,23284486,3.1434056100000002e-12,200989302,3209732,2749374796
8935000,3658194655,25695906,3.4689473100000002e-12,200459877,3208848,2752583644
8940000,2455619678,44079257,5.9506996950000005e-12,250135697,3209352,2755792996
8945000,2183576004,43997221,5.9396248350000005e-12,256077064,3208048,2759001044
8950000,3775233081,44206841,5.9679235349999996e-12,254391601,3204984,2762206028
8955000,2705316262,44013435,5.941813725e-12,256656481,3207896,2765413924
8960000,2064751549,43946016,5.9327121600000006e-12,254515721,3207204,2768621128
8965000,7906643935,44213483,5.968820205e-12,254446151,3213484,2771834612
8970000,2139297487,44204386,5.9675921100000005e-12,254191863,3211180,2775045792
8975000,2069791621,43961161,5.934756735000001e-12,255032600,3203112,2778248904
8980000,3076348488,43897253,5.9261291550000005e-12,252773035,3207220,2781456124
8985000,2350262835,43956717,5.9341567950000006e-12,254635015,3210264,2784666388
8990000,2178616773,43932775,5.930924625e-12,253212934,3200756,2787867144
8995000,3201513504,44188393,5.965433055000001e-12,253681649,3208384,2791075528
9000000,3997702025,43956133,5.934077955e-12,254728084,3207800,2794283328
9005000,2122736247,43907357,5.927493195e-12,253157608,3207588,2797490916
9010000,3569164832,44182913,5.964693255e-12,253564886,3206244,2800697160
9015000,4211645629,43950169,5.933272815e-12,254498207,3207884,2803905044
9020000,4435813119,44278527,5.977601145e-12,255792534,3206512,2807111556
9025000,3088847384,43928789,5.9303865150000005e-12,253827158,3206488,2810318044
9030000,2821479170,43809514,5.9142843900000006e-12,249935625,3207004,2813525048
9035000,2103692634,44101851,5.9537498850000006e-12,250845247,3207508,2816732556
9040000,2801167500,43817650,5.91538275e-12,250219917,3207880,2819940436
9045000,4106984305,44087789,5.951851515e-12,250201119,3208588,2823149024
9050000,2868730208,43796762,5.912562870000001e-12,249643278,3208332,2826357356
9055000,3849948519,43879887,5.923784745e-12,252276700,3207948,2829565304
9060000,2110808431,44225676,5.97046626e-12,254763208,3207688,2832772992
9065000,3363518414,43812380,5.9146713e-12,250083298,3208884,2835981876
9070000,2523612924,43836277,5.917897395e-12,250849162,3206180,2839188056
9075000,9256956941,44080514,5.950869390000001e-12,249300185,3206656,2842394712
9080000,2164193573,43839100,5.9182785000000004e-12,250824392,3210408,2845605120
9085000,3516228058,43784345,5.910886575e-12,249232751,3204420,2848809540
9090000,2166312401,43834592,5.91766992e-12,250812099,3208832,2852018372
9095000,3478660681,43855563,5.9205010050000005e-12,251428558,3208800,2855227172
9100000,2153264828,43787052,5.91125202e-12,249274435,3209944,2858437116
9105000,2653411463,44143115,5.959320525e-12,251803706,3210856,2861647972
9110000,3876698373,43805611,5.9137574849999995e-12,249906831,3203968,2864851940
9115000,2081444499,43782245,5.910603075e-12,249156768,3204420,2868056360
9120000,3633387055,44044360,5.945988600000001e-12,248769406,3208816,2871265176
9125000,2629975765,43787400,5.911299e-12,249248860,3208292,2874473468
9130000,2915149889,43985075,5.937985125e-12,255613650,3209788,2877683256
9135000,3492271112,44233866,5.9715719100000005e-12,255084740,3206552,2880889808
9140000,2334604430,43951604,5.9334665400000005e-12,254546977,3205972,2884095780
9145000,4025808399,43958460,5.9343921e-12,254738285,3207844,2887303624
9150000,2144505808,44243266,5.9728409100000004e-12,255206254,3204796,2890508420
9155000,3927293201,43981108,5.93744958e-12,255499198,3211824,2893720244
9160000,3227851333,43978732,5.9371288200000005e-12,255343779,3207240,2896927484
9165000,3071194664,44256827,5.974671645e-12,255522974,3210624,2900138108
9170000,2147608264,43980700,5.937394500000001e-12,255483134,3206476,2903344584
9175000,7000328812,59471394,8.02863819e-12,253779023,44402000,2947746584
9180000,11400732279,60753763,8.201758005e-12,245532168,48325228,2996071812
9185000,5395611236,60364748,8.149240980000001e-12,244603137,48327548,3044399360
9190000,3304564004,60646416,8.187266160000001e-12,243716059,48324988,3092724348
9195000,3633645270,60384677,8.151931395000001e-12,245473806,48330616,3141054964
9200000,3530028530,60362883,8.148989205e-12,243440158,48349328,3189404292
9205000,4900994036,60712913,8.196243255e-12,245679213,48366456,3237770748
9210000,2896599308,60202763,8.127373005e-12,243556153,48370556,3286141304
9215000,4999422806,60661738,8.18933463e-12,244195813,48337340,3334478644
9220000,2252818879,49820788,6.7258063800000006e-12,243852742,24458044,3358936688
9225000,3117573464,40349516,5.44718466e-12,233585725,3208800,3362145488
9230000,4432985686,39964551,5.395214385000001e-12,235303481,3205800,3365351288
9235000,2901874879,39933155,5.3909759250000006e-12,233460385,3205128,3368556416
9240000,3586690038,40164359,5.422188465e-12,234574213,3208708,3371765124
9245000,2205881718,40166797,5.422517595000001e-12,233323848,3209844,3374974968
9250000,2479603277,39830587,5.377129245000001e-12,234007771,3211096,3378186064
9255000,3678283778,40118968,5.4160606800000005e-12,230358726,3207588,3381393652
9260000,2874148365,39829166,5.37693741e-12,228046117,3210580,3384604232
9265000,3591189381,39729979,5.363547165e-12,230611481,3209512,3387813744
9270000,3238121475,40040038,5.405405130000001e-12,229341009,3207148,3391020892
9275000,3041813279,39745726,5.36567301e-12,229997953,3206940,3394227832
9280000,2114873218,39954612,5.39387262e-12,234324706,3207888,3397435720
9285000,4105447515,39940398,5.3919537299999994e-12,234161819,3208528,3400644248
9290000,2268350998,39955812,5.3940346200000006e-12,236018265,3208880,3403853128
9295000,7586109544,40133810,5.4180643500000005e-12,233280113,3206060,3407059188
9300000,2459338044,39864728,5.38173828e-12,233899156,3207732,3410266920
9305000,2068824386,39883165,5.384227275000001e-12,234910887,3202060,3413468980
9310000,3426997288,39726409,5.3630652150000005e-12,234395985,3206300,3416675280
9315000,2199038646,39856593,5.380640055e-12,234881936,3211760,3419887040
9320000,2107383679,40215340,5.4290709e-12,235844018,3214156,3423101196
9325000,3471951214,40087483,5.411810205e-12,233779343,3206436,3426307632
9330000,2729685021,39897905,5.386217175e-12,234879642,3210156,3429517788
9335000,3484751932,39887810,5.38485435e-12,234702959,3206036,3432723824
9340000,3405540955,39871814,5.382694890000001e-12,234515144,3209216,3435933040
9345000,2953720025,39873320,5.382898200000001e-12,234236657,3205612,3439138652
9350000,4015200483,39764850,5.36825475e-12,233615755,3209712,3442348364
9355000,2495203681,39917129,5.388812415000001e-12,236359758,3206412,3445554776
9360000,3975886887,39873833,5.382967455e-12,234020063,3210332,3448765108
9365000,2438208970,39998846,5.399844210000001e-12,234888506,3208272,3451973380
9370000,4292467239,40255287,5.434463745e-12,233703731,3206372,3455179752
9375000,2268596969,39929059,5.390422965000001e-12,234801340,3205696,3458385448
9380000,4165811690,42007866,5.67106191e-12,234213782,3208520,3461593968
9385000,2312904182,45773124,6.17937174e-12,234368640,3207276,3464801244
9390000,3798957721,45822531,6.186041685000001e-12,234514672,3208392,3468009636
9395000,3640509622,45737343,6.174541305e-12,231814836,3211520,3471221156
9400000,2633980262,43320210,5.84822835e-12,228388987,3205864,3474427020
9405000,2897706169,39706654,5.360398290000001e-12,230057162,3209868,3477636888
9410000,2071568320,40456502,5.46162777e-12,228888782,3205804,3480842692
9415000,3512030781,40208136,5.428098360000001e-12,229086445,3208800,3484051492
9420000,2528834849,39752000,5.36652e-12,230387267,3209556,3487261048
9425000,2222074754,40372752,5.45032152e-12,234555447,3206744,3490467792
9430000,3422849735,39807919,5.374069065e-12,232411803,3205860,3493673652
9435000,2362388496,40495125,5.466841875e-12,229807789,3205812,3496879464
9440000,3343494673,40584863,5.478956505e-12,232107454,3204908,3500084372
9445000,2820749400,39885701,5.384569635e-12,234727331,3212280,3503296652
9450000,3964128834,40401417,5.454191295e-12,235368040,3208328,3506504980
9455000,2606942339,40207536,5.42801736e-12,234612334,3210736,3509715716
9460000,3485396916,40113168,5.41527768e-12,233133936,3208404,3512924120
9465000,2771086644,40364792,5.4492469200000004e-12,232704268,3206992,3516131112
9470000,3828947077,40167442,5.42260467e-12,233594242,3204760,3519335872
9475000,2691792661,40276800,5.437368e-12,233354830,3214228,3522550100
9480000,3739850040,28871839,3.897698265e-12,233576271,-1772854824,1749695276
9485000,2793195405,23346547,3.151783845e-12,203006286,3204768,1752900044
9490000,3128756717,23442759,3.1647724649999998e-12,206133168,3205144,1756105188
9495000,2078876918,23352074,3.1525299900000004e-12,203185916,3205828,1759311016
9500000,3559026937,23441969,3.1646658150000004e-12,206107512,3207060,1762518076
9505000,2404282989,23785639,3.211061265e-12,206361752,3210840,1765728916
9510000,3069825839,23393698,3.1581492300000004e-12,204538692,3205480,1768934396
9515000,2109677224,23416115,3.161175525e-12,205267237,3212144,1772146540
9520000,3940608715,23777037,3.209899995e-12,206082170,3210776,1775357316
9525000,2495895177,23379021,3.156167835e-12,204061687,3206348,1778563664
9530000,3931899262,23448560,3.1655556e-12,206321701,3209528,1781773192
9535000,2173071659,23755586,3.20700411e-12,205385017,3207772,1784980964
9540000,6195544227,23414260,3.1609251e-12,205206972,3212252,1788193216
9545000,2163767219,23447777,3.1654498949999997e-12,206296260,3209484,1791402700
9550000,3431686700,23648759,3.1925824650000002e-12,201913159,3202448,1794605148
9555000,2115638752,23301652,3.14572302e-12,201547210,3207980,1797813128
9560000,2416465745,23244164,3.1379621400000004e-12,199678857,3206128,1801019256
9565000,3999670014,23570020,3.1819527e-12,199354118,3209200,1804228456
9570000,3052122212,23224726,3.13533801e-12,199047094,3207548,1807436004
9575000,2986335083,23233195,3.136481325e-12,199322341,3208492,1810644496
9580000,2116161929,23542328,3.1782142800000003e-12,198454153,3209916,1813854412
9585000,5960753819,23237705,3.137090175e-12,199468931,3202792,1817057204
9590000,2176578823,23258707,3.139925445e-12,200151471,3206884,1820264088
9595000,2656587057,23735734,3.2043240900000005e-12,204739842,3205960,1823470048
9600000,3047745302,23376290,3.1557991500000003e-12,203972927,3206992,1826677040
9605000,2888955828,23427592,3.1627249200000003e-12,205640238,3210588,1829887628
9610000,4050216148,23741575,3.205112625e-12,204929664,3204984,1833092612
9615000,2811569252,23435598,3.1638057300000002e-12,205900439,3209344,1836301956
9620000,3795121875,23385741,3.157075035e-12,204280094,3207940,1839509896
9625000,2059372456,23461512,3.16730412e-12,206742634,3205872,1842715768
9630000,1314371152,23375069,3.155634315e-12,203933255,3210228,1845925996
9635000,2214958840,23402036,3.15927486e-12,204809689,3207848,1849133844
9640000,2774927633,23443704,3.16490004e-12,206163892,3207508,1852341352
9645000,2199009341,23727306,3.20318631e-12,204465929,3205024,1855546376
9650000,924405760,23456074,3.1665699900000002e-12,206565926,3208480,1858754856
9655000,2132389654,23433596,3.1635354600000004e-12,205835376,3205864,1861960720
9660000,2984408716,23403605,3.1594866750000004e-12,204860685,3204112,1865164832
9665000,3534915308,23392047,3.157926345e-12,204485041,3208436,1868373268
9670000,2170913675,23736988,3.2044933800000004e-12,204780588,3207116,1871580384
9675000,6914134631,23390714,3.15774639e-12,204441714,3204180,1874784564
9680000,2051102520,23733336,3.20400036e-12,204661888,3204992,1877989556
9685000,3067122489,23401200,3.159162e-12,204782498,3206448,1881196004
9690000,2183518782,23394366,3.15823941e-12,204560413,3203580,1884399584
9695000,2420717068,23381942,3.1565621700000002e-12,204156635,3201592,1887601176
9700000,2405521652,23398330,3.15877455e-12,204689237,3208976,1890810152
9705000,4341856176,23429865,3.163031775e-12,205714110,3207272,1894017424
9710000,2366565494,23443389,3.164857515e-12,206153642,3203220,1897220644
9715000,4119766007,23351224,3.1524152400000004e-12,203158274,3208704,1900429348
9720000,2758435416,23293898,3.1446762300000004e-12,201295204,3206568,1903635916
9725000,7417878175,23343736,3.1514043600000003e-12,202914931,3207928,1906843844
9730000,2091851643,23792650,3.2120077500000005e-12,206589600,3205964,1910049808
9735000,2494036051,23409130,3.1602325500000004e-12,205040228,3206880,1913256688
9740000,2329573078,23447431,3.165403185e-12,206285017,3205512,1916462200
9745000,3517755678,23421252,3.16186902e-12,205434196,3205172,1919667372
9750000,3981424846,23438303,3.164170905e-12,205988352,3209340,1922876712
9755000,2140127198,23464447,3.167700345e-12,206838031,3206008,1926082720
9760000,3829818992,23266154,3.14093079e-12,200393515,3209904,1929292624
9765000,2297569501,23210110,3.1333648500000003e-12,198572083,3209788,1932502412
9770000,6364255286,23274186,3.14201511e-12,200654541,3208856,1935711268
9775000,3427057095,23739658,3.2048538300000005e-12,204867358,3205956,1938917224
9780000,3290759099,23447118,3.16536093e-12,206274837,3203284,1942120508
9785000,194248895,23408408,3.16013508e-12,205016785,3207240,1945327748
9790000,2091057658,23419771,3.161669085e-12,205386070,3208420,1948536168
9795000,2370322372,23436544,3.16393344e-12,205931203,3207884,1951744052
9800000,4150371805,23401031,3.159139185e-12,204777007,3209452,1954953504
9805000,2868476334,23813741,3.2148550350000003e-12,207275073,3202668,1958156172
9810000,4205557618,23416238,3.16119213e-12,205271243,3206124,1961362296
9815000,2270930921,23433288,3.1634938800000003e-12,205825383,3209256,1964571552
9820000,7868320123,23721105,3.2023491750000003e-12,204264399,3207324,1967778876
9825000,2236860518,23762971,3.208001085e-12,205625030,3206388,1970985264
9830000,2542749208,23388055,3.1573874250000003e-12,204355280,3206408,1974191672
9835000,3758841755,23797267,3.2126310450000006e-12,206739666,3212108,1977403780
9840000,2394932663,23388674,3.15747099e-12,204375409,3207872,1980611652
9845000,2204173109,23416244,3.16119294e-12,205271443,3205392,1983817044
9850000,2434282089,23736676,3.20445126e-12,204770440,3208508,1987025552
9855000,2777334207,23428929,3.162905415e-12,205683711,3212556,1990238108
9860000,2291150468,23411648,3.16057248e-12,205122084,3206764,1993444872
9865000,6705284214,23718006,3.2019308100000004e-12,204163672,3207976,1996652848
9870000,2061675821,23780209,3.2103282150000002e-12,206185258,3207876,1999860724
9875000,3185247375,23394056,3.1581975600000003e-12,204550317,3207704,2003068428
9880000,2595690299,23417045,3.161301075e-12,205297475,3207144,2006275572
9885000,3930699349,23653797,3.193262595e-12,202076884,3207480,2009483052
9890000,2649195307,23381472,3.15649872e-12,204141331,3209724,2012692776
9895000,3132512770,23476122,3.16927647e-12,207217170,3205316,2015898092
9900000,2165216542,23583654,3.1837932900000003e-12,199797246,3207328,2019105420
9905000,2394875097,23262101,3.140383635e-12,200261781,3209920,2022315340
9910000,2424940123,23577934,3.1830210900000004e-12,199611341,3207936,2025523276
9915000,2124338978,23269846,3.1414292100000003e-12,200513501,3208984,2028732260
9920000,2672110620,23237551,3.1370693850000002e-12,199463920,3207876,2031940136
9925000,3979062587,23301434,3.14569359e-12,201540121,3210228,2035150364
9930000,2883329776,23461435,3.167293725e-12,206740152,3205988,2038356352
9935000,3753991994,23405195,3.1597013250000003e-12,204912340,3208680,2041565032
9940000,2748662973,23426403,3.162564405e-12,205601594,3209360,2044774392
9945000,3598934052,23388867,3.157497045e-12,204381680,3203540,2047977932
9950000,3343560784,23380089,3.1563120149999998e-12,204096411,3206880,2051184812
9955000,6719806166,23794185,3.212214975e-12,206639482,3211336,2054396148
9960000,2131415026,23384479,3.156904665e-12,204239070,3212684,2057608832
9965000,3530283819,23743574,3.2053824900000004e-12,204994635,3208100,2060816932
9970000,2913847859,23412992,3.1607539200000002e-12,205165731,3207064,2064023996
9975000,3563964407,23372415,3.155276025e-12,203846991,3209320,2067233316
9980000,2575750405,23765936,3.2084013600000004e-12,205721398,3206980,2070440296
9985000,4262891605,23394149,3.158210115e-12,204553339,3207968,2073648264
9990000,2949002321,23411190,3.1605106500000002e-12,205107177,3208440,2076856704
9995000,2879898834,23734839,3.2042032650000002e-12,204710763,3206508,2080063212
10000000,2652524220,23391086,3.1577966100000003e-12,204453468,3207064,2083270276
10005000,3280293937,23375914,3.15574839e-12,203960723,3210372,2086480648
10010000,2510144677,23350530,3.15232155e-12,203135728,3202272,2089682920
10015000,2061985793,23408828,3.16019178e-12,205030413,3203256,2092886176
10020000,2862756104,23727392,3.20319792e-12,204468710,3210220,2096096396
10025000,2266039763,23391809,3.157894215e-12,204477316,3210364,2099306760
10030000,4231222345,23305906,3.14629731e-12,201685444,3209184,2102515944
10035000,2390769510,23573499,3.182422365e-12,199467195,3204136,2105720080
10040000,3742442460,23233523,3.1365256050000003e-12,199333007,3205092,2108925172
10045000,3315797071,23222183,3.134994705e-12,198964438,3210536,2112135708
10050000,3033950484,23589383,3.184566705e-12,199983410,3205652,2115341360
10055000,2064095376,23439904,3.16438704e-12,206040401,3210644,2118552004
10060000,5703865903,23720350,3.20224725e-12,204239861,3209072,2121761076
10065000,2332645024,23438894,3.1642506900000003e-12,206007555,3206744,2124967820
10070000,2306045149,23389376,3.1575657600000003e-12,204398247,3207476,2128175296
10075000,3499420031,23400577,3.159077895e-12,204762266,3209212,2131384508
10080000,2062937020,23738689,3.204723015e-12,204835879,3207804,2134592312
10085000,3943306731,23413150,3.1607752500000003e-12,205170868,3209784,2137802096
10090000,2291740009,23422008,3.1619710800000006e-12,205458770,3204624,2141006720
10095000,2860361974,23722271,3.2025065850000004e-12,204302286,3205480,2144212200
10100000,2913458987,23439948,3.16439298e-12,206041809,3206992,2147419192
10105000,6329830423,23729987,3.2035482450000004e-12,204552677,3207496,2150626688
10110000,2921372404,23767051,3.208551885e-12,205757636,3203144,2153829832
10115000,2810922458,23359351,3.1535123850000002e-12,203422403,3205184,2157035016
10120000,3503434457,23439682,3.16435707e-12,206033173,3206564,2160241580
10125000,2876373110,23709767,3.200818545e-12,203895898,3203112,2163444692
10130000,3782749575,23414486,3.16095561e-12,205214297,3205944,2166650636
10135000,197940689,23398897,3.158851095e-12,204707674,3204392,2169855028
10140000,2079967763,23784158,3.21086133e-12,206313608,3205572,2173060600
10145000,2981158356,23433964,3.1635851399999998e-12,205847349,3206276,2176266876
10150000,6194966114,23739896,3.2048859600000003e-12,204875101,3204452,2179471328
10155000,2105157768,23427683,3.1627372050000006e-12,205643189,3206392,2182677720
10160000,3591011948,23731427,3.203742645e-12,204599866,3208000,2185885720
10165000,2754528393,23368489,3.154746015e-12,203719399,3208032,2189093752
10170000,3722070661,23394232,3.1582213200000004e-12,204556050,3207848,2192301600
10175000,2727780641,23695157,3.198846195e-12,203421090,3206248,2195507848
10180000,3151009249,23433908,3.16357758e-12,205845500,3207156,2198715004
10185000,2606279354,23373937,3.1554814950000004e-12,203896457,3208840,2201923844
10190000,3327550549,23779026,3.2101685100000003e-12,206146816,3209736,2205133580
10195000,3021539390,23232885,3.1364394750000004e-12,199312277,3209332,2208342912
10200000,7475616078,23546062,3.17871837e-12,198575491,3205612,2211548524
10205000,2666334057,23284385,3.1433919750000003e-12,200986023,3215540,2214764064
10210000,3641105410,23310181,3.146874435e-12,201824407,3207484,2217971548
10215000,3383311910,23458405,3.1668846750000002e-12,206641672,3208384,2221179932
10220000,3998539074,23388077,3.157390395e-12,204356021,3207500,2224387432
10225000,2486824916,23793302,3.21209577e-12,206610802,3207004,2227594436
10230000,2755625400,23420101,3.161713635e-12,205396806,3205980,2230800416
10235000,4236549931,23774485,3.2095554750000005e-12,205999230,3209504,2234009920
10240000,2154257870,23413523,3.160825605e-12,205183012,3206804,2237216724
10245000,7969808532,23714409,3.201445215e-12,204046775,3206640,2240423364
10250000,2957939331,23377074,3.1559049900000003e-12,203998407,3206628,2243629992
10255000,3318696524,23449882,3.16573407e-12,206364669,3208408,2246838400
10260000,2085738282,23386000,3.1571100000000005e-12,204288489,3207432,2250045832
10265000,3965209376,23412288,3.16065888e-12,205142880,3207384,2253253216
10270000,2907308692,23453307,3.166196445e-12,206475977,3211192,2256464408
10275000,3893475086,23723321,3.2026483350000002e-12,204336411,3205536,2259669944
10280000,2695200718,23437491,3.164061285e-12,205961977,3206408,2262876352
10285000,4174217951,23728225,3.2033103750000002e-12,204495806,3208432,2266084784
10290000,2773330581,23403590,3.15948465e-12,204860173,3207728,2269292512
10295000,7851753729,23798197,3.212756595e-12,206769877,3207504,2272500016
10300000,2109030501,23402094,3.15928269e-12,204811548,3204632,2275704648
10305000,3872038642,23440924,3.16452474e-12,206073551,3213108,2278917756
10310000,3210445469,23726603,3.203091405e-12,204443074,3206984,2282124740
10315000,3180072203,23394780,3.1582953e-12,204573853,3209344,2285334084
10320000,2160179095,23421426,3.1618925100000003e-12,205439859,3206008,2288540092
10325000,3986154966,23692730,3.19851855e-12,203342194,3206300,2291746392
10330000,2726320924,23438425,3.164187375e-12,205992327,3206540,2294952932
10335000,2083902938,23377904,3.1560170400000003e-12,204025373,3208208,2298161140
10340000,2705855608,23374023,3.1554931050000003e-12,203899247,3208664,2301369804
10345000,7525210446,23582659,3.183658965e-12,199764902,3208340,2304578144
10350000,2061864302,23204481,3.132604935e-12,198389148,3208832,2307786976
10355000,3153455406,23309541,3.1467880350000003e-12,201803579,3211196,2310998172
10360000,2348404741,23586692,3.1842034200000002e-12,199895975,3202940,2314201112
10365000,2964747092,23281905,3.143057175e-12,200905423,3208632,2317409744
10370000,2589851237,23256284,3.1395983400000002e-12,200072757,3206388,2320616132
10375000,4143223556,23638774,3.1912344900000004e-12,201588618,3208824,2323824956
10380000,2489522901,23470624,3.16853424e-12,207038802,3209912,2327034868
10385000,3301990995,23409942,3.16034217e-12,205066631,3204564,2330239432
10390000,2537561787,23459279,3.167002665e-12,206670078,3206024,2333445456
10395000,6218662491,23776657,3.2098486950000003e-12,206069828,3205136,2336650592
10400000,2208911278,23460520,3.1671702000000002e-12,206710403,3203644,2339854236
10405000,2123114904,23747570,3.20592195e-12,205124496,3207576,2343061812
10410000,3854352620,23386379,3.157161165e-12,204300825,3206040,2346267852
10415000,2158582951,23388944,3.15750744e-12,204384202,3209812,2349477664
10420000,3472975137,23777664,3.20998464e-12,206102570,3204460,2352682124
10425000,2252139540,23413575,3.160832625e-12,205184697,3203692,2355885816
10430000,4179045335,23449999,3.165749865e-12,206368459,3204540,2359090356
10435000,2190269611,23767310,3.2085868500000004e-12,205766051,3205136,2362295492
10440000,2238479241,23461769,3.167338815e-12,206750993,3206664,2365502156
10445000,2159569867,23447711,3.165440985e-12,206294126,3209460,2368711616
10450000,2068648127,23433623,3.1635391049999998e-12,205836243,3209188,2371920804
10455000,3411262938,23444095,3.164952825e-12,206176580,3205508,2375126312
10460000,2099336352,23296959,3.145089465e-12,201394669,3207548,2378333860
10465000,3523065259,23364170,3.15416295e-12,203579028,3213196,2381547056
10470000,3530692143,23719995,3.2021993250000002e-12,204228303,3210204,2384757260
10475000,2734798300,23406474,3.15987399e-12,204953925,3206448,2387963708
10480000,2891281284,23734771,3.2041940850000003e-12,204708534,3207896,2391171604
10485000,2589054590,23412954,3.16074879e-12,205164512,3210788,2394382392
10490000,6714061254,23896997,3.226094595e-12,209980894,3209128,2397591520
10495000,2066007040,23502621,3.172853835e-12,208078686,3206404,2400797924
10500000,3757935809,23392388,3.15797238e-12,204496133,3206248,2404004172
10505000,2066341322,23261476,3.14029926e-12,200241487,3206020,2407210192
10510000,3634280870,23321202,3.14836227e-12,202182581,3204908,2410415100
10515000,3246606090,23286893,3.1437305549999997e-12,201067533,3202724,2413617824
10520000,3115380212,23589826,3.18462651e-12,199997808,3206128,2416823952
10525000,2732560598,23272178,3.14174403e-12,200589290,3206916,2420030868
10530000,3893480449,23582606,3.18365181e-12,199763162,3206272,2423237140
10535000,2430826164,23305155,3.1461959250000005e-12,201661055,3209224,2426446364
10540000,2141483247,23458664,3.1669196400000005e-12,206650106,3206852,2429653216
10545000,2484812103,23747963,3.2059750050000002e-12,205137276,3209800,2432863016
10550000,2341765730,23456975,3.166691625e-12,206595201,3207352,2436070368
10555000,2185197560,23444543,3.165013305e-12,206191166,3210228,2439280596
10560000,4168335856,23743090,3.2053171500000003e-12,204978894,3207456,2442488052
10565000,2822121927,23456984,3.16669284e-12,206595506,3207964,2445696016
10570000,4045367016,23411752,3.1605865199999997e-12,205125445,3209468,2448905484
10575000,2414380309,23456617,3.166643295e-12,206582921,3205332,2452110816
10580000,2842049638,23449317,3.165657795e-12,206346326,3210764,2455321580
10585000,2098116589,23429712,3.1630111200000003e-12,205709136,3205888,2458527468
10590000,3325640897,23475854,3.16924029e-12,207208777,3204884,2461732352
10595000,2587235139,23434166,3.16361241e-12,205853913,3207588,2464939940
10600000,3238406044,23802815,3.2133800250000002e-12,206919956,3206584,2468146524
10605000,2061943101,23412179,3.1606441650000005e-12,205139329,3206920,2471353444
10610000,3538199120,23749105,3.206129175e-12,205174381,3206160,2474559604
10615000,2071498651,23414336,3.16093536e-12,205209416,3205980,2477765584
10620000,3042078918,23424683,3.1623322050000002e-12,205545690,3206000,2480971584
10625000,3488863849,23727124,3.2031617400000004e-12,204460026,3207008,2484178592
10630000,4303977145,23455061,3.166433235e-12,206532986,3201740,2487380332
10635000,3408465521,23413084,3.16076634e-12,205168745,3207820,2490588152
10640000,2498252793,23791662,3.21187437e-12,206557507,3210232,2493798384
10645000,3583027787,23388306,3.15742131e-12,204363456,3206604,2497004988
10650000,2134011613,23412373,3.1606703550000005e-12,205145618,3203376,2500208364
10655000,3958154830,23780332,3.2103448200000003e-12,206189267,3203260,2503411624
10660000,2096401491,23458657,3.166918695e-12,206649867,3208184,2506619808
10665000,2808144253,23342776,3.15127476e-12,202883738,3210480,2509830288
10670000,2602941809,23605995,3.1868093250000002e-12,200523323,3204972,2513035260
10675000,2320872757,23275739,3.142224765e-12,200705024,3207760,2516243020
10680000,2064289061,23258653,3.139918155e-12,200149065,3206700,2519449720
10685000,4190029433,23249242,3.13864767e-12,199843878,3207132,2522656852
10690000,2164096563,23623632,3.18919032e-12,201096527,3207652,2525864504
10695000,2496464479,23332921,3.149944335e-12,202563454,3204484,2529068988
10700000,4381989147,23771251,3.2091188850000002e-12,205894152,3204992,2532273980
10705000,2169931142,23425500,3.1624425000000002e-12,205572265,3209272,2535483252
10710000,3972588206,23258164,3.1398521399999997e-12,200133841,3207880,2538691132
10715000,2717911283,23680173,3.1968233550000003e-12,202934102,3208780,2541899912
10720000,6156867617,23462612,3.1674526200000003e-12,206778415,3205492,2545105404
10725000,2073861192,23776331,3.2098046850000003e-12,204967753,3205492,2548310896
10730000,2932188409,23465346,3.1678217100000004e-12,206867253,3208412,2551519308
10735000,2754789332,23786856,3.21122556e-12,206401300,3206860,2554726168
10740000,107241036,23424978,3.1623720299999998e-12,205555302,3211704,2557937872
10745000,2164912781,23478719,3.1696270650000003e-12,207301874,3205704,2561143576
10750000,3396563701,23773572,3.2094322200000002e-12,205969576,3208008,2564351584
10755000,3265755967,23451433,3.165943455e-12,206415094,3209768,2567561352
10760000,2253459062,23768085,3.208691475e-12,205791240,3206300,2570767652
10765000,7100362725,23364848,3.15425448e-12,203601054,3206460,2573974112
10770000,3428348542,23788035,3.2113847250000003e-12,206439610,3210956,2577185068
10775000,2064962766,23400089,3.159012015e-12,204746392,3206904,2580391972
10780000,2425937545,23443424,3.16486224e-12,206154783,3204600,2583596572
10785000,4399334449,23715493,3.2015915550000002e-12,204081318,3203848,2586800420
10790000,3410362309,23453062,3.16616337e-12,206468009,3209036,2590009456
10795000,2869448416,23734059,3.204097965e-12,204685379,3207324,2593216780
10800000,3007983061,23453230,3.16618605e-12,206473468,3205468,2596422248
10805000,3320290183,23418602,3.16151127e-12,205348059,3211292,2599633540
10810000,2443777401,23458664,3.1669196400000005e-12,206650077,3205064,2602838604
10815000,2073937854,23389442,3.1575746700000003e-12,204400380,3207260,2606045864
10820000,3901374498,23454904,3.1664120400000003e-12,206527906,3207748,2609253612
10825000,3313393877,23426478,3.16257453e-12,205604035,3209712,2612463324
10830000,3836965101,23430156,3.16307106e-12,205723562,3207144,2615670468
10835000,3141474150,23461440,3.1672944000000004e-12,206740296,3205272,2618875740
10840000,3444905370,23730787,3.2036562449999997e-12,204579051,3208812,2622084552
10845000,2189363011,23452054,3.16602729e-12,206435248,3206580,2625291132
10850000,3608268486,23760846,3.2077142100000004e-12,205555987,3210268,2628501400
10855000,4952776093,23427406,3.1626998100000002e-12,205634199,3205520,2631706920
10860000,2168367689,23613909,3.187877715e-12,211695562,3203044,2634909964
10865000,3379442926,23555164,3.17994714e-12,209786355,3207388,2638117352
10870000,2836758251,23628751,3.1898813850000002e-12,212177903,3206124,2641323476
10875000,4042432274,23902607,3.226851945e-12,210163199,3210140,2644533616
10880000,2615730048,23617252,3.1883290200000004e-12,211804191,3208504,2647742120
10885000,4073128428,23916913,3.2287832550000004e-12,210628164,3204504,2650946624
10890000,2965328821,23598856,3.18584556e-12,211206346,3205508,2654152132
10895000,3965032498,23620212,3.1887286200000005e-12,211900410,3208044,2657360176
10900000,5183291402,23891459,3.2253469650000004e-12,209800886,3209212,2660569388
10905000,5338698099,23618408,3.1884850800000005e-12,211841771,3206328,2663775716
10910000,3027600522,23916347,3.228706845e-12,210609759,3208184,2666983900
10915000,2107792534,23609179,3.187239165e-12,211541824,3208032,2670191932
10920000,2544632521,23924172,3.22976322e-12,210864084,3207828,2673399760
10925000,2079643010,23566003,3.1814104050000003e-12,210138593,3202184,2676601944
10930000,2116833621,23612534,3.18769209e-12,211650877,3208476,2679810420
10935000,3773266460,23907728,3.22754328e-12,210329655,3207252,2683017672
10940000,2785221790,23608134,3.1870980900000005e-12,211507875,3210368,2686228040
10945000,3078628841,23591794,3.18489219e-12,210976819,3206608,2689434648
10950000,2730155773,23884447,3.224400345e-12,209573020,3205180,2692639828
10955000,5762108338,23540904,3.17802204e-12,209322878,3205868,2695845696
10960000,2334168685,23609229,3.187245915e-12,211543463,3206480,2699052176
10965000,3214117983,23547279,3.178882665e-12,209530072,3207916,2702260092
10970000,111533602,23546705,3.1788051750000003e-12,209511423,3209356,2705469448
10975000,2185282861,23700647,3.1995873450000003e-12,203599511,3207888,2708677336
10980000,2395835784,23403050,3.1594117500000004e-12,204842626,3208684,2711886020
10985000,2142717307,23432627,3.163404645e-12,205803891,3209256,2715095276
10990000,3011537885,23523909,3.1757277150000005e-12,208770562,3204668,2718299944
10995000,4032271202,23595857,3.185440695e-12,211108853,3208512,2721508456
11000000,3718342395,23880585,3.223878975e-12,209447501,3210436,2724718892
11005000,2314260574,23577145,3.1829145750000004e-12,210500720,3207840,2727926732
11010000,2060439853,23541775,3.1781396250000002e-12,209351204,3206200,2731132932
11015000,3769605761,23528427,3.176337645e-12,208917378,3204856,2734337788
11020000,3121147591,23548300,3.1790205000000002e-12,209563270,3207436,2737545224
11025000,3967293044,23907899,3.2275663650000004e-12,210335178,3206876,2740752100
11030000,2706371867,23603981,3.186537435e-12,211372905,3205048,2743957148
11035000,4201882385,23872094,3.22273269e-12,209171526,3210176,2747167324
11040000,2964296109,23575973,3.182756355e-12,210462629,3208708,2750376032
11045000,2890452092,23585035,3.183979725e-12,210757134,3206192,2753582224
11050000,2941439060,23575210,3.1826533500000003e-12,210437847,3209524,2756791748
11055000,4180734841,23605825,3.186786375e-12,211432836,3210520,2760002268
11060000,2129519635,23585062,3.1839833700000004e-12,210758036,3208328,2763210596
11065000,3805917512,23518320,3.1749732000000004e-12,208588901,3205940,2766416536
11070000,3355614880,23592965,3.185050275e-12,211014882,3206984,2769623520
11075000,2810973135,23868248,3.2222134800000005e-12,209046555,3204504,2772828024
11080000,2174698547,23565423,3.1813321050000004e-12,210119763,3209744,2776037768
11085000,3298737460,23578482,3.18309507e-12,210544180,3204312,2779242080
11090000,4581848092,23570508,3.18201858e-12,210285020,3209764,2782451844
11095000,7543105622,23610265,3.1873857749999998e-12,211577108,3205556,2785657400
11100000,8365959032,23872063,3.222728505e-12,209170519,3211220,2788868620
11105000,3694788013,23632838,3.19043313e-12,212310739,3209484,2792078104
11110000,2822619456,23553288,3.17969388e-12,209725375,3204928,2795283032
11115000,4102200160,23580744,3.18340044e-12,210617704,3208152,2798491184
11120000,2072355094,23910499,3.2279173650000003e-12,210419699,3206364,2801697548
11125000,3941486584,23390696,3.1577439599999998e-12,204441112,3209092,2804906640
11130000,2563966694,23440384,3.1644518400000005e-12,206055972,3209252,2808115892
11135000,3193605383,23917463,3.228857505e-12,210646029,3207964,2811323856
11140000,2789779152,23559281,3.180502935e-12,209920148,3205392,2814529248
11145000,4007793740,23611677,3.187576395e-12,211623009,3207372,2817736620
11150000,2245554871,23558920,3.1804542e-12,209908423,3204144,2820940764
11155000,3616852330,23589533,3.184586955e-12,210903334,3209248,2824150012
11160000,3003782146,23428845,3.162894075e-12,205680977,3206976,2827356988
11165000,2944389441,23382123,3.156586605e-12,204162510,3203548,2830560536
11170000,2211882091,23440548,3.1644739800000003e-12,206061336,3207444,2833767980
11175000,2845057529,23467305,3.1680861750000003e-12,206930924,3209948,2836977928
11180000,2228491937,23941612,3.23211762e-12,211430865,3206284,2840184212
11185000,2085899024,23566194,3.1814361900000004e-12,210144806,3201964,2843386176
11190000,3906991804,23935882,3.2313440700000003e-12,211244650,3205548,2846591724
11195000,2797646352,23544950,3.17856825e-12,209454379,3204112,2849795836
11200000,3341346589,23603250,3.18643875e-12,211349119,3207700,2853003536
11205000,2317782184,23573918,3.18247893e-12,210395854,3207660,2856211196
11210000,3317468605,23539921,3.177889335e-12,209290945,3206740,2859417936
11215000,2092093303,23904749,3.227141115e-12,210232825,3203588,2862621524
11220000,3780115038,23550693,3.1793435550000003e-12,209641047,3206928,2865828452
11225000,2433664534,23572482,3.1822850700000003e-12,210349171,3209684,2869038136
11230000,4586381218,23889236,3.2250468600000006e-12,209728650,3210408,2872248544
11235000,2351609249,23849291,3.219654285e-12,208430453,3209788,2875458332
11240000,2444206232,23569458,3.18187683e-12,210250889,3207836,2878666168
11245000,3776949818,23568968,3.18181068e-12,210234953,3208836,2881875004
11250000,2692207213,23867037,3.222049995e-12,209007169,3206760,2885081764
11255000,3446721370,23534563,3.1771660050000002e-12,209115884,3201672,2888283436
11260000,2432320709,23594362,3.18523887e-12,211060276,3208792,2891492228
11265000,3568262598,23876595,3.2233403250000005e-12,209317830,3205472,2894697700
11270000,2246478653,23492317,3.171462795e-12,207743816,3206796,2897904496
11275000,8717805059,23729998,3.2035497300000005e-12,204553400,3205980,2901110476
11280000,2051733103,23401312,3.15917712e-12,204786132,3204624,2904315100
11285000,3555243195,23756687,3.2071527450000003e-12,205420815,3205000,2907520100
11290000,2888781092,23405723,3.159772605e-12,204929507,3205908,2910726008
11295000,2265409007,23449468,3.16567818e-12,206351212,3208636,2913934644
11300000,3300888156,23731798,3.2037927300000002e-12,204611912,3205508,2917140152
11305000,2489463496,23475270,3.1691614500000002e-12,207189786,3207804,2920347956
11310000,2227408195,23914602,3.22847127e-12,210553033,3207564,2923555520
11315000,3883210339,23557996,3.1803294600000002e-12,209878366,3205344,2926760864
11320000,2145041874,23594200,3.185217e-12,211055004,3208740,2929969604
11325000,2420483931,23568286,3.18171861e-12,210212802,3206536,2933176140
11330000,3668707400,23923822,3.2297159700000004e-12,210852688,3206452,2936382592
11335000,2406787717,23565182,3.18129957e-12,210111932,3207780,2939590372
11340000,9475437440,23598834,3.18584259e-12,211205603,3208388,2942798760
11345000,22223760169,23928216,3.23030916e-12,209904011,3206080,2946004840
11350000,14218632567,24729332,3.3384598200000004e-12,210835769,3203076,2949207916
11355000,2071143070,23903390,3.2269576500000005e-12,210188660,3214288,2952422204
11360000,2062184761,23608635,3.187165725e-12,211523166,3206116,2955628320
11365000,2064947581,23573597,3.1824355950000004e-12,210385406,3207252,2958835572
11370000,4088181679,23606143,3.1868293050000003e-12,211443154,3205112,2962040684
11375000,3322260566,23901646,3.2267222100000004e-12,210131985,3206856,2965247540
11380000,2157908736,23569453,3.1818761550000002e-12,210250723,3204916,2968452456
11385000,2535882846,23932078,3.23083053e-12,211121013,3206452,2971658908
11390000,3812575281,23546480,3.1787748e-12,209504103,3208728,2974867636
11395000,2218203882,23932380,3.2308713000000003e-12,211130821,3204792,2978072428
11400000,2353355931,23555858,3.18004083e-12,209808907,3206468,2981278896
11405000,4131053848,23946455,3.232771425e-12,211588271,3211292,2984490188
11410000,2669120836,23608092,3.18709242e-12,211506482,3208760,2987698948
11415000,3628883004,23575857,3.1827406950000004e-12,210458867,3210716,2990909664
11420000,2616582155,23486665,3.1706997750000005e-12,207560108,3205784,2994115448
11425000,3443920792,23751315,3.2064275250000003e-12,205246207,3208816,2997324264
11430000,2593147078,23405325,3.159718875e-12,204916585,3204316,3000528580
11435000,8010262968,23783970,3.21083595e-12,206307517,3209840,3003738420
11440000,2086184399,23584517,3.183909795e-12,210740308,3205876,3006944296
11445000,2957245663,23558337,3.1803754950000002e-12,209889471,3205412,3010149708
11450000,4189016633,23586045,3.1841160750000005e-12,210789964,3213092,3013362800
11455000,2318504974,23862178,3.2213940300000004e-12,208849273,3208896,3016571696
11460000,2915624506,23582959,3.1836994650000003e-12,210689670,3207100,3019778796
11465000,2537941469,23540603,3.1779814050000004e-12,209312098,3204804,3022983600
11470000,3323903841,23884152,3.2243605200000003e-12,209563426,3206528,3026190128
11475000,2496969509,23545828,3.17868678e-12,209482917,3207396,3029397524
11480000,7206934596,23903456,3.22696656e-12,210190808,3207868,3032605392
11485000,3186642623,23608496,3.18714696e-12,211519621,3209448,3035814840
11490000,3344262428,23858567,3.220906545e-12,208731894,3208940,3039023780
11495000,2520536335,23562921,3.1809943350000003e-12,210038429,3209216,3042232996
11500000,4554275640,23580761,3.1834027350000004e-12,210618251,3206912,3045439908
11505000,2309484187,23944023,3.2324431050000003e-12,211509215,3208068,3048647976
11510000,3903407644,23567254,3.18157929e-12,210179270,3204140,3051852116
11515000,1673328679,23553686,3.1797476100000004e-12,209738297,3207500,3055059616
11520000,2164153252,23918256,3.22896456e-12,210671809,3208180,3058267796
11525000,3740834688,23579656,3.1832535600000003e-12,210582328,3207328,3061475124
11530000,5929476820,23923283,3.229643205e-12,210835175,3202196,3064677320
11535000,3419158008,23542413,3.178225755e-12,209371942,3207144,3067884464
11540000,2211434637,23922990,3.2296036500000004e-12,210825663,3204272,3071088736
11545000,2734290340,23535666,3.17731491e-12,209152665,3205280,3074294016
11550000,2119556081,23512293,3.1741595550000003e-12,208393021,3204892,3077498908
11555000,2564102777,23576743,3.1828603050000004e-12,210487658,3204956,3080703864
11560000,3468985716,23564201,3.181167135e-12,210080040,3207164,3083911028
11565000,2418428656,23530455,3.176611425e-12,208983285,3210080,3087121108
11570000,2181445850,23937724,3.2315927400000003e-12,211304508,3206172,3090327280
11575000,2128224927,23421356,3.16188306e-12,205437564,3210684,3093537964
11580000,2888308394,23445264,3.16511064e-12,206214588,3208128,3096746092
11585000,2179322900,23715097,3.2015380950000004e-12,204069144,3207820,3099953912
11590000,3531867676,23408847,3.160194345e-12,205031034,3207388,3103161300
11595000,2280455405,23451896,3.16600596e-12,206430116,3203704,3106365004
11600000,2088083451,23390956,3.1577790600000002e-12,204449564,3205300,3109570304
11605000,2787739895,23475039,3.1691302650000003e-12,207182267,3211876,3112782180
11610000,2078557528,23892031,3.225424185e-12,209819504,3209684,3115991864
11615000,8262943165,23563429,3.181062915e-12,210054941,3204492,3119196356
11620000,2259653539,23943281,3.232342935e-12,211485118,3207724,3122404080
11625000,2726798686,23577674,3.18298599e-12,210517915,3205964,3125610044
11630000,3969080858,23944972,3.23257122e-12,211540067,3202756,3128812800
11635000,3064844142,23562976,3.18100176e-12,210040247,3206804,3132019604
11640000,3414911157,23618341,3.188476035e-12,211839604,3207216,3135226820
11645000,2356918015,23607068,3.18695418e-12,211473234,3209872,3138436692
11650000,3795658206,23577828,3.18300678e-12,210522933,3208204,3141644896
11655000,2918908675,23946542,3.2327831700000003e-12,211591101,3211124,3144856020
11660000,5240435420,23553075,3.1796651250000003e-12,209718453,3204796,3148060816
11665000,2135781631,23563148,3.1810249800000004e-12,210045825,3206612,3151267428
11670000,3125952416,23544788,3.17854638e-12,209449131,3202584,3154470012
11675000,4436341349,23903867,3.2270220450000002e-12,210204177,3209364,3157679376
11680000,2707778074,23606745,3.186910575e-12,211462714,3208404,3160887780
11685000,2861750070,23897411,3.226150485e-12,209994325,3208248,3164096028
11690000,2117585604,23612621,3.187703835e-12,211653687,3204744,3167300772
11695000,3336211063,23563150,3.18102525e-12,210045887,3204980,3170505752
11700000,2060003778,23601532,3.18620682e-12,211293291,3207356,3173713108
11705000,4247480732,23597572,3.1856722200000003e-12,211164583,3208972,3176922080
11710000,2056339845,23920946,3.22932771e-12,210759214,3205716,3180127796
11715000,3486517784,23579435,3.183223725e-12,210575143,3208756,3183336552
11720000,2171832526,23596354,3.1855077900000005e-12,211125018,3206292,3186542844
11725000,4017033085,23949854,3.2332302900000004e-12,211698747,3208496,3189751340
11730000,2125098725,23768920,3.2088042000000002e-12,216733416,3206668,3192958008
11735000,4462759643,23572185,3.182244975e-12,210339524,3207644,3196165652
11740000,2164191198,23934802,3.23119827e-12,211209548,3207332,3199372984
11745000,4327949305,23518182,3.17495457e-12,208584437,3207872,3202580856
11750000,3535485064,23608510,3.1871488500000004e-12,211520092,3207812,3205788668
11755000,7028687188,23552642,3.1796066700000003e-12,209704384,3208408,3208997076
11760000,2054011906,23954336,3.23383536e-12,211844412,3205056,3212202132
11765000,2151830828,23583635,3.183790725e-12,210711639,3206876,3215409008
11770000,4145657794,23567207,3.181572945e-12,210177740,3208552,3218617560
11775000,109178077,23602840,3.1863834e-12,211335824,3208052,3221825612
11780000,2081441161,23587160,3.1842666e-12,210826201,3206948,3225032560
11785000,3129426992,23969936,3.23594136e-12,212351398,3207700,3228240260
11790000,3397120842,23577418,3.1829514299999997e-12,210509598,3209064,3231449324
11795000,3695668509,23604091,3.186552285e-12,211376471,3206280,3234655604
11800000,6220096178,23938530,3.23170155e-12,211330716,3206864,3237862468
11805000,2374604493,23599801,3.1859731350000003e-12,211237051,3207352,3241069820
11810000,3975581688,23816314,3.2152023900000004e-12,207358687,3206840,3244276660
11815000,2088076489,23428913,3.162903255e-12,205683182,3209060,3247485720
11820000,3825254332,23473355,3.168902925e-12,207127542,3207248,3250692968
11825000,2552734657,23757078,3.20720553e-12,205433520,3209680,3253902648
11830000,3822645670,23473428,3.1689127800000003e-12,207129913,3208216,3257110864
11835000,2914926722,23821845,3.2159490749999997e-12,207538455,3208372,3260319236
11840000,3636464936,23440884,3.16451934e-12,206072227,3209292,3263528528
11845000,2943558793,23488132,3.17089782e-12,207607798,3206708,3266735236
11850000,2567063705,23486786,3.1707161100000003e-12,207564063,3205812,3269941048
11855000,2949382037,23488220,3.1709097e-12,207610657,3204800,3273145848
11860000,2120525883,23701758,3.19973733e-12,203635610,3207424,3276353272
11865000,2892214608,23406066,3.1598189100000004e-12,204940644,3208536,3279561808
11870000,3959850227,23774278,3.20952753e-12,205992523,3204496,3282766304
11875000,2688789074,23422373,3.1620203550000003e-12,205470641,3210684,3285976988
11880000,4146609874,23456003,3.166560405e-12,206563598,3204364,3289181352
11885000,2515523646,23950764,3.2333531400000003e-12,211728306,3210800,3292392152
11890000,3997797215,23592896,3.18504096e-12,211012642,3207816,3295599968
11895000,2333535540,23614005,3.187890675e-12,211698679,3209384,3298809352
11900000,6636766481,23951651,3.2334728850000005e-12,211757142,3207472,3302016824
11905000,2204877521,23521588,3.1754143800000004e-12,208695123,3205356,3305222180
11910000,2642170683,23599620,3.1859487000000002e-12,211231156,3206908,3308429088
11915000,2209046698,23560367,3.180649545e-12,209955446,3208724,3311637812
11920000,2571857002,23942016,3.2321721600000005e-12,211443998,3208240,3314846052
11925000,3861087280,23540394,3.17795319e-12,209306304,3207268,3318053320
11930000,2201682580,23571075,3.1820951250000004e-12,210303452,3204828,3321258148
11935000,2213135256,23944625,3.232524375e-12,211527504,3203340,3324461488
11940000,2628691880,23537431,3.1775531850000002e-12,209210023,3208036,3327669524
11945000,8284441879,23928776,3.2303847600000002e-12,211013699,3208296,3330877820
11950000,2210776671,23622197,3.188996595e-12,211964909,3205828,3334083648
11955000,2095288730,23590671,3.184740585e-12,210940309,3206992,3337290640
11960000,3792885034,23585004,3.18397554e-12,210756130,3210244,3340500884
11965000,2360364178,23910956,3.22797906e-12,210434553,3208776,3343709660
11970000,4056284325,23534832,3.1772023199999997e-12,209125559,3208736,3346918396
11975000,2731991099,23579273,3.183201855e-12,210569869,3209924,3350128320
11980000,4148608339,23915410,3.22858035e-12,210579288,3206984,3353335304
11985000,2174401694,23552722,3.17961747e-12,209706967,3209252,3356544556
11990000,8048578847,23788203,3.211407405e-12,206445085,3207832,3359752388
11995000,2136375110,23435764,3.1638281400000003e-12,205905857,3211160,3362963548
12000000,2763513123,23464172,3.1676632200000003e-12,206829116,3205656,3366169204
12005000,3869163937,23377372,3.1559452200000003e-12,204008115,3211636,3369380840
12010000,2116022930,23804951,3.213668385e-12,206989402,3203232,3372584072
12015000,3802917438,23415390,3.16107765e-12,205243670,3203920,3375787992
12020000,2154073106,23430185,3.1630749750000002e-12,205724529,3206548,3378994540
12025000,4406911737,23792284,3.2119583399999997e-12,206577702,3208848,3382203388
12030000,2140962412,23404449,3.159600615e-12,204888114,3207276,3385410664
12035000,7517262682,23764109,3.208154715e-12,205662021,3206064,3388616728
12040000,2383789645,23590849,3.184764615e-12,210944803,3208856,3391825584
12045000,2219439620,23550872,3.17936772e-12,209646849,3207492,3395033076
12050000,3958214724,23606030,3.18681405e-12,211439472,3207516,3398240592
12055000,2612948436,23847336,3.21939036e-12,208366898,3211216,3401451808
12060000,4128147175,23614201,3.187917135e-12,211705044,3202720,3404654528
12065000,2549461337,23582212,3.18359862e-12,210665381,3206884,3407861412
12070000,4329484454,23939563,3.231841005e-12,211364275,3204844,3411066256
12075000,2708693282,23545209,3.1786032150000004e-12,209462804,3203916,3414270172
12080000,5642728515,23909439,3.227774265e-12,210385247,3206344,3417476516
12085000,2401253225,23608462,3.18714237e-12,211518520,3209312,3420685828
12090000,2346897926,23570596,3.18203046e-12,210287894,3210228,3423896056
12095000,3809629906,23582772,3.18367422e-12,210683600,3206920,3427102976
12100000,2830879949,23916266,3.2286959100000003e-12,210607137,3204276,3430307252
12105000,3866276008,23593303,3.185095905e-12,211025846,3206320,3433513572
12110000,2168355140,23610882,3.1874690700000004e-12,211597174,3205528,3436719100
12115000,2667230549,23551816,3.17949516e-12,209677542,3207192,3439926292
12120000,6046018247,23881279,3.2239726650000003e-12,209470031,3206756,3443133048
12125000,2524789443,23576562,3.18283587e-12,210481781,3207544,3446340592
12130000,2665147145,23545417,3.1786312950000003e-12,209469572,3206992,3449547584
12135000,3813994777,23582615,3.183653025e-12,210678491,3203488,3452751072
12140000,1356280038,23586741,3.184210035e-12,210812580,3207192,3455958264
12145000,2345577578,23911440,3.2280443999999998e-12,210448935,3209400,3459167664
12150000,2139591918,23596638,3.18554613e-12,211134230,3206408,3462374072
12155000,3479077526,23881417,3.223991295e-12,209474530,3207728,3465581800
12160000,2143748692,23613899,3.1878763649999998e-12,211695219,3202636,3468784436
12165000,7354937038,23759018,3.20746743e-12,205496549,3211276,3471995712
12170000,2385282895,23434281,3.163627935e-12,205857628,3209880,3475205592
12175000,2629332570,23413200,3.160782e-12,205172505,3211196,3478416788
12180000,3326747612,23404910,3.1596628500000003e-12,204903079,3208744,3481625532
12185000,2677269538,23776468,3.2098231800000002e-12,206063688,3208712,3484834244
12190000,2210943615,23384212,3.1568686200000002e-12,204230381,3206500,3488040744
12195000,3534807519,26468653,3.573268155e-12,204662269,3209452,3491250196
12200000,3212815880,44319233,5.9830964550000004e-12,255554937,3209032,3494459228
12205000,2878955112,44067847,5.949159345000001e-12,258398692,3206432,3497665660
12210000,2139267745,44169671,5.962905585e-12,261661245,3208432,3500874092
12215000,3385468019,44417772,5.996399220000001e-12,258806952,3208308,3504082400
12220000,2874530459,44131866,5.95780191e-12,260562591,3206120,3507288520
12225000,2214464101,44106536,5.95438236e-12,259743310,3206784,3510495304
12230000,3664149139,44098170,5.953252950000001e-12,259311088,3208984,3513704288
12235000,2435592379,44120270,5.95623645e-12,260033772,3209960,3516914248
12240000,2185807314,44422394,5.99702319e-12,258990317,3206348,3520120596
12245000,2570582685,44170458,5.96301183e-12,261547894,3210296,3523330892
12250000,4898411655,44426391,5.997562785000001e-12,259146938,3207608,3526538500
12255000,3393292986,44462258,6.0024048300000006e-12,260190351,3209428,3529747928
12260000,3690594924,44088051,5.951886885000001e-12,259062043,3205136,3532953064
12265000,2738748905,44447932,6.000470820000001e-12,259799375,3208552,3536161616
12270000,2244581464,44131135,5.957703225e-12,260638137,3203608,3539365224
12275000,3909672290,44093284,5.952593340000001e-12,258990902,3211788,3542577012
12280000,3361588585,44482448,6.00513048e-12,260938721,3209024,3545786036
12285000,3300218102,44092018,5.95242243e-12,259052072,3209616,3548995652
12290000,2070346726,44450007,6.000750945e-12,259862279,3205460,3552201112
12295000,5611310993,44456964,6.00169014e-12,260112451,3206912,3555408024
12300000,3346169628,44107376,5.95449576e-12,259622831,3208228,3558616252
12305000,2816288745,44161344,5.961781440000001e-12,261396952,3207608,3561823860
12310000,2218423556,44454455,6.001351425000001e-12,259893260,3208060,3565031920
12315000,2992207996,44077567,5.9504715450000004e-12,258754962,3206888,3568238808
12320000,2104548672,44442399,5.999723865e-12,259617391,3206928,3571445736
12325000,2508165199,43953982,5.933787570000001e-12,254499063,3210756,3574656492
12330000,4244362952,44294476,5.979754260000001e-12,254745545,3208348,3577864840
12335000,2447236637,43896291,5.9259992850000005e-12,252631888,3210456,3581075296
12340000,4106942749,43976499,5.9368273649999995e-12,255501627,3204520,3584279816
12345000,2123340029,44086244,5.951642940000001e-12,258964391,3207024,3587486840
12350000,7265053345,44407448,5.995005480000001e-12,258364890,3206916,3590693756
12355000,3282846170,44537490,6.01256115e-12,260110494,3211500,3593905256
12360000,2160225825,44099633,5.953450455e-12,259395957,3207656,3597112912
12365000,2353894035,44095697,5.9529190950000005e-12,259351807,3207144,3600320056
12370000,4277431934,44083152,5.95122552e-12,258715963,3209664,3603529720
12375000,3075858681,44465616,6.0028581599999996e-12,260377630,3205580,3606735300
12380000,4464447096,44101519,5.953705065e-12,259324298,3209260,3609944560
12385000,2726717966,44136371,5.958410085e-12,260610037,3208720,3613153280
12390000,4131284007,44460442,6.002159670000001e-12,260275224,3203372,3616356652
12395000,2536948119,44058808,5.94793908e-12,258193987,3204940,3619561592
12400000,5641727500,44482104,6.00508404e-12,260788066,3205696,3622767288
12405000,3360499967,44509674,6.00880599e-12,261338622,3214688,3625981976
12410000,2774596717,44117219,5.955824565e-12,260120318,3205564,3629187540
12415000,3678245838,44424054,5.9972472900000005e-12,258668394,3208600,3632396140
12420000,2540072881,44127775,5.957249625e-12,260307406,3208056,3635604196
12425000,2951933152,44093221,5.952584835e-12,259190353,3208624,3638812820
12430000,2450360966,44445833,6.000187455000001e-12,259363827,3209316,3642022136
12435000,2399379535,44125877,5.956993395e-12,260286425,3209016,3645231152
12440000,2233108958,44094961,5.952819735e-12,259148968,3210712,3648441864
12445000,3969678063,44479672,6.00475572e-12,260641857,3208932,3651650796
12450000,5010389013,44106089,5.954322015e-12,259346613,3213204,3654864000
12455000,2123157380,44509510,6.00878385e-12,261328091,3207320,3658071320
12460000,2189002181,44076221,5.950289835e-12,258703281,3205184,3661276504
12465000,3497790827,44089045,5.9520210750000005e-12,259086813,3209196,3664485700
12470000,3178711466,44097739,5.953194765e-12,259398193,3204296,3667689996
12475000,2565479800,44337694,5.985588690000001e-12,255742314,3209288,3670899284
12480000,3978128679,43935780,5.9313303000000005e-12,254163964,3210884,3674110168
12485000,2247022126,44078662,5.95061937e-12,258620612,3206508,3677316676
12490000,3955996320,44419451,5.996625885000001e-12,258531090,3206400,3680523076
12495000,2267455526,44118569,5.9560068149999995e-12,259958660,3208408,3683731484
12500000,2492224113,44046680,5.9463018000000005e-12,257842601,3204552,3686936036
12505000,2704194843,44031108,5.94419958e-12,257025446,3208468,3690144504
12510000,2457544750,44491118,6.006300930000001e-12,259801067,3205900,3693350404
12515000,2064517155,43974915,5.936613525e-12,255305542,3207392,3696557796
12520000,3419692308,56259172,7.594988220000001e-12,254950778,36375544,3732933340
12525000,3804902216,60688274,8.19291699e-12,243172359,48421232,3781354572
12530000,6701509587,60431417,8.158241295e-12,244953185,48405780,3829760352
12535000,4950075981,60810350,8.209397250000001e-12,247150784,48415584,3878175936
12540000,2843206532,52310169,7.061872815000001e-12,250822042,29348776,3907524712
12545000,2185335408,40337186,5.4455201100000006e-12,238642083,3207416,3910732128
12550000,3378046428,40223138,5.43012363e-12,240803755,3203744,3913935872
12555000,2163107196,40252225,5.4340503750000005e-12,239899881,3213100,3917148972
12560000,6460330076,40134235,5.418121725e-12,239427390,3204920,3920353892
12565000,3140939125,40230847,5.431164345e-12,239303421,3203204,3923557096
12570000,2727775862,40172056,5.42322756e-12,239758371,3207700,3926764796
12575000,2478576567,40327554,5.44421979e-12,240292814,3206876,3929971672
12580000,2722679033,40356113,5.448075255000001e-12,239134672,3208648,3933180320
12585000,4437310362,40145360,5.4196236e-12,239742681,3209888,3936390208
12590000,2171790736,40128295,5.417319825e-12,240088383,3206496,3939596704
12595000,3281985980,40623220,5.484134700000001e-12,238401068,3208576,3942805280
12600000,2064514689,40271841,5.4366985350000005e-12,240072698,3204796,3946010076
12605000,3005639912,40055757,5.407527195e-12,240059212,3210656,3949220732
12610000,3636869713,40070088,5.40946188e-12,240505001,3208816,3952429548
12615000,3455087784,40081223,5.410965105e-12,238591277,3208284,3955637832
12620000,2710722803,39863465,5.381567775e-12,239812331,3210004,3958847836
12625000,2583533184,40797069,5.507604315000001e-12,239659440,3203636,3962051472
12630000,4038220659,40324325,5.443783875e-12,240376541,3210252,3965261724
12635000,2705708530,39914870,5.3885074500000006e-12,235547283,3207252,3968468976
12640000,3612309369,40132042,5.417825670000001e-12,233821380,3209232,3971678208
12645000,2066987864,39898170,5.3862529500000005e-12,235327957,3203240,3974881448
12650000,2719368684,39880878,5.38391853e-12,234405142,3208172,3978089620
12655000,5137896479,39769633,5.368900455e-12,236182477,3204316,3981293936
12660000,3613240855,40204192,5.427565920000001e-12,238874475,3209992,3984503928
12665000,3293174048,40145969,5.419705815e-12,236195426,3208252,3987712180
12670000,2156236846,40124649,5.416827615000001e-12,235197213,3208208,3990920388
12675000,3043611391,40822753,5.511071655000001e-12,241015422,3208528,3994128916
12680000,2270549551,40285072,5.4384847200000005e-12,239374675,3207808,3997336724
12685000,2831130096,40064688,5.40873288e-12,240326883,3203744,4000540468
12690000,3958071588,40421616,5.45691816e-12,239718356,3202120,4003742588
12695000,2589677060,40053033,5.4071594550000005e-12,240470063,3202260,4006944848
12700000,4475922898,40445904,5.460197040000001e-12,240396742,3212240,4010157088
12705000,2299207266,40001118,5.40015093e-12,238676410,3207268,4013364356
12710000,2060542920,40059836,5.40807786e-12,240301269,3206012,4016570368
12715000,6345369375,40304791,5.441146785e-12,238064757,3205644,4019776012
12720000,4116050135,40140602,5.41898127e-12,240817076,3205524,4022981536
12725000,3504469736,40494842,5.46680367e-12,239665322,3207380,4026188916
12730000,2097354733,40102644,5.41385694e-12,240613311,3207652,4029396568
12735000,3788151958,40216125,5.429176875000001e-12,238931368,3204400,4032600968
12740000,2339118185,40726186,5.49803511e-12,239509232,3207412,4035808380
12745000,4004733090,44496574,6.00703749e-12,241056105,3206920,4039015300
12750000,2580716486,40812356,5.50966806e-12,238903283,3204228,4042219528
12755000,3987031446,40471512,5.46365412e-12,241461209,3209652,4045429180
12760000,3297107528,40018101,5.402443635e-12,238836506,3207020,4048636200
12765000,3088910193,40024805,5.4033486750000004e-12,239119589,3208792,4051844992
12770000,2264857853,40016102,5.40217377e-12,239768965,3208548,4055053540
12775000,2570393029,40348716,5.447076660000001e-12,238695992,3206036,4058259576
12780000,3316648214,40049118,5.40663093e-12,240224443,3206144,4061465720
12785000,2059686938,40413769,5.455858815e-12,239163063,3208320,4064674040
12790000,3024884731,40038364,5.40517914e-12,239447927,3210052,4067884092
12795000,3780113170,40383197,5.451731595e-12,238460141,3207348,4071091440
12800000,2199297435,40043034,5.40580959e-12,239760476,3204992,4074296432
12805000,2674627514,44243557,5.972880195000001e-12,236354794,3213984,4077510416
12810000,7169845977,41036155,5.539880925000001e-12,234518815,3208168,4080718584
12815000,3273781880,39604684,5.346632340000001e-12,234513507,3211248,4083929832
12820000,2095618501,40340724,5.445997740000001e-12,236858611,3208208,4087138040
12825000,2289767637,40088040,5.4118854e-12,240144114,3207356,4090345396
12830000,2279256591,40147246,5.41987821e-12,240396637,3206836,4093552232
12835000,3305811876,43283746,5.84330571e-12,240077000,3206936,4096759168
12840000,3188090340,46009270,6.211251450000001e-12,240816184,3208168,4099967336
12845000,3132452732,45972146,6.206239710000001e-12,239393717,3209828,4103177164
12850000,2619640775,45949174,6.2031384900000004e-12,240730705,3204736,4106381900
12855000,2807333980,41309011,5.576716485e-12,240471498,3203604,4109585504
12860000,2615999069,40774014,5.504491890000001e-12,240877507,3209464,4112794968
12865000,5037081680,39945829,5.392686915e-12,238825760,3207452,4116002420
12870000,6878201776,40749432,5.50117332e-12,240526272,3204580,4119207000
12875000,7758623752,40711156,5.49600606e-12,238507773,3208740,4122415740
12880000,2130447236,39883040,5.384210400000001e-12,240381838,3206500,4125622240
